,Date,Transaction Type,Num,Customer,Memo/Description,Qty,Sales Price,Amount,Balance
FireWrap Grip Kit - Light Blue,,,,,,,,,
FireWrap Grip Kit - Light Blue,03/23/2018,Sales Receipt,#1394,,FireWrap  Grip Kit - Pre-Order,1,24.95  ,24.95  ,24.95  
FireWrap Grip Kit - Light Blue,04/26/2018,Sales Receipt,#1477,,FireWrap  Grip Kit - Pre-Order,1,24.95  ,24.95  ,49.90  
FireWrap Grip Kit - Light Blue,04/27/2018,Sales Receipt,#1511,,FireWrap  Grip Kit - Pre-Order,1,24.95  ,24.95  ,74.85  
FireWrap Grip Kit - Light Blue,05/14/2018,Sales Receipt,#1617,,FireWrap  Grip Kit,1,34.95  ,34.95  ,109.80  
FireWrap Grip Kit - Light Blue,06/22/2018,Invoice,1133,,,4,26.00  ,104.00  ,213.80  
FireWrap Grip Kit - Light Blue,10/09/2018,Sales Receipt,#1895,,FireWrap  Grip Kit,1,34.95  ,34.95  ,248.75  
FireWrap Grip Kit - Light Blue,11/30/2018,Sales Receipt,#2045,,FireWrap  Grip Kit,1,34.95  ,34.95  ,283.70  
FireWrap Grip Kit - Light Blue,12/30/2018,Sales Receipt,#2149,,FireWrap  Grip Kit,1,34.95  ,34.95  ,318.65  
FireWrap Grip Kit - Light Blue,01/23/2019,Invoice,1257,,,1,30.00  ,30.00  ,348.65  
FireWrap Grip Kit - Light Blue,02/20/2019,Sales Receipt,#2317,,FireWrap  Grip Kit,1,34.95  ,34.95  ,383.60  
FireWrap Grip Kit - Light Blue,03/05/2019,Invoice,1266,,"P.O. Number: 19-0213-5 
Jason Oliva
2040 N 51st St
Milwaukee, WI 53208",1,30.00  ,30.00  ,413.60  
FireWrap Grip Kit - Light Blue,03/14/2019,Invoice,1300,,,1,30.00  ,30.00  ,443.60  
FireWrap Grip Kit - Light Blue,04/01/2019,Sales Receipt,#2473,,FireWrap Grip Kit,2,34.95  ,69.90  ,513.50  
FireWrap Grip Kit - Light Blue,04/02/2019,Sales Receipt,#2473,,FireWrap Grip Kit,2,34.95  ,69.90  ,583.40  
FireWrap Grip Kit - Light Blue,11/05/2019,Invoice,M-110519-005,,FireWrap Grip Kit - Light Blue,2,26.00  ,52.00  ,635.40  
Total for FireWrap Grip Kit - Light Blue,,,,,,21,,$	635.40  ,
FireWrap Grip Kit - Pink,,,,,,,,,
FireWrap Grip Kit - Pink,05/12/2018,Invoice,1115,,,1,26.00  ,26.00  ,26.00  
FireWrap Grip Kit - Pink,06/22/2018,Invoice,1133,,,4,26.00  ,104.00  ,130.00  
FireWrap Grip Kit - Pink,07/23/2018,Sales Receipt,#1736,,FireWrap  Grip Kit,1,34.95  ,34.95  ,164.95  
FireWrap Grip Kit - Pink,08/30/2018,Sales Receipt,#1801,,FireWrap  Grip Kit,1,34.95  ,34.95  ,199.90  
FireWrap Grip Kit - Pink,09/18/2018,Sales Receipt,#1847,,FireWrap  Grip Kit,1,34.95  ,34.95  ,234.85  
FireWrap Grip Kit - Pink,10/11/2018,Sales Receipt,#1898,,FireWrap  Grip Kit,2,34.95  ,69.90  ,304.75  
FireWrap Grip Kit - Pink,12/17/2018,Sales Receipt,#2102,,FireWrap  Grip Kit,1,34.95  ,34.95  ,339.70  
FireWrap Grip Kit - Pink,01/25/2019,Invoice,1248,,,2,26.00  ,52.00  ,391.70  
FireWrap Grip Kit - Pink,11/05/2019,Invoice,M-110519-005,,FireWrap Grip Kit - Pink,4,26.00  ,104.00  ,495.70  
Total for FireWrap Grip Kit - Pink,,,,,,17,,$	495.70  ,
FireWrap® Grip Kit Black,,,,,,,,,
FireWrap® Grip Kit Black,03/23/2018,Sales Receipt,#1396,,FireWrap  Grip Kit - Pre-Order,8,24.95  ,199.60  ,199.60  
FireWrap® Grip Kit Black,03/23/2018,Sales Receipt,#1391,,FireWrap  Grip Kit - Pre-Order,1,24.95  ,24.95  ,224.55  
FireWrap® Grip Kit Black,03/23/2018,Sales Receipt,#1390,,FireWrap  Grip Kit - Pre-Order,1,24.95  ,24.95  ,249.50  
FireWrap® Grip Kit Black,03/23/2018,Sales Receipt,#1395,,FireWrap  Grip Kit - Pre-Order,1,24.95  ,24.95  ,274.45  
FireWrap® Grip Kit Black,03/25/2018,Sales Receipt,#1407,,FireWrap  Grip Kit - Pre-Order,1,24.95  ,24.95  ,299.40  
FireWrap® Grip Kit Black,03/27/2018,Sales Receipt,#1415,,FireWrap  Grip Kit - Pre-Order,1,24.95  ,24.95  ,324.35  
FireWrap® Grip Kit Black,03/28/2018,Sales Receipt,#1417,,FireWrap  Grip Kit - Pre-Order,1,24.95  ,24.95  ,349.30  
FireWrap® Grip Kit Black,04/04/2018,Sales Receipt,#1424,,FireWrap  Grip Kit - Pre-Order,1,24.95  ,24.95  ,374.25  
FireWrap® Grip Kit Black,04/07/2018,Sales Receipt,#1431,,FireWrap  Grip Kit - Pre-Order,1,24.95  ,24.95  ,399.20  
FireWrap® Grip Kit Black,04/09/2018,Sales Receipt,#1434,,FireWrap  Grip Kit - Pre-Order,1,24.95  ,24.95  ,424.15  
FireWrap® Grip Kit Black,04/09/2018,Sales Receipt,#1433,,FireWrap  Grip Kit - Pre-Order,2,24.95  ,49.90  ,474.05  
FireWrap® Grip Kit Black,04/12/2018,Sales Receipt,#1438,,FireWrap  Grip Kit - Pre-Order,1,24.95  ,24.95  ,499.00  
FireWrap® Grip Kit Black,04/15/2018,Sales Receipt,#1450,,FireWrap  Grip Kit - Pre-Order,1,24.95  ,24.95  ,523.95  
FireWrap® Grip Kit Black,04/17/2018,Sales Receipt,#1454,,FireWrap  Grip Kit - Pre-Order,1,24.95  ,24.95  ,548.90  
FireWrap® Grip Kit Black,04/18/2018,Sales Receipt,#1458,,FireWrap  Grip Kit - Pre-Order,2,24.95  ,49.90  ,598.80  
FireWrap® Grip Kit Black,04/25/2018,Sales Receipt,#1464,,FireWrap  Grip Kit - Pre-Order,1,24.95  ,24.95  ,623.75  
FireWrap® Grip Kit Black,04/26/2018,Sales Receipt,#1496,,FireWrap  Grip Kit - Pre-Order,1,24.95  ,24.95  ,648.70  
FireWrap® Grip Kit Black,04/26/2018,Sales Receipt,#1488,,FireWrap  Grip Kit - Pre-Order,1,24.95  ,24.95  ,673.65  
FireWrap® Grip Kit Black,04/26/2018,Sales Receipt,#1466,,FireWrap  Grip Kit - Pre-Order,2,24.95  ,49.90  ,723.55  
FireWrap® Grip Kit Black,04/26/2018,Sales Receipt,#1491,,FireWrap  Grip Kit - Pre-Order,1,24.95  ,24.95  ,748.50  
FireWrap® Grip Kit Black,04/26/2018,Sales Receipt,#1469,,FireWrap  Grip Kit - Pre-Order,1,24.95  ,24.95  ,773.45  
FireWrap® Grip Kit Black,04/26/2018,Sales Receipt,#1480,,FireWrap  Grip Kit - Pre-Order,1,24.95  ,24.95  ,798.40  
FireWrap® Grip Kit Black,04/26/2018,Sales Receipt,#1471,,FireWrap  Grip Kit - Pre-Order,1,24.95  ,24.95  ,823.35  
FireWrap® Grip Kit Black,04/26/2018,Sales Receipt,#1481,,FireWrap  Grip Kit - Pre-Order,1,24.95  ,24.95  ,848.30  
FireWrap® Grip Kit Black,04/26/2018,Sales Receipt,#1494,,FireWrap  Grip Kit - Pre-Order,1,24.95  ,24.95  ,873.25  
FireWrap® Grip Kit Black,04/26/2018,Sales Receipt,#1484,,FireWrap  Grip Kit - Pre-Order,1,24.95  ,24.95  ,898.20  
FireWrap® Grip Kit Black,04/26/2018,Sales Receipt,#1465,,FireWrap  Grip Kit - Pre-Order,1,24.95  ,24.95  ,923.15  
FireWrap® Grip Kit Black,04/27/2018,Sales Receipt,#1514,,FireWrap  Grip Kit - Pre-Order,1,24.95  ,24.95  ,948.10  
FireWrap® Grip Kit Black,04/27/2018,Sales Receipt,#1519,,FireWrap  Grip Kit - Pre-Order,1,24.95  ,24.95  ,973.05  
FireWrap® Grip Kit Black,04/27/2018,Sales Receipt,#1540,,FireWrap  Grip Kit - Pre-Order,1,24.95  ,24.95  ,998.00  
FireWrap® Grip Kit Black,04/27/2018,Sales Receipt,#1506,,FireWrap  Grip Kit - Pre-Order,1,24.95  ,24.95  ,"1,022.95  "
FireWrap® Grip Kit Black,04/27/2018,Sales Receipt,#1523,,FireWrap  Grip Kit - Pre-Order,2,24.95  ,49.90  ,"1,072.85  "
FireWrap® Grip Kit Black,04/27/2018,Sales Receipt,#1505,,FireWrap  Grip Kit - Pre-Order,1,24.95  ,24.95  ,"1,097.80  "
FireWrap® Grip Kit Black,04/27/2018,Sales Receipt,#1532,,FireWrap  Grip Kit - Pre-Order,1,24.95  ,24.95  ,"1,122.75  "
FireWrap® Grip Kit Black,04/27/2018,Sales Receipt,#1504,,FireWrap  Grip Kit - Pre-Order,1,24.95  ,24.95  ,"1,147.70  "
FireWrap® Grip Kit Black,04/27/2018,Sales Receipt,1110,,,4,24.95  ,99.80  ,"1,247.50  "
FireWrap® Grip Kit Black,04/27/2018,Sales Receipt,#1539,,FireWrap  Grip Kit - Pre-Order,1,24.95  ,24.95  ,"1,272.45  "
FireWrap® Grip Kit Black,04/27/2018,Sales Receipt,#1545,,FireWrap  Grip Kit - Pre-Order,2,24.95  ,49.90  ,"1,322.35  "
FireWrap® Grip Kit Black,04/27/2018,Sales Receipt,#1541,,FireWrap  Grip Kit - Pre-Order,1,24.95  ,24.95  ,"1,347.30  "
FireWrap® Grip Kit Black,04/27/2018,Sales Receipt,#1538,,FireWrap  Grip Kit - Pre-Order,3,24.95  ,74.85  ,"1,422.15  "
FireWrap® Grip Kit Black,04/28/2018,Sales Receipt,#1556,,FireWrap  Grip Kit - Pre-Order,1,24.95  ,24.95  ,"1,447.10  "
FireWrap® Grip Kit Black,04/28/2018,Sales Receipt,#1566,,FireWrap  Grip Kit - Pre-Order,1,24.95  ,24.95  ,"1,472.05  "
FireWrap® Grip Kit Black,04/28/2018,Sales Receipt,#1563,,FireWrap  Grip Kit - Pre-Order,1,24.95  ,24.95  ,"1,497.00  "
FireWrap® Grip Kit Black,04/29/2018,Sales Receipt,#1574,,FireWrap  Grip Kit - Pre-Order,1,24.95  ,24.95  ,"1,521.95  "
FireWrap® Grip Kit Black,04/30/2018,Invoice,1111,,,3,20.00  ,60.00  ,"1,581.95  "
FireWrap® Grip Kit Black,04/30/2018,Invoice,1112,,,5,20.00  ,100.00  ,"1,681.95  "
FireWrap® Grip Kit Black,04/30/2018,Sales Receipt,#1584,,FireWrap  Grip Kit - Pre-Order,2,24.95  ,49.90  ,"1,731.85  "
FireWrap® Grip Kit Black,04/30/2018,Invoice,1113,,,3,20.00  ,60.00  ,"1,791.85  "
FireWrap® Grip Kit Black,04/30/2018,Sales Receipt,#1580,,FireWrap  Grip Kit - Pre-Order,2,24.95  ,49.90  ,"1,841.75  "
FireWrap® Grip Kit Black,05/01/2018,Sales Receipt,#1586,,FireWrap  Grip Kit - Pre-Order,1,24.95  ,24.95  ,"1,866.70  "
FireWrap® Grip Kit Black,05/02/2018,Sales Receipt,#1589,,FireWrap  Grip Kit,1,34.95  ,34.95  ,"1,901.65  "
FireWrap® Grip Kit Black,05/02/2018,Sales Receipt,#1590,,FireWrap  Grip Kit,1,34.95  ,34.95  ,"1,936.60  "
FireWrap® Grip Kit Black,05/04/2018,Sales Receipt,#1595,,FireWrap  Grip Kit,1,34.95  ,34.95  ,"1,971.55  "
FireWrap® Grip Kit Black,05/04/2018,Sales Receipt,#1593,,FireWrap  Grip Kit,1,34.95  ,34.95  ,"2,006.50  "
FireWrap® Grip Kit Black,05/05/2018,Sales Receipt,#1601,,FireWrap  Grip Kit,1,34.95  ,34.95  ,"2,041.45  "
FireWrap® Grip Kit Black,05/05/2018,Sales Receipt,#1599,,FireWrap  Grip Kit,1,34.95  ,34.95  ,"2,076.40  "
FireWrap® Grip Kit Black,05/05/2018,Sales Receipt,#1600,,FireWrap  Grip Kit,2,34.95  ,69.90  ,"2,146.30  "
FireWrap® Grip Kit Black,05/05/2018,Sales Receipt,#1597,,FireWrap  Grip Kit,1,34.95  ,34.95  ,"2,181.25  "
FireWrap® Grip Kit Black,05/09/2018,Invoice,1114,,,2,30.00  ,60.00  ,"2,241.25  "
FireWrap® Grip Kit Black,05/09/2018,Sales Receipt,#1611,,FireWrap  Grip Kit,2,34.95  ,69.90  ,"2,311.15  "
FireWrap® Grip Kit Black,05/10/2018,Sales Receipt,#1612,,FireWrap  Grip Kit,1,34.95  ,34.95  ,"2,346.10  "
FireWrap® Grip Kit Black,05/11/2018,Sales Receipt,#1615,,FireWrap  Grip Kit,1,34.95  ,34.95  ,"2,381.05  "
FireWrap® Grip Kit Black,05/12/2018,Invoice,1115,,,12,26.00  ,312.00  ,"2,693.05  "
FireWrap® Grip Kit Black,05/14/2018,Sales Receipt,#1618,,FireWrap  Grip Kit,1,34.95  ,34.95  ,"2,728.00  "
FireWrap® Grip Kit Black,05/15/2018,Sales Receipt,#1620,,FireWrap  Grip Kit,1,34.95  ,34.95  ,"2,762.95  "
FireWrap® Grip Kit Black,05/15/2018,Sales Receipt,#1619,,FireWrap  Grip Kit,1,34.95  ,34.95  ,"2,797.90  "
FireWrap® Grip Kit Black,05/17/2018,Invoice,1117,,,12,20.00  ,240.00  ,"3,037.90  "
FireWrap® Grip Kit Black,05/18/2018,Sales Receipt,#1626,,FireWrap  Grip Kit,1,34.95  ,34.95  ,"3,072.85  "
FireWrap® Grip Kit Black,05/18/2018,Sales Receipt,#1625,,FireWrap  Grip Kit,1,34.95  ,34.95  ,"3,107.80  "
FireWrap® Grip Kit Black,05/18/2018,Sales Receipt,#1627,,FireWrap  Grip Kit,1,34.95  ,34.95  ,"3,142.75  "
FireWrap® Grip Kit Black,05/19/2018,Sales Receipt,#1629,,FireWrap  Grip Kit,1,34.95  ,34.95  ,"3,177.70  "
FireWrap® Grip Kit Black,05/21/2018,Sales Receipt,#1636,,FireWrap  Grip Kit,1,34.95  ,34.95  ,"3,212.65  "
FireWrap® Grip Kit Black,05/21/2018,Sales Receipt,#1634,,FireWrap  Grip Kit,1,34.95  ,34.95  ,"3,247.60  "
FireWrap® Grip Kit Black,05/23/2018,Sales Receipt,#1642,,FireWrap  Grip Kit,1,34.95  ,34.95  ,"3,282.55  "
FireWrap® Grip Kit Black,05/25/2018,Sales Receipt,#1647,,FireWrap  Grip Kit,1,34.95  ,34.95  ,"3,317.50  "
FireWrap® Grip Kit Black,06/03/2018,Sales Receipt,#1661,,FireWrap  Grip Kit,1,34.95  ,34.95  ,"3,352.45  "
FireWrap® Grip Kit Black,06/04/2018,Invoice,1124,,,1,34.95  ,34.95  ,"3,387.40  "
FireWrap® Grip Kit Black,06/07/2018,Sales Receipt,#1668,,FireWrap  Grip Kit,1,34.95  ,34.95  ,"3,422.35  "
FireWrap® Grip Kit Black,06/08/2018,Sales Receipt,#1669,,FireWrap  Grip Kit,1,34.95  ,34.95  ,"3,457.30  "
FireWrap® Grip Kit Black,06/09/2018,Sales Receipt,#1671,,FireWrap  Grip Kit,2,34.95  ,69.90  ,"3,527.20  "
FireWrap® Grip Kit Black,06/18/2018,Sales Receipt,#1683,,FireWrap  Grip Kit,2,34.95  ,69.90  ,"3,597.10  "
FireWrap® Grip Kit Black,06/18/2018,Sales Receipt,#1679,,FireWrap  Grip Kit,1,34.95  ,34.95  ,"3,632.05  "
FireWrap® Grip Kit Black,06/21/2018,Sales Receipt,#1688,,FireWrap  Grip Kit,1,34.95  ,34.95  ,"3,667.00  "
FireWrap® Grip Kit Black,06/22/2018,Invoice,1133,,,17,26.00  ,442.00  ,"4,109.00  "
FireWrap® Grip Kit Black,06/28/2018,Sales Receipt,#1694,,FireWrap  Grip Kit,4,34.95  ,139.80  ,"4,248.80  "
FireWrap® Grip Kit Black,07/03/2018,Sales Receipt,#1698,,FireWrap  Grip Kit,1,34.95  ,34.95  ,"4,283.75  "
FireWrap® Grip Kit Black,07/03/2018,Sales Receipt,#1699,,FireWrap  Grip Kit,1,34.95  ,34.95  ,"4,318.70  "
FireWrap® Grip Kit Black,07/08/2018,Sales Receipt,#1709,,FireWrap  Grip Kit,1,34.95  ,34.95  ,"4,353.65  "
FireWrap® Grip Kit Black,07/08/2018,Sales Receipt,#1708,,FireWrap  Grip Kit,1,34.95  ,34.95  ,"4,388.60  "
FireWrap® Grip Kit Black,07/14/2018,Sales Receipt,#1717,,FireWrap  Grip Kit,1,34.95  ,34.95  ,"4,423.55  "
FireWrap® Grip Kit Black,07/14/2018,Sales Receipt,#1716,,FireWrap  Grip Kit,1,34.95  ,34.95  ,"4,458.50  "
FireWrap® Grip Kit Black,07/15/2018,Sales Receipt,#1720,,FireWrap  Grip Kit,1,34.95  ,34.95  ,"4,493.45  "
FireWrap® Grip Kit Black,07/15/2018,Sales Receipt,#1722,,FireWrap  Grip Kit,1,34.95  ,34.95  ,"4,528.40  "
FireWrap® Grip Kit Black,07/18/2018,Sales Receipt,#1725,,FireWrap  Grip Kit,1,34.95  ,34.95  ,"4,563.35  "
FireWrap® Grip Kit Black,07/19/2018,Sales Receipt,#1728,,FireWrap  Grip Kit,1,34.95  ,34.95  ,"4,598.30  "
FireWrap® Grip Kit Black,07/19/2018,Sales Receipt,#1730,,FireWrap  Grip Kit,1,34.95  ,34.95  ,"4,633.25  "
FireWrap® Grip Kit Black,07/22/2018,Sales Receipt,#1735,,FireWrap  Grip Kit,1,34.95  ,34.95  ,"4,668.20  "
FireWrap® Grip Kit Black,07/23/2018,Sales Receipt,#1737,,FireWrap  Grip Kit,1,34.95  ,34.95  ,"4,703.15  "
FireWrap® Grip Kit Black,08/01/2018,Invoice,1154,,,50,34.95  ,"1,747.50  ","6,450.65  "
FireWrap® Grip Kit Black,08/02/2018,Sales Receipt,#1748,,FireWrap  Grip Kit,1,34.95  ,34.95  ,"6,485.60  "
FireWrap® Grip Kit Black,08/02/2018,Sales Receipt,#1749,,FireWrap  Grip Kit,1,34.95  ,34.95  ,"6,520.55  "
FireWrap® Grip Kit Black,08/04/2018,Sales Receipt,#1753,,FireWrap  Grip Kit,1,34.95  ,34.95  ,"6,555.50  "
FireWrap® Grip Kit Black,08/07/2018,Sales Receipt,#1760,,FireWrap  Grip Kit,4,34.95  ,139.80  ,"6,695.30  "
FireWrap® Grip Kit Black,08/11/2018,Sales Receipt,#1770,,FireWrap  Grip Kit,1,34.95  ,34.95  ,"6,730.25  "
FireWrap® Grip Kit Black,08/15/2018,Sales Receipt,#1777,,FireWrap  Grip Kit,1,34.95  ,34.95  ,"6,765.20  "
FireWrap® Grip Kit Black,08/17/2018,Invoice,1161,,,6,34.95  ,209.70  ,"6,974.90  "
FireWrap® Grip Kit Black,08/19/2018,Sales Receipt,#1780,,FireWrap  Grip Kit,1,34.95  ,34.95  ,"7,009.85  "
FireWrap® Grip Kit Black,08/21/2018,Invoice,1163,,,3,28.00  ,84.00  ,"7,093.85  "
FireWrap® Grip Kit Black,08/22/2018,Invoice,1164,,,4,34.95  ,139.80  ,"7,233.65  "
FireWrap® Grip Kit Black,08/23/2018,Sales Receipt,#1785,,FireWrap  Grip Kit,1,34.95  ,34.95  ,"7,268.60  "
FireWrap® Grip Kit Black,08/23/2018,Sales Receipt,#1783,,FireWrap  Grip Kit,1,34.95  ,34.95  ,"7,303.55  "
FireWrap® Grip Kit Black,08/24/2018,Sales Receipt,#1790,,FireWrap  Grip Kit,2,34.95  ,69.90  ,"7,373.45  "
FireWrap® Grip Kit Black,08/24/2018,Invoice,1166,,,1,30.00  ,30.00  ,"7,403.45  "
FireWrap® Grip Kit Black,08/24/2018,Sales Receipt,#1789,,FireWrap  Grip Kit,1,34.95  ,34.95  ,"7,438.40  "
FireWrap® Grip Kit Black,08/24/2018,Sales Receipt,#1787,,FireWrap  Grip Kit,4,34.95  ,139.80  ,"7,578.20  "
FireWrap® Grip Kit Black,08/24/2018,Sales Receipt,#1788,,FireWrap  Grip Kit,1,34.95  ,34.95  ,"7,613.15  "
FireWrap® Grip Kit Black,08/28/2018,Sales Receipt,#1796,,FireWrap  Grip Kit,1,34.95  ,34.95  ,"7,648.10  "
FireWrap® Grip Kit Black,08/29/2018,Sales Receipt,#1800,,FireWrap  Grip Kit,1,34.95  ,34.95  ,"7,683.05  "
FireWrap® Grip Kit Black,08/30/2018,Sales Receipt,#1803,,FireWrap  Grip Kit,2,34.95  ,69.90  ,"7,752.95  "
FireWrap® Grip Kit Black,08/31/2018,Sales Receipt,#1804,,FireWrap  Grip Kit,1,34.95  ,34.95  ,"7,787.90  "
FireWrap® Grip Kit Black,09/03/2018,Sales Receipt,#1810,,FireWrap  Grip Kit,1,34.95  ,34.95  ,"7,822.85  "
FireWrap® Grip Kit Black,09/05/2018,Sales Receipt,#1814,,FireWrap  Grip Kit,1,34.95  ,34.95  ,"7,857.80  "
FireWrap® Grip Kit Black,09/05/2018,Sales Receipt,#1813,,FireWrap  Grip Kit,1,34.95  ,34.95  ,"7,892.75  "
FireWrap® Grip Kit Black,09/09/2018,Sales Receipt,#1819,,FireWrap  Grip Kit,1,34.95  ,34.95  ,"7,927.70  "
FireWrap® Grip Kit Black,09/10/2018,Invoice,1169,,,1,26.00  ,26.00  ,"7,953.70  "
FireWrap® Grip Kit Black,09/10/2018,Sales Receipt,#1822,,FireWrap  Grip Kit,1,34.95  ,34.95  ,"7,988.65  "
FireWrap® Grip Kit Black,09/12/2018,Sales Receipt,#1831,,FireWrap  Grip Kit,1,34.95  ,34.95  ,"8,023.60  "
FireWrap® Grip Kit Black,09/12/2018,Sales Receipt,#1829,,FireWrap  Grip Kit,1,34.95  ,34.95  ,"8,058.55  "
FireWrap® Grip Kit Black,09/12/2018,Sales Receipt,#1828,,FireWrap  Grip Kit,1,34.95  ,34.95  ,"8,093.50  "
FireWrap® Grip Kit Black,09/12/2018,Sales Receipt,#1827,,FireWrap  Grip Kit,1,34.95  ,34.95  ,"8,128.45  "
FireWrap® Grip Kit Black,09/12/2018,Sales Receipt,#1826,,FireWrap  Grip Kit,1,34.95  ,34.95  ,"8,163.40  "
FireWrap® Grip Kit Black,09/13/2018,Sales Receipt,#1836,,FireWrap  Grip Kit,1,34.95  ,34.95  ,"8,198.35  "
FireWrap® Grip Kit Black,09/16/2018,Sales Receipt,#1840,,FireWrap  Grip Kit,1,34.95  ,34.95  ,"8,233.30  "
FireWrap® Grip Kit Black,09/17/2018,Sales Receipt,#1841,,FireWrap  Grip Kit,1,34.95  ,34.95  ,"8,268.25  "
FireWrap® Grip Kit Black,09/18/2018,Sales Receipt,#1844,,FireWrap  Grip Kit,1,34.95  ,34.95  ,"8,303.20  "
FireWrap® Grip Kit Black,09/18/2018,Sales Receipt,#1843,,FireWrap  Grip Kit,1,34.95  ,34.95  ,"8,338.15  "
FireWrap® Grip Kit Black,09/18/2018,Sales Receipt,#1848,,FireWrap  Grip Kit,1,34.95  ,34.95  ,"8,373.10  "
FireWrap® Grip Kit Black,09/18/2018,Sales Receipt,#1845,,FireWrap  Grip Kit,1,34.95  ,34.95  ,"8,408.05  "
FireWrap® Grip Kit Black,09/19/2018,Sales Receipt,#1850,,FireWrap  Grip Kit,1,34.95  ,34.95  ,"8,443.00  "
FireWrap® Grip Kit Black,09/20/2018,Sales Receipt,#1856,,FireWrap  Grip Kit,1,34.95  ,34.95  ,"8,477.95  "
FireWrap® Grip Kit Black,09/20/2018,Sales Receipt,#1853,,FireWrap  Grip Kit,1,34.95  ,34.95  ,"8,512.90  "
FireWrap® Grip Kit Black,09/21/2018,Sales Receipt,#1861,,FireWrap  Grip Kit,2,34.95  ,69.90  ,"8,582.80  "
FireWrap® Grip Kit Black,09/24/2018,Sales Receipt,#1867,,FireWrap  Grip Kit,1,34.95  ,34.95  ,"8,617.75  "
FireWrap® Grip Kit Black,09/24/2018,Sales Receipt,#1865,,FireWrap  Grip Kit,1,34.95  ,34.95  ,"8,652.70  "
FireWrap® Grip Kit Black,09/25/2018,Sales Receipt,#1869,,FireWrap  Grip Kit,1,34.95  ,34.95  ,"8,687.65  "
FireWrap® Grip Kit Black,09/27/2018,Sales Receipt,#1874,,FireWrap  Grip Kit,1,34.95  ,34.95  ,"8,722.60  "
FireWrap® Grip Kit Black,09/27/2018,Sales Receipt,#1873,,FireWrap  Grip Kit,1,34.95  ,34.95  ,"8,757.55  "
FireWrap® Grip Kit Black,09/28/2018,Sales Receipt,#1877,,FireWrap  Grip Kit,1,34.95  ,34.95  ,"8,792.50  "
FireWrap® Grip Kit Black,10/02/2018,Invoice,1176,,,24,28.00  ,672.00  ,"9,464.50  "
FireWrap® Grip Kit Black,10/03/2018,Sales Receipt,#1886,,FireWrap  Grip Kit,1,34.95  ,34.95  ,"9,499.45  "
FireWrap® Grip Kit Black,10/03/2018,Sales Receipt,#1887,,FireWrap  Grip Kit,1,34.95  ,34.95  ,"9,534.40  "
FireWrap® Grip Kit Black,10/06/2018,Sales Receipt,#1891,,FireWrap  Grip Kit,1,34.95  ,34.95  ,"9,569.35  "
FireWrap® Grip Kit Black,10/08/2018,Sales Receipt,#1893,,FireWrap  Grip Kit,1,34.95  ,34.95  ,"9,604.30  "
FireWrap® Grip Kit Black,10/08/2018,Sales Receipt,#1894,,FireWrap  Grip Kit,1,34.95  ,34.95  ,"9,639.25  "
FireWrap® Grip Kit Black,10/09/2018,Sales Receipt,#1895,,FireWrap  Grip Kit,1,34.95  ,34.95  ,"9,674.20  "
FireWrap® Grip Kit Black,10/10/2018,Invoice,1178,,,1,34.95  ,34.95  ,"9,709.15  "
FireWrap® Grip Kit Black,10/13/2018,Sales Receipt,#1902,,FireWrap  Grip Kit,1,34.95  ,34.95  ,"9,744.10  "
FireWrap® Grip Kit Black,10/15/2018,Sales Receipt,#1903,,FireWrap  Grip Kit,2,34.95  ,69.90  ,"9,814.00  "
FireWrap® Grip Kit Black,10/16/2018,Sales Receipt,#1906,,FireWrap  Grip Kit,2,34.95  ,69.90  ,"9,883.90  "
FireWrap® Grip Kit Black,10/17/2018,Sales Receipt,#1909,,FireWrap  Grip Kit,1,34.95  ,34.95  ,"9,918.85  "
FireWrap® Grip Kit Black,10/17/2018,Sales Receipt,#1910,,FireWrap  Grip Kit,1,34.95  ,34.95  ,"9,953.80  "
FireWrap® Grip Kit Black,10/23/2018,Sales Receipt,#1958,,FireWrap  Grip Kit,1,34.95  ,34.95  ,"9,988.75  "
FireWrap® Grip Kit Black,10/23/2018,Sales Receipt,#1957,,FireWrap  Grip Kit,1,34.95  ,34.95  ,"10,023.70  "
FireWrap® Grip Kit Black,10/26/2018,Sales Receipt,#1964,,FireWrap  Grip Kit,2,34.95  ,69.90  ,"10,093.60  "
FireWrap® Grip Kit Black,11/01/2018,Sales Receipt,#1975,,FireWrap  Grip Kit,2,34.95  ,69.90  ,"10,163.50  "
FireWrap® Grip Kit Black,11/01/2018,Sales Receipt,#1977,,FireWrap  Grip Kit,1,34.95  ,34.95  ,"10,198.45  "
FireWrap® Grip Kit Black,11/02/2018,Sales Receipt,#1979,,FireWrap  Grip Kit,1,34.95  ,34.95  ,"10,233.40  "
FireWrap® Grip Kit Black,11/03/2018,Sales Receipt,#1984,,FireWrap  Grip Kit,2,34.95  ,69.90  ,"10,303.30  "
FireWrap® Grip Kit Black,11/03/2018,Sales Receipt,#1985,,FireWrap  Grip Kit,1,34.95  ,34.95  ,"10,338.25  "
FireWrap® Grip Kit Black,11/08/2018,Sales Receipt,#1990,,FireWrap  Grip Kit,1,34.95  ,34.95  ,"10,373.20  "
FireWrap® Grip Kit Black,11/12/2018,Sales Receipt,#1994,,FireWrap  Grip Kit,2,34.95  ,69.90  ,"10,443.10  "
FireWrap® Grip Kit Black,11/13/2018,Invoice,1203,,,8,28.00  ,224.00  ,"10,667.10  "
FireWrap® Grip Kit Black,11/16/2018,Sales Receipt,#2002,,FireWrap  Grip Kit,1,34.95  ,34.95  ,"10,702.05  "
FireWrap® Grip Kit Black,11/22/2018,Sales Receipt,#2012,,FireWrap  Grip Kit,2,34.95  ,69.90  ,"10,771.95  "
FireWrap® Grip Kit Black,11/26/2018,Sales Receipt,#2034,,FireWrap  Grip Kit,5,34.95  ,174.75  ,"10,946.70  "
FireWrap® Grip Kit Black,11/26/2018,Sales Receipt,#2036,,FireWrap  Grip Kit,1,34.95  ,34.95  ,"10,981.65  "
FireWrap® Grip Kit Black,11/26/2018,Sales Receipt,#2035,,FireWrap  Grip Kit,1,34.95  ,34.95  ,"11,016.60  "
FireWrap® Grip Kit Black,11/28/2018,Sales Receipt,#2037,,FireWrap  Grip Kit,4,34.95  ,139.80  ,"11,156.40  "
FireWrap® Grip Kit Black,11/28/2018,Sales Receipt,#2039,,FireWrap  Grip Kit,3,34.95  ,104.85  ,"11,261.25  "
FireWrap® Grip Kit Black,11/29/2018,Invoice,1212,,,2,30.00  ,60.00  ,"11,321.25  "
FireWrap® Grip Kit Black,11/29/2018,Sales Receipt,#2041,,FireWrap  Grip Kit,1,34.95  ,34.95  ,"11,356.20  "
FireWrap® Grip Kit Black,12/01/2018,Sales Receipt,#2048,,FireWrap  Grip Kit,1,34.95  ,34.95  ,"11,391.15  "
FireWrap® Grip Kit Black,12/03/2018,Sales Receipt,#2056,,FireWrap  Grip Kit,1,34.95  ,34.95  ,"11,426.10  "
FireWrap® Grip Kit Black,12/05/2018,Invoice,1215,,,6,25.00  ,150.00  ,"11,576.10  "
FireWrap® Grip Kit Black,12/05/2018,Sales Receipt,#2062,,FireWrap Grip Kit,1,34.95  ,34.95  ,"11,611.05  "
FireWrap® Grip Kit Black,12/07/2018,Invoice,1218,,,7,30.00  ,210.00  ,"11,821.05  "
FireWrap® Grip Kit Black,12/07/2018,Sales Receipt,#2069,,FireWrap  Grip Kit,2,34.95  ,69.90  ,"11,890.95  "
FireWrap® Grip Kit Black,12/10/2018,Sales Receipt,#2077,,FireWrap  Grip Kit,1,34.95  ,34.95  ,"11,925.90  "
FireWrap® Grip Kit Black,12/12/2018,Sales Receipt,#2083,,FireWrap  Grip Kit,1,34.95  ,34.95  ,"11,960.85  "
FireWrap® Grip Kit Black,12/12/2018,Sales Receipt,#2082,,FireWrap  Grip Kit,1,34.95  ,34.95  ,"11,995.80  "
FireWrap® Grip Kit Black,12/15/2018,Sales Receipt,#2095,,FireWrap Grip Kit,1,34.95  ,34.95  ,"12,030.75  "
FireWrap® Grip Kit Black,12/15/2018,Sales Receipt,#2093,,FireWrap  Grip Kit,1,34.95  ,34.95  ,"12,065.70  "
FireWrap® Grip Kit Black,12/16/2018,Sales Receipt,#2097,,FireWrap  Grip Kit,1,34.95  ,34.95  ,"12,100.65  "
FireWrap® Grip Kit Black,12/16/2018,Sales Receipt,#2101,,FireWrap  Grip Kit,1,34.95  ,34.95  ,"12,135.60  "
FireWrap® Grip Kit Black,12/18/2018,Sales Receipt,#2108,,FireWrap  Grip Kit,1,34.95  ,34.95  ,"12,170.55  "
FireWrap® Grip Kit Black,12/18/2018,Sales Receipt,#2105,,FireWrap Grip Kit,1,34.95  ,34.95  ,"12,205.50  "
FireWrap® Grip Kit Black,12/19/2018,Refund,#2110 (Refund 1),,FireWrap  Grip Kit,-1,34.95  ,-34.95  ,"12,170.55  "
FireWrap® Grip Kit Black,12/19/2018,Sales Receipt,#2109,,FireWrap  Grip Kit,1,34.95  ,34.95  ,"12,205.50  "
FireWrap® Grip Kit Black,12/19/2018,Sales Receipt,#2110,,FireWrap  Grip Kit,1,34.95  ,34.95  ,"12,240.45  "
FireWrap® Grip Kit Black,12/19/2018,Sales Receipt,#2111,,FireWrap  Grip Kit,1,34.95  ,34.95  ,"12,275.40  "
FireWrap® Grip Kit Black,12/20/2018,Sales Receipt,#2115,,FireWrap  Grip Kit,2,34.95  ,69.90  ,"12,345.30  "
FireWrap® Grip Kit Black,12/20/2018,Sales Receipt,#2114,,FireWrap  Grip Kit,1,34.95  ,34.95  ,"12,380.25  "
FireWrap® Grip Kit Black,12/20/2018,Sales Receipt,#2113,,FireWrap  Grip Kit,1,34.95  ,34.95  ,"12,415.20  "
FireWrap® Grip Kit Black,12/21/2018,Sales Receipt,#2117,,FireWrap Grip Kit,1,34.95  ,34.95  ,"12,450.15  "
FireWrap® Grip Kit Black,12/22/2018,Sales Receipt,#2119,,FireWrap Grip Kit,1,34.95  ,34.95  ,"12,485.10  "
FireWrap® Grip Kit Black,12/23/2018,Sales Receipt,#2120,,FireWrap  Grip Kit,1,34.95  ,34.95  ,"12,520.05  "
FireWrap® Grip Kit Black,12/24/2018,Sales Receipt,#2121,,FireWrap  Grip Kit,1,34.95  ,34.95  ,"12,555.00  "
FireWrap® Grip Kit Black,12/25/2018,Sales Receipt,#2124,,FireWrap  Grip Kit,1,34.95  ,34.95  ,"12,589.95  "
FireWrap® Grip Kit Black,12/25/2018,Sales Receipt,#2123,,FireWrap  Grip Kit,1,34.95  ,34.95  ,"12,624.90  "
FireWrap® Grip Kit Black,12/26/2018,Sales Receipt,#2129,,FireWrap Grip Kit,1,34.95  ,34.95  ,"12,659.85  "
FireWrap® Grip Kit Black,12/26/2018,Sales Receipt,#2125,,FireWrap  Grip Kit,1,34.95  ,34.95  ,"12,694.80  "
FireWrap® Grip Kit Black,12/28/2018,Sales Receipt,#2138,,FireWrap  Grip Kit,1,34.95  ,34.95  ,"12,729.75  "
FireWrap® Grip Kit Black,12/29/2018,Sales Receipt,#2142,,FireWrap  Grip Kit,1,34.95  ,34.95  ,"12,764.70  "
FireWrap® Grip Kit Black,12/29/2018,Sales Receipt,#2145,,FireWrap Grip Kit,1,34.95  ,34.95  ,"12,799.65  "
FireWrap® Grip Kit Black,12/31/2018,Sales Receipt,#2151,,FireWrap Grip Kit,1,34.95  ,34.95  ,"12,834.60  "
FireWrap® Grip Kit Black,01/02/2019,Sales Receipt,#2156,,FireWrap Grip Kit,1,34.95  ,34.95  ,"12,869.55  "
FireWrap® Grip Kit Black,01/07/2019,Sales Receipt,#2176,,FireWrap  Grip Kit,1,34.95  ,34.95  ,"12,904.50  "
FireWrap® Grip Kit Black,01/07/2019,Sales Receipt,#2177,,FireWrap  Grip Kit,1,34.95  ,34.95  ,"12,939.45  "
FireWrap® Grip Kit Black,01/08/2019,Sales Receipt,#2179,,FireWrap  Grip Kit,1,34.95  ,34.95  ,"12,974.40  "
FireWrap® Grip Kit Black,01/08/2019,Sales Receipt,#2178,,FireWrap  Grip Kit,1,34.95  ,34.95  ,"13,009.35  "
FireWrap® Grip Kit Black,01/11/2019,Sales Receipt,#2189,,FireWrap  Grip Kit,1,34.95  ,34.95  ,"13,044.30  "
FireWrap® Grip Kit Black,01/13/2019,Sales Receipt,#2192,,FireWrap  Grip Kit,1,34.95  ,34.95  ,"13,079.25  "
FireWrap® Grip Kit Black,01/13/2019,Invoice,1232,,,1,30.00  ,30.00  ,"13,109.25  "
FireWrap® Grip Kit Black,01/16/2019,Sales Receipt,#2204,,FireWrap  Grip Kit,2,34.95  ,69.90  ,"13,179.15  "
FireWrap® Grip Kit Black,01/16/2019,Sales Receipt,#2206,,FireWrap Grip Kit,1,34.95  ,34.95  ,"13,214.10  "
FireWrap® Grip Kit Black,01/17/2019,Sales Receipt,#2208,,FireWrap  Grip Kit,1,34.95  ,34.95  ,"13,249.05  "
FireWrap® Grip Kit Black,01/17/2019,Invoice,1247,,,1,30.00  ,30.00  ,"13,279.05  "
FireWrap® Grip Kit Black,01/17/2019,Sales Receipt,#2209,,FireWrap Grip Kit,2,34.95  ,69.90  ,"13,348.95  "
FireWrap® Grip Kit Black,01/18/2019,Sales Receipt,#2219,,FireWrap Grip Kit,1,34.95  ,34.95  ,"13,383.90  "
FireWrap® Grip Kit Black,01/19/2019,Sales Receipt,#2220,,FireWrap  Grip Kit,1,34.95  ,34.95  ,"13,418.85  "
FireWrap® Grip Kit Black,01/21/2019,Sales Receipt,#2229,,FireWrap  Grip Kit,2,34.95  ,69.90  ,"13,488.75  "
FireWrap® Grip Kit Black,01/21/2019,Sales Receipt,#2227,,FireWrap  Grip Kit,2,34.95  ,69.90  ,"13,558.65  "
FireWrap® Grip Kit Black,01/21/2019,Sales Receipt,#2228,,FireWrap Grip Kit,1,34.95  ,34.95  ,"13,593.60  "
FireWrap® Grip Kit Black,01/21/2019,Sales Receipt,#2226,,FireWrap  Grip Kit,1,34.95  ,34.95  ,"13,628.55  "
FireWrap® Grip Kit Black,01/23/2019,Invoice,1252,,,1,30.00  ,30.00  ,"13,658.55  "
FireWrap® Grip Kit Black,01/23/2019,Invoice,1255,,,4,30.00  ,120.00  ,"13,778.55  "
FireWrap® Grip Kit Black,01/23/2019,Invoice,1258,,,1,30.00  ,30.00  ,"13,808.55  "
FireWrap® Grip Kit Black,01/25/2019,Sales Receipt,#2234,,FireWrap Grip Kit,3,34.95  ,104.85  ,"13,913.40  "
FireWrap® Grip Kit Black,01/28/2019,Invoice,1263,,,5,30.00  ,150.00  ,"14,063.40  "
FireWrap® Grip Kit Black,01/30/2019,Sales Receipt,#2251,,FireWrap Grip Kit,1,34.95  ,34.95  ,"14,098.35  "
FireWrap® Grip Kit Black,01/30/2019,Sales Receipt,#2254,,FireWrap  Grip Kit,1,34.95  ,34.95  ,"14,133.30  "
FireWrap® Grip Kit Black,02/02/2019,Invoice,1242,,P.O. Number: 19-0103-11,3,30.00  ,90.00  ,"14,223.30  "
FireWrap® Grip Kit Black,02/02/2019,Invoice,1265,,,2,30.00  ,60.00  ,"14,283.30  "
FireWrap® Grip Kit Black,02/02/2019,Invoice,1242,,"P.O. Number: 19-0129-1 
Bradford McCutcheon
10538 Le Mans Rd
Dallas, TX 75238",2,30.00  ,60.00  ,"14,343.30  "
FireWrap® Grip Kit Black,02/02/2019,Invoice,1242,,"P.O. Number: 19-0129-2
Sean Wilson
5150 Hampshire Dr
Shelby Township, MI 48316",5,30.00  ,150.00  ,"14,493.30  "
FireWrap® Grip Kit Black,02/05/2019,Sales Receipt,#2268,,FireWrap  Grip Kit,1,34.95  ,34.95  ,"14,528.25  "
FireWrap® Grip Kit Black,02/06/2019,Invoice,1268,,FireWrap Grip-Kit für Halligan-Tool - Schwarz,400,25.00  ,"10,000.00  ","24,528.25  "
FireWrap® Grip Kit Black,02/07/2019,Sales Receipt,#2271,,FireWrap  Grip Kit,2,34.95  ,69.90  ,"24,598.15  "
FireWrap® Grip Kit Black,02/07/2019,Sales Receipt,#2273,,FireWrap  Grip Kit,3,34.95  ,104.85  ,"24,703.00  "
FireWrap® Grip Kit Black,02/08/2019,Sales Receipt,1269,,Custom Install - Halligan w/ red and Hammer all black.,1,34.95  ,34.95  ,"24,737.95  "
FireWrap® Grip Kit Black,02/09/2019,Sales Receipt,#2276,,FireWrap  Grip Kit,1,34.95  ,34.95  ,"24,772.90  "
FireWrap® Grip Kit Black,02/10/2019,Sales Receipt,#2283,,FireWrap  Grip Kit,1,34.95  ,34.95  ,"24,807.85  "
FireWrap® Grip Kit Black,02/13/2019,Sales Receipt,#2288,,FireWrap  Grip Kit,2,34.95  ,69.90  ,"24,877.75  "
FireWrap® Grip Kit Black,02/14/2019,Sales Receipt,#2292,,FireWrap Grip Kit,1,34.95  ,34.95  ,"24,912.70  "
FireWrap® Grip Kit Black,02/15/2019,Sales Receipt,#2296,,FireWrap  Grip Kit,2,34.95  ,69.90  ,"24,982.60  "
FireWrap® Grip Kit Black,02/15/2019,Sales Receipt,#2297,,FireWrap  Grip Kit,1,34.95  ,34.95  ,"25,017.55  "
FireWrap® Grip Kit Black,02/15/2019,Sales Receipt,#2295,,FireWrap  Grip Kit,1,34.95  ,34.95  ,"25,052.50  "
FireWrap® Grip Kit Black,02/16/2019,Sales Receipt,#2300,,FireWrap  Grip Kit,4,34.95  ,139.80  ,"25,192.30  "
FireWrap® Grip Kit Black,02/17/2019,Sales Receipt,#2304,,FireWrap  Grip Kit,1,34.95  ,34.95  ,"25,227.25  "
FireWrap® Grip Kit Black,02/18/2019,Invoice,1271,,,10,25.00  ,250.00  ,"25,477.25  "
FireWrap® Grip Kit Black,02/18/2019,Sales Receipt,#2310,,FireWrap Grip Kit,1,34.95  ,34.95  ,"25,512.20  "
FireWrap® Grip Kit Black,02/18/2019,Invoice,1277,,,4,29.00  ,116.00  ,"25,628.20  "
FireWrap® Grip Kit Black,02/19/2019,Sales Receipt,#2313,,FireWrap Grip Kit,1,34.95  ,34.95  ,"25,663.15  "
FireWrap® Grip Kit Black,02/20/2019,Invoice,1270,,,1,30.00  ,30.00  ,"25,693.15  "
FireWrap® Grip Kit Black,02/20/2019,Sales Receipt,#2319,,FireWrap Grip Kit,1,34.95  ,34.95  ,"25,728.10  "
FireWrap® Grip Kit Black,02/21/2019,Sales Receipt,#2320,,FireWrap  Grip Kit,6,34.95  ,209.70  ,"25,937.80  "
FireWrap® Grip Kit Black,02/21/2019,Sales Receipt,#2322,,FireWrap  Grip Kit,1,34.95  ,34.95  ,"25,972.75  "
FireWrap® Grip Kit Black,02/22/2019,Invoice,1283,,Thin Red Line,1,34.95  ,34.95  ,"26,007.70  "
FireWrap® Grip Kit Black,02/22/2019,Sales Receipt,#2323,,FireWrap  Grip Kit,1,34.95  ,34.95  ,"26,042.65  "
FireWrap® Grip Kit Black,02/23/2019,Sales Receipt,#2332,,FireWrap  Grip Kit,1,34.95  ,34.95  ,"26,077.60  "
FireWrap® Grip Kit Black,02/24/2019,Sales Receipt,#2334,,FireWrap Grip Kit,2,34.95  ,69.90  ,"26,147.50  "
FireWrap® Grip Kit Black,02/25/2019,Sales Receipt,#2337,,FireWrap Grip Kit,3,34.95  ,104.85  ,"26,252.35  "
FireWrap® Grip Kit Black,02/25/2019,Invoice,1279,,,5,30.00  ,150.00  ,"26,402.35  "
FireWrap® Grip Kit Black,02/26/2019,Sales Receipt,#2344,,FireWrap  Grip Kit,1,34.95  ,34.95  ,"26,437.30  "
FireWrap® Grip Kit Black,02/27/2019,Invoice,1280,,,8,28.00  ,224.00  ,"26,661.30  "
FireWrap® Grip Kit Black,02/28/2019,Sales Receipt,#2349,,FireWrap  Grip Kit,2,34.95  ,69.90  ,"26,731.20  "
FireWrap® Grip Kit Black,02/28/2019,Sales Receipt,#2353,,FireWrap Grip Kit,1,34.95  ,34.95  ,"26,766.15  "
FireWrap® Grip Kit Black,03/01/2019,Invoice,1289,,,6,30.00  ,180.00  ,"26,946.15  "
FireWrap® Grip Kit Black,03/02/2019,Sales Receipt,#2359,,FireWrap Grip Kit,1,34.95  ,34.95  ,"26,981.10  "
FireWrap® Grip Kit Black,03/03/2019,Sales Receipt,#2365,,FireWrap Grip Kit,2,34.95  ,69.90  ,"27,051.00  "
FireWrap® Grip Kit Black,03/03/2019,Sales Receipt,#2363,,FireWrap  Grip Kit,1,34.95  ,34.95  ,"27,085.95  "
FireWrap® Grip Kit Black,03/04/2019,Sales Receipt,#2367,,FireWrap Grip Kit,1,34.95  ,34.95  ,"27,120.90  "
FireWrap® Grip Kit Black,03/05/2019,Invoice,1266,,"P.O. Number: 19-0204-3 
Dayton Shireman
537 SE Canterbury LN
Lees Summit, MO 64063",2,30.00  ,60.00  ,"27,180.90  "
FireWrap® Grip Kit Black,03/06/2019,Sales Receipt,#2379,,FireWrap Grip Kit,1,34.95  ,34.95  ,"27,215.85  "
FireWrap® Grip Kit Black,03/06/2019,Sales Receipt,#2378,,FireWrap  Grip Kit,1,34.95  ,34.95  ,"27,250.80  "
FireWrap® Grip Kit Black,03/07/2019,Invoice,1292,,,1,34.95  ,34.95  ,"27,285.75  "
FireWrap® Grip Kit Black,03/08/2019,Sales Receipt,#2391,,FireWrap  Grip Kit,1,34.95  ,34.95  ,"27,320.70  "
FireWrap® Grip Kit Black,03/10/2019,Sales Receipt,#2398,,FireWrap  Grip Kit,1,34.95  ,34.95  ,"27,355.65  "
FireWrap® Grip Kit Black,03/11/2019,Invoice,1294,,Thin Red Line Edition,1,30.00  ,30.00  ,"27,385.65  "
FireWrap® Grip Kit Black,03/11/2019,Sales Receipt,#2400,,FireWrap  Grip Kit,1,34.95  ,34.95  ,"27,420.60  "
FireWrap® Grip Kit Black,03/13/2019,Sales Receipt,#2407,,FireWrap  Grip Kit,1,34.95  ,34.95  ,"27,455.55  "
FireWrap® Grip Kit Black,03/13/2019,Sales Receipt,#2411,,FireWrap  Grip Kit,1,34.95  ,34.95  ,"27,490.50  "
FireWrap® Grip Kit Black,03/16/2019,Sales Receipt,#2418,,FireWrap  Grip Kit,1,34.95  ,34.95  ,"27,525.45  "
FireWrap® Grip Kit Black,03/21/2019,Sales Receipt,#2432,,FireWrap Grip Kit,4,34.95  ,139.80  ,"27,665.25  "
FireWrap® Grip Kit Black,03/21/2019,Invoice,1305,,,1,30.00  ,30.00  ,"27,695.25  "
FireWrap® Grip Kit Black,03/22/2019,Sales Receipt,#2435,,FireWrap® Grip Kit,1,34.95  ,34.95  ,"27,730.20  "
FireWrap® Grip Kit Black,03/22/2019,Sales Receipt,#2437,,FireWrap® Grip Kit,2,34.95  ,69.90  ,"27,800.10  "
FireWrap® Grip Kit Black,03/25/2019,Sales Receipt,#2443,,FireWrap Grip Kit,1,34.95  ,34.95  ,"27,835.05  "
FireWrap® Grip Kit Black,03/29/2019,Sales Receipt,#2454,,FireWrap® Grip Kit,3,34.95  ,104.85  ,"27,939.90  "
FireWrap® Grip Kit Black,03/29/2019,Sales Receipt,#2458,,FireWrap® Grip Kit,2,34.95  ,69.90  ,"28,009.80  "
FireWrap® Grip Kit Black,04/01/2019,Sales Receipt,#2467,,FireWrap® Grip Kit,1,34.95  ,34.95  ,"28,044.75  "
FireWrap® Grip Kit Black,04/01/2019,Invoice,1316,,,3,30.00  ,90.00  ,"28,134.75  "
FireWrap® Grip Kit Black,04/01/2019,Sales Receipt,#2471,,FireWrap Grip Kit,1,34.95  ,34.95  ,"28,169.70  "
FireWrap® Grip Kit Black,04/02/2019,Sales Receipt,#2474,,FireWrap® Grip Kit,1,34.95  ,34.95  ,"28,204.65  "
FireWrap® Grip Kit Black,04/02/2019,Sales Receipt,#2476,,FireWrap Grip Kit,1,34.95  ,34.95  ,"28,239.60  "
FireWrap® Grip Kit Black,04/03/2019,Sales Receipt,#2481,,FireWrap® Grip Kit,1,34.95  ,34.95  ,"28,274.55  "
FireWrap® Grip Kit Black,04/04/2019,Sales Receipt,#2482,,FireWrap® Grip Kit,2,34.95  ,69.90  ,"28,344.45  "
FireWrap® Grip Kit Black,04/04/2019,Sales Receipt,#2488,,FireWrap® Grip Kit,1,34.95  ,34.95  ,"28,379.40  "
FireWrap® Grip Kit Black,04/05/2019,Sales Receipt,#2494,,FireWrap Grip Kit,1,34.95  ,34.95  ,"28,414.35  "
FireWrap® Grip Kit Black,04/05/2019,Sales Receipt,#2491,,FireWrap® Grip Kit,2,34.95  ,69.90  ,"28,484.25  "
FireWrap® Grip Kit Black,04/08/2019,Sales Receipt,#2500,,FireWrap® Grip Kit,1,34.95  ,34.95  ,"28,519.20  "
FireWrap® Grip Kit Black,04/11/2019,Sales Receipt,#2526,,FireWrap® Grip Kit,4,34.95  ,139.80  ,"28,659.00  "
FireWrap® Grip Kit Black,04/11/2019,Sales Receipt,#2524,,FireWrap® Grip Kit,2,34.95  ,69.90  ,"28,728.90  "
FireWrap® Grip Kit Black,04/12/2019,Sales Receipt,#2541,,FireWrap® Grip Kit,1,34.95  ,34.95  ,"28,763.85  "
FireWrap® Grip Kit Black,04/12/2019,Sales Receipt,#2527,,FireWrap® Grip Kit,1,34.95  ,34.95  ,"28,798.80  "
FireWrap® Grip Kit Black,04/12/2019,Sales Receipt,#2528,,FireWrap® Grip Kit,1,34.95  ,34.95  ,"28,833.75  "
FireWrap® Grip Kit Black,04/13/2019,Sales Receipt,#2582,,FireWrap® Grip Kit,2,34.95  ,69.90  ,"28,903.65  "
FireWrap® Grip Kit Black,04/14/2019,Sales Receipt,#2589,,FireWrap® Grip Kit,1,34.95  ,34.95  ,"28,938.60  "
FireWrap® Grip Kit Black,04/16/2019,Sales Receipt,#2593,,FireWrap® Grip Kit,1,34.95  ,34.95  ,"28,973.55  "
FireWrap® Grip Kit Black,04/17/2019,Sales Receipt,#2595,,FireWrap® Grip Kit,4,34.95  ,139.80  ,"29,113.35  "
FireWrap® Grip Kit Black,04/21/2019,Sales Receipt,#2601,,FireWrap® Grip Kit,1,34.95  ,34.95  ,"29,148.30  "
FireWrap® Grip Kit Black,04/22/2019,Sales Receipt,#2605,,FireWrap® Grip Kit,2,34.95  ,69.90  ,"29,218.20  "
FireWrap® Grip Kit Black,04/22/2019,Sales Receipt,#2607,,FireWrap® Grip Kit,1,34.95  ,34.95  ,"29,253.15  "
FireWrap® Grip Kit Black,05/15/2019,Invoice,1354,,,6,30.00  ,180.00  ,"29,433.15  "
FireWrap® Grip Kit Black,05/24/2019,Invoice,1350,,,1,30.00  ,30.00  ,"29,463.15  "
FireWrap® Grip Kit Black,06/08/2019,Invoice,1359,,,2,30.00  ,60.00  ,"29,523.15  "
FireWrap® Grip Kit Black,06/10/2019,Sales Receipt,#2677,,FireWrap® Grip Kit,1,34.95  ,34.95  ,"29,558.10  "
FireWrap® Grip Kit Black,06/10/2019,Sales Receipt,#2673,,FireWrap® Grip Kit,1,34.95  ,34.95  ,"29,593.05  "
FireWrap® Grip Kit Black,06/11/2019,Sales Receipt,#2680,,FireWrap® Grip Kit,1,34.95  ,34.95  ,"29,628.00  "
FireWrap® Grip Kit Black,06/11/2019,Invoice,1365,,,7,30.00  ,210.00  ,"29,838.00  "
FireWrap® Grip Kit Black,06/11/2019,Sales Receipt,#2681,,FireWrap® Grip Kit,1,34.95  ,34.95  ,"29,872.95  "
FireWrap® Grip Kit Black,06/14/2019,Sales Receipt,#2690,,FireWrap Grip Kit,1,34.95  ,34.95  ,"29,907.90  "
FireWrap® Grip Kit Black,06/19/2019,Sales Receipt,#2704,,FireWrap Grip Kit,1,34.95  ,34.95  ,"29,942.85  "
FireWrap® Grip Kit Black,06/20/2019,Sales Receipt,#2709,,FireWrap® Grip Kit,1,34.95  ,34.95  ,"29,977.80  "
FireWrap® Grip Kit Black,06/23/2019,Sales Receipt,#2723,,FireWrap® Grip Kit,1,34.95  ,34.95  ,"30,012.75  "
FireWrap® Grip Kit Black,06/23/2019,Sales Receipt,#2724,,FireWrap® Grip Kit,1,34.95  ,34.95  ,"30,047.70  "
FireWrap® Grip Kit Black,06/24/2019,Sales Receipt,#2727,,FireWrap® Grip Kit,1,34.95  ,34.95  ,"30,082.65  "
FireWrap® Grip Kit Black,06/25/2019,Sales Receipt,#2728,,FireWrap® Grip Kit,2,34.95  ,69.90  ,"30,152.55  "
FireWrap® Grip Kit Black,06/27/2019,Sales Receipt,#2731,,FireWrap® Grip Kit,2,34.95  ,69.90  ,"30,222.45  "
FireWrap® Grip Kit Black,06/27/2019,Sales Receipt,#2732,,FireWrap Grip Kit,1,34.95  ,34.95  ,"30,257.40  "
FireWrap® Grip Kit Black,06/28/2019,Invoice,1372,,"Matthew Sapp
7234 Waters Edge Dr
The Colony TX 75056",2,30.00  ,60.00  ,"30,317.40  "
FireWrap® Grip Kit Black,06/28/2019,Invoice,1372,,"Dan Mallory
Fort Calhoun Fire-Rescue
5543 Clearwater Dr
Fort Calhoun NE 68023",1,30.00  ,30.00  ,"30,347.40  "
FireWrap® Grip Kit Black,06/28/2019,Invoice,1372,,"Charles Cerone
282 3rd St 
Saddle Brook NJ 07663",3,30.00  ,90.00  ,"30,437.40  "
FireWrap® Grip Kit Black,06/28/2019,Invoice,1372,,"Alex Tull
417 E Liberty Ave
Spokane WA 99207",1,30.00  ,30.00  ,"30,467.40  "
FireWrap® Grip Kit Black,06/30/2019,Sales Receipt,#2736,,FireWrap Grip Kit,1,34.95  ,34.95  ,"30,502.35  "
FireWrap® Grip Kit Black,07/01/2019,Sales Receipt,#2741,,FireWrap® Grip Kit,1,34.95  ,34.95  ,"30,537.30  "
FireWrap® Grip Kit Black,07/02/2019,Invoice,1375,,,6,34.95  ,209.70  ,"30,747.00  "
FireWrap® Grip Kit Black,07/02/2019,Invoice,1361,,"P.O. Number: 19-0624-3 
Ariel Jackson
14 Firmin Way
Hanover, PA 17331",1,30.00  ,30.00  ,"30,777.00  "
FireWrap® Grip Kit Black,07/03/2019,Sales Receipt,#2749,,FireWrap Grip Kit,1,34.95  ,34.95  ,"30,811.95  "
FireWrap® Grip Kit Black,07/05/2019,Sales Receipt,#2753,,FireWrap® Grip Kit,1,34.95  ,34.95  ,"30,846.90  "
FireWrap® Grip Kit Black,07/07/2019,Sales Receipt,#2756,,FireWrap® Grip Kit,5,34.95  ,174.75  ,"31,021.65  "
FireWrap® Grip Kit Black,07/07/2019,Sales Receipt,#2758,,FireWrap Grip Kit,1,34.95  ,34.95  ,"31,056.60  "
FireWrap® Grip Kit Black,07/21/2019,Invoice,1381,,,0,,0.00  ,"31,056.60  "
FireWrap® Grip Kit Black,07/23/2019,Sales Receipt,112-9152279-2220259,,FireWrap Grip Kit (New),1,34.95  ,34.95  ,"31,091.55  "
FireWrap® Grip Kit Black,07/23/2019,Invoice,1382,,,0,,0.00  ,"31,091.55  "
FireWrap® Grip Kit Black,07/23/2019,Sales Receipt,112-3958774-9681836,,FireWrap Grip Kit (New),1,34.95  ,34.95  ,"31,126.50  "
FireWrap® Grip Kit Black,07/24/2019,Sales Receipt,112-5420335-6457825,,FireWrap Grip Kit,2,34.95  ,69.90  ,"31,196.40  "
FireWrap® Grip Kit Black,07/27/2019,Sales Receipt,112-6224469-6335459,,FireWrap Grip Kit (New),1,34.95  ,34.95  ,"31,231.35  "
FireWrap® Grip Kit Black,07/31/2019,Sales Receipt,113-8043684-4721835,,FireWrap Grip Kit (New),1,34.95  ,34.95  ,"31,266.30  "
FireWrap® Grip Kit Black,08/01/2019,Invoice,1376,,"P.O. Number: 19-0717-13 
Sean Wilson
5150 Hampshire Dr
Shelby Township, MI 48316",5,26.00  ,130.00  ,"31,396.30  "
FireWrap® Grip Kit Black,08/01/2019,Invoice,1376,,"P.O. Number: 19-0703-2
Mark Corisini
1129 S Euclid Ave
Villa Park, IL 60181",1,30.00  ,30.00  ,"31,426.30  "
FireWrap® Grip Kit Black,08/01/2019,Invoice,1376,,"P.O. Number: 19-0703-2 '
Alex Merrick
9426 East Woodmark
Conroe, TX 77304",1,26.00  ,26.00  ,"31,452.30  "
FireWrap® Grip Kit Black,08/03/2019,Sales Receipt,113-7008794-4923438,,FireWrap Grip Kit (New),1,34.95  ,34.95  ,"31,487.25  "
FireWrap® Grip Kit Black,08/07/2019,Sales Receipt,113-3988706-0585810,,FireWrap Grip Kit,1,34.95  ,34.95  ,"31,522.20  "
FireWrap® Grip Kit Black,08/09/2019,Sales Receipt,114-4478173-5664250,,FireWrap Grip Kit,1,34.95  ,34.95  ,"31,557.15  "
FireWrap® Grip Kit Black,08/09/2019,Sales Receipt,112-0348441-9098659,,FireWrap Grip Kit,1,34.95  ,34.95  ,"31,592.10  "
FireWrap® Grip Kit Black,08/22/2019,Sales Receipt,114-6241427-5312226,,FireWrap Grip Kit,1,34.95  ,34.95  ,"31,627.05  "
FireWrap® Grip Kit Black,08/23/2019,Sales Receipt,111-4427304-3749065,,FireWrap Grip Kit,1,34.95  ,34.95  ,"31,662.00  "
FireWrap® Grip Kit Black,08/30/2019,Sales Receipt,111-4196053-4458608,,FireWrap Grip Kit (New),1,34.95  ,34.95  ,"31,696.95  "
FireWrap® Grip Kit Black,09/17/2019,Sales Receipt,111-4729240-7904222,,FireWrap Grip Kit (New),15,34.95  ,524.25  ,"32,221.20  "
FireWrap® Grip Kit Black,09/18/2019,Sales Receipt,114-3511571-9665815,,FireWrap Grip Kit (New),1,34.95  ,34.95  ,"32,256.15  "
FireWrap® Grip Kit Black,09/25/2019,Sales Receipt,111-0741498-3316248,,FireWrap Grip Kit (New),2,34.95  ,69.90  ,"32,326.05  "
FireWrap® Grip Kit Black,10/07/2019,Sales Receipt,114-2282214-3773845,,FireWrap Grip Kit (New),1,34.95  ,34.95  ,"32,361.00  "
FireWrap® Grip Kit Black,10/08/2019,Sales Receipt,114-8210960-5458650,,FireWrap Grip Kit (New),1,34.95  ,34.95  ,"32,395.95  "
FireWrap® Grip Kit Black,10/08/2019,Sales Receipt,112-3334443-4333039,,FireWrap Grip Kit (New),1,34.95  ,34.95  ,"32,430.90  "
FireWrap® Grip Kit Black,10/17/2019,Sales Receipt,114-6125899-7949848,,FireWrap Grip Kit (New),1,34.95  ,34.95  ,"32,465.85  "
FireWrap® Grip Kit Black,10/18/2019,Sales Receipt,112-8700627-8353863,,FireWrap Grip Kit (New),1,34.95  ,34.95  ,"32,500.80  "
FireWrap® Grip Kit Black,10/20/2019,Sales Receipt,114-5943190-6060230,,FireWrap Grip Kit (New),1,34.95  ,34.95  ,"32,535.75  "
FireWrap® Grip Kit Black,10/20/2019,Sales Receipt,114-6866252-0837802,,FireWrap Grip Kit (New),1,34.95  ,34.95  ,"32,570.70  "
FireWrap® Grip Kit Black,10/23/2019,Sales Receipt,114-3598234-5934630,,FireWrap Grip Kit (New),2,34.95  ,69.90  ,"32,640.60  "
FireWrap® Grip Kit Black,10/28/2019,Sales Receipt,112-7547880-3518657,,FireWrap Grip Kit (New),1,34.95  ,34.95  ,"32,675.55  "
FireWrap® Grip Kit Black,10/29/2019,Sales Receipt,112-7815716-5608231,,FireWrap Grip Kit (New),2,34.95  ,69.90  ,"32,745.45  "
FireWrap® Grip Kit Black,10/30/2019,Sales Receipt,112-4582357-9823455,,FireWrap Grip Kit (New),1,34.95  ,34.95  ,"32,780.40  "
FireWrap® Grip Kit Black,11/07/2019,Sales Receipt,111-2141101-8106610,,FireWrap Grip Kit - Black (New),1,34.95  ,34.95  ,"32,815.35  "
FireWrap® Grip Kit Black,11/08/2019,Sales Receipt,113-2363679-2335422,,FireWrap Grip Kit - Black (New),5,34.95  ,174.75  ,"32,990.10  "
FireWrap® Grip Kit Black,11/19/2019,Sales Receipt,111-2380097-0563449,,FireWrap Grip Kit - Black (New),1,34.95  ,34.95  ,"33,025.05  "
FireWrap® Grip Kit Black,11/22/2019,Sales Receipt,111-9675419-6145848,,FireWrap Grip Kit - Black (New),1,34.95  ,34.95  ,"33,060.00  "
FireWrap® Grip Kit Black,11/26/2019,Sales Receipt,112-4758667-1895448,,FireWrap Grip Kit - Black (New),1,34.95  ,34.95  ,"33,094.95  "
FireWrap® Grip Kit Black,11/27/2019,Sales Receipt,111-6074798-9794603,,FireWrap Grip Kit - Black (New),1,34.95  ,34.95  ,"33,129.90  "
FireWrap® Grip Kit Black,11/30/2019,Sales Receipt,112-3754679-9855415,,FireWrap Grip Kit - Black (New),1,34.95  ,34.95  ,"33,164.85  "
FireWrap® Grip Kit Black,12/01/2019,Sales Receipt,112-1207090-2301865,,FireWrap Grip Kit - Black (New),1,34.95  ,34.95  ,"33,199.80  "
FireWrap® Grip Kit Black,12/04/2019,Sales Receipt,112-1480226-3799401,,FireWrap Grip Kit - Black (New),1,34.95  ,34.95  ,"33,234.75  "
FireWrap® Grip Kit Black,12/05/2019,Sales Receipt,112-7605696-0893826,,FireWrap Grip Kit - Black (New),1,34.95  ,34.95  ,"33,269.70  "
FireWrap® Grip Kit Black,12/06/2019,Sales Receipt,113-9955817-0409058,,FireWrap Grip Kit - Black (New),1,34.95  ,34.95  ,"33,304.65  "
FireWrap® Grip Kit Black,12/07/2019,Sales Receipt,114-8410472-5489060,,FireWrap Grip Kit - Black (New),1,34.95  ,34.95  ,"33,339.60  "
FireWrap® Grip Kit Black,12/10/2019,Sales Receipt,111-4399744-5743405,,FireWrap Grip Kit - Black (New),1,34.95  ,34.95  ,"33,374.55  "
FireWrap® Grip Kit Black,12/13/2019,Sales Receipt,111-5986357-1864242,,FireWrap Grip Kit - Black (New),1,34.95  ,34.95  ,"33,409.50  "
FireWrap® Grip Kit Black,12/13/2019,Sales Receipt,113-3989450-2874639,,FireWrap Grip Kit - Black (New),1,34.95  ,34.95  ,"33,444.45  "
FireWrap® Grip Kit Black,12/14/2019,Sales Receipt,112-9183746-7687417,,FireWrap Grip Kit - Black (New),1,34.95  ,34.95  ,"33,479.40  "
FireWrap® Grip Kit Black,12/16/2019,Sales Receipt,114-4910450-0751415,,FireWrap Grip Kit - Black (New),1,34.95  ,34.95  ,"33,514.35  "
FireWrap® Grip Kit Black,12/16/2019,Sales Receipt,112-5965764-6094642,,FireWrap Grip Kit - Black (New),1,34.95  ,34.95  ,"33,549.30  "
FireWrap® Grip Kit Black,12/28/2019,Sales Receipt,113-4842574-1688251,,FireWrap Grip Kit - Black (New),6,34.95  ,209.70  ,"33,759.00  "
FireWrap® Grip Kit Black,12/31/2019,Sales Receipt,113-8363121-3770659,,FireWrap Grip Kit - Black (New),1,34.95  ,34.95  ,"33,793.95  "
FireWrap® Grip Kit Black,01/01/2020,Sales Receipt,111-1448692-4022660,,FireWrap Grip Kit - Black (New),1,34.95  ,34.95  ,"33,828.90  "
FireWrap® Grip Kit Black,01/02/2020,Sales Receipt,112-2645334-1653000,,FireWrap Grip Kit - Black (New),1,34.95  ,34.95  ,"33,863.85  "
FireWrap® Grip Kit Black,01/05/2020,Sales Receipt,113-3447913-8091461,,FireWrap Grip Kit - Black (New),1,24.95  ,24.95  ,"33,888.80  "
FireWrap® Grip Kit Black,01/06/2020,Sales Receipt,113-4206589-5923422,,FireWrap Grip Kit - Black (New),1,24.95  ,24.95  ,"33,913.75  "
FireWrap® Grip Kit Black,01/06/2020,Sales Receipt,111-0706236-3510625,,FireWrap Grip Kit - Black (New),2,24.95  ,49.90  ,"33,963.65  "
FireWrap® Grip Kit Black,01/07/2020,Sales Receipt,112-6136051-7101034,,FireWrap Grip Kit - Black (New),1,24.95  ,24.95  ,"33,988.60  "
FireWrap® Grip Kit Black,01/07/2020,Sales Receipt,111-1067535-3549829,,FireWrap Grip Kit - Black (New),1,24.95  ,24.95  ,"34,013.55  "
FireWrap® Grip Kit Black,01/08/2020,Sales Receipt,113-1424361-5273803,,FireWrap Grip Kit - Black (New),1,24.95  ,24.95  ,"34,038.50  "
FireWrap® Grip Kit Black,01/10/2020,Sales Receipt,112-6674272-6447443,,FireWrap Grip Kit - Black (New),1,24.95  ,24.95  ,"34,063.45  "
FireWrap® Grip Kit Black,01/14/2020,Sales Receipt,114-2001683-1229045,,FireWrap Grip Kit - Black (New),1,24.95  ,24.95  ,"34,088.40  "
FireWrap® Grip Kit Black,01/15/2020,Sales Receipt,112-8237651-8045005,,FireWrap Grip Kit - Black (New),1,24.95  ,24.95  ,"34,113.35  "
FireWrap® Grip Kit Black,01/17/2020,Sales Receipt,114-7143124-3290634,,FireWrap Grip Kit - Black (New),1,24.95  ,24.95  ,"34,138.30  "
FireWrap® Grip Kit Black,01/17/2020,Sales Receipt,111-2471646-8342647,,FireWrap Grip Kit - Black (New),1,24.95  ,24.95  ,"34,163.25  "
FireWrap® Grip Kit Black,01/17/2020,Sales Receipt,114-6554577-0240224,,FireWrap Grip Kit - Black (New),1,24.95  ,24.95  ,"34,188.20  "
FireWrap® Grip Kit Black,01/19/2020,Sales Receipt,112-7101912-2657053,,FireWrap Grip Kit - Black (New),1,24.95  ,24.95  ,"34,213.15  "
FireWrap® Grip Kit Black,01/22/2020,Sales Receipt,114-8906853-7169822,,FireWrap Grip Kit - Black (New),1,24.95  ,24.95  ,"34,238.10  "
FireWrap® Grip Kit Black,01/23/2020,Sales Receipt,112-6729279-1490600,,FireWrap Grip Kit - Black (New),1,24.95  ,24.95  ,"34,263.05  "
FireWrap® Grip Kit Black,01/26/2020,Sales Receipt,113-6931499-3502640,,FireWrap Grip Kit - Black (New),1,24.95  ,24.95  ,"34,288.00  "
FireWrap® Grip Kit Black,01/26/2020,Sales Receipt,112-9546985-5411403,,FireWrap Grip Kit - Black (New),1,24.95  ,24.95  ,"34,312.95  "
FireWrap® Grip Kit Black,01/27/2020,Sales Receipt,114-9768113-0020257,,FireWrap Grip Kit - Black (New),1,24.95  ,24.95  ,"34,337.90  "
FireWrap® Grip Kit Black,01/30/2020,Sales Receipt,113-6037704-3870669,,FireWrap Grip Kit - Black (New),2,24.95  ,49.90  ,"34,387.80  "
FireWrap® Grip Kit Black,01/31/2020,Sales Receipt,113-9139089-9445038,,FireWrap Grip Kit - Black (New),1,24.95  ,24.95  ,"34,412.75  "
FireWrap® Grip Kit Black,02/02/2020,Sales Receipt,114-0916966-7640205,,FireWrap Grip Kit - Black (New),3,24.95  ,74.85  ,"34,487.60  "
FireWrap® Grip Kit Black,02/03/2020,Sales Receipt,112-1179230-2155434,,FireWrap Grip Kit - Black (New),1,24.95  ,24.95  ,"34,512.55  "
FireWrap® Grip Kit Black,02/07/2020,Sales Receipt,114-6605096-8835427,,FireWrap Grip Kit - Black (New),1,24.95  ,24.95  ,"34,537.50  "
FireWrap® Grip Kit Black,02/08/2020,Sales Receipt,112-3836115-2446630,,FireWrap Grip Kit - Black (New),1,24.95  ,24.95  ,"34,562.45  "
FireWrap® Grip Kit Black,02/13/2020,Sales Receipt,113-1622010-7476266,,FireWrap Grip Kit - Black (New),1,24.95  ,24.95  ,"34,587.40  "
FireWrap® Grip Kit Black,02/14/2020,Sales Receipt,112-9803606-8110647,,FireWrap Grip Kit - Black (New),1,24.95  ,24.95  ,"34,612.35  "
FireWrap® Grip Kit Black,02/15/2020,Sales Receipt,114-1506874-9741017,,FireWrap Grip Kit - Black (New),1,24.95  ,24.95  ,"34,637.30  "
FireWrap® Grip Kit Black,02/16/2020,Sales Receipt,113-9995187-2984224,,FireWrap Grip Kit - Black (New),1,24.95  ,24.95  ,"34,662.25  "
FireWrap® Grip Kit Black,02/19/2020,Sales Receipt,113-9845110-2540259,,FireWrap Grip Kit - Black (New),1,24.95  ,24.95  ,"34,687.20  "
FireWrap® Grip Kit Black,02/20/2020,Sales Receipt,114-1503898-9287412,,FireWrap Grip Kit - Black (New),1,24.95  ,24.95  ,"34,712.15  "
FireWrap® Grip Kit Black,02/21/2020,Sales Receipt,111-8084381-5117034,,FireWrap Grip Kit - Black (New),2,24.95  ,49.90  ,"34,762.05  "
FireWrap® Grip Kit Black,02/22/2020,Sales Receipt,112-5264645-8685050,,FireWrap Grip Kit - Black (New),1,24.95  ,24.95  ,"34,787.00  "
FireWrap® Grip Kit Black,02/23/2020,Sales Receipt,114-5175319-6631405,,FireWrap Grip Kit - Black (New),1,24.95  ,24.95  ,"34,811.95  "
FireWrap® Grip Kit Black,02/24/2020,Sales Receipt,113-5296724-0317036,,FireWrap Grip Kit - Black (New),1,24.95  ,24.95  ,"34,836.90  "
FireWrap® Grip Kit Black,02/26/2020,Sales Receipt,112-7410067-1634656,,FireWrap Grip Kit - Black (New),1,24.95  ,24.95  ,"34,861.85  "
FireWrap® Grip Kit Black,02/26/2020,Sales Receipt,114-3550778-7375412,,FireWrap Grip Kit - Black (New),1,24.95  ,24.95  ,"34,886.80  "
FireWrap® Grip Kit Black,02/27/2020,Sales Receipt,111-2049385-9421004,,FireWrap Grip Kit - Black (New),1,24.95  ,24.95  ,"34,911.75  "
FireWrap® Grip Kit Black,02/28/2020,Sales Receipt,112-7323606-3453841,,FireWrap Grip Kit - Black (New),1,24.95  ,24.95  ,"34,936.70  "
FireWrap® Grip Kit Black,03/01/2020,Sales Receipt,112-2114910-6814640,,FireWrap Grip Kit - Black (New),1,24.95  ,24.95  ,"34,961.65  "
FireWrap® Grip Kit Black,03/03/2020,Sales Receipt,113-8427333-9242654,,FireWrap Grip Kit - Black (New),1,24.95  ,24.95  ,"34,986.60  "
FireWrap® Grip Kit Black,03/06/2020,Sales Receipt,113-2248921-7324237,,FireWrap Grip Kit - Black (New),1,24.95  ,24.95  ,"35,011.55  "
FireWrap® Grip Kit Black,03/09/2020,Sales Receipt,112-2251525-4939457,,FireWrap Grip Kit - Black (New),1,24.95  ,24.95  ,"35,036.50  "
FireWrap® Grip Kit Black,03/11/2020,Sales Receipt,114-1701513-1499422,,FireWrap Grip Kit - Black (New),1,24.95  ,24.95  ,"35,061.45  "
FireWrap® Grip Kit Black,03/12/2020,Sales Receipt,113-7631376-1534639,,FireWrap Grip Kit - Black (New),1,24.95  ,24.95  ,"35,086.40  "
FireWrap® Grip Kit Black,03/12/2020,Sales Receipt,113-8804335-1105869,,FireWrap Grip Kit - Black (New),1,24.95  ,24.95  ,"35,111.35  "
FireWrap® Grip Kit Black,03/13/2020,Sales Receipt,113-8980863-4922601,,FireWrap Grip Kit - Black (New),1,24.95  ,24.95  ,"35,136.30  "
FireWrap® Grip Kit Black,03/15/2020,Sales Receipt,114-6900938-1246626,,FireWrap Grip Kit - Black (New),1,24.95  ,24.95  ,"35,161.25  "
FireWrap® Grip Kit Black,03/17/2020,Sales Receipt,113-8224129-2273054,,FireWrap Grip Kit - Black,4,24.95  ,99.80  ,"35,261.05  "
FireWrap® Grip Kit Black,03/18/2020,Sales Receipt,113-6895607-4745807,,FireWrap Grip Kit - Black (New),4,24.95  ,99.80  ,"35,360.85  "
FireWrap® Grip Kit Black,03/18/2020,Sales Receipt,113-2904325-6805029,,FireWrap Grip Kit - Black (New),1,24.95  ,24.95  ,"35,385.80  "
FireWrap® Grip Kit Black,03/20/2020,Sales Receipt,112-6403966-3331458,,FireWrap Grip Kit - Black (New),1,24.95  ,24.95  ,"35,410.75  "
FireWrap® Grip Kit Black,03/20/2020,Sales Receipt,114-1399799-6813032,,FireWrap Grip Kit - Black (New),2,24.95  ,49.90  ,"35,460.65  "
FireWrap® Grip Kit Black,03/21/2020,Sales Receipt,114-3032379-7488223,,FireWrap Grip Kit - Black (New),1,24.95  ,24.95  ,"35,485.60  "
FireWrap® Grip Kit Black,03/23/2020,Sales Receipt,111-5662148-2890642,,FireWrap Grip Kit - Black (New),1,24.95  ,24.95  ,"35,510.55  "
FireWrap® Grip Kit Black,03/24/2020,Sales Receipt,113-5185944-1169027,,FireWrap Grip Kit - Black (New),1,24.95  ,24.95  ,"35,535.50  "
FireWrap® Grip Kit Black,03/29/2020,Sales Receipt,112-5454260-2428242,,FireWrap Grip Kit - Black (New),1,24.95  ,24.95  ,"35,560.45  "
FireWrap® Grip Kit Black,03/31/2020,Sales Receipt,113-8629279-6913028,,FireWrap Grip Kit - Black (New),1,24.95  ,24.95  ,"35,585.40  "
FireWrap® Grip Kit Black,04/02/2020,Sales Receipt,112-9873686-1953059,,FireWrap Grip Kit - Black,1,24.95  ,24.95  ,"35,610.35  "
FireWrap® Grip Kit Black,04/02/2020,Sales Receipt,3604,,FireWrap® Grip Kit - Black,1,24.95  ,24.95  ,"35,635.30  "
FireWrap® Grip Kit Black,04/04/2020,Sales Receipt,112-7327806-0048212,,FireWrap Grip Kit - Black (New),2,24.95  ,49.90  ,"35,685.20  "
FireWrap® Grip Kit Black,04/04/2020,Sales Receipt,111-0444802-6273009,,FireWrap Grip Kit - Black,4,24.95  ,99.80  ,"35,785.00  "
FireWrap® Grip Kit Black,04/06/2020,Sales Receipt,3614,,FireWrap® Grip Kit - Black,1,24.95  ,24.95  ,"35,809.95  "
FireWrap® Grip Kit Black,04/07/2020,Sales Receipt,3616,,FireWrap® Grip Kit - Black,4,24.95  ,99.80  ,"35,909.75  "
FireWrap® Grip Kit Black,04/07/2020,Sales Receipt,3615,,FireWrap® Grip Kit - Black,1,24.95  ,24.95  ,"35,934.70  "
FireWrap® Grip Kit Black,04/08/2020,Sales Receipt,113-2527800-1283429,,FireWrap Grip Kit - Black (New),1,24.95  ,24.95  ,"35,959.65  "
FireWrap® Grip Kit Black,04/10/2020,Sales Receipt,113-8920924-4886631,,FireWrap Grip Kit - Black (New),1,24.95  ,24.95  ,"35,984.60  "
FireWrap® Grip Kit Black,04/10/2020,Sales Receipt,3624,,FireWrap® Grip Kit - Black,2,24.95  ,49.90  ,"36,034.50  "
FireWrap® Grip Kit Black,04/11/2020,Sales Receipt,3627,,FireWrap® Grip Kit - Black,1,24.95  ,24.95  ,"36,059.45  "
FireWrap® Grip Kit Black,04/12/2020,Sales Receipt,3629,,FireWrap® Grip Kit - Black,1,24.95  ,24.95  ,"36,084.40  "
FireWrap® Grip Kit Black,04/13/2020,Sales Receipt,3631,,FireWrap® Grip Kit - Black,1,24.95  ,24.95  ,"36,109.35  "
FireWrap® Grip Kit Black,04/16/2020,Sales Receipt,111-8630791-0921843,,FireWrap Grip Kit - Black (New),1,24.95  ,24.95  ,"36,134.30  "
FireWrap® Grip Kit Black,04/17/2020,Sales Receipt,3653,,FireWrap® Grip Kit - Black,1,24.95  ,24.95  ,"36,159.25  "
FireWrap® Grip Kit Black,04/17/2020,Sales Receipt,3650,,FireWrap® Grip Kit - Black,1,24.95  ,24.95  ,"36,184.20  "
FireWrap® Grip Kit Black,04/17/2020,Sales Receipt,111-6309213-1357058,,FireWrap Grip Kit - Black (New),1,24.95  ,24.95  ,"36,209.15  "
FireWrap® Grip Kit Black,04/17/2020,Sales Receipt,113-8631478-1570633,,FireWrap Grip Kit - Black (New),1,24.95  ,24.95  ,"36,234.10  "
FireWrap® Grip Kit Black,04/17/2020,Sales Receipt,114-1638373-2529807,,FireWrap Grip Kit - Black (New),1,24.95  ,24.95  ,"36,259.05  "
FireWrap® Grip Kit Black,04/18/2020,Sales Receipt,111-7133569-1921853,,FireWrap Grip Kit - Black (New),1,24.95  ,24.95  ,"36,284.00  "
FireWrap® Grip Kit Black,04/20/2020,Sales Receipt,3671,,FireWrap® Grip Kit - Black,1,24.95  ,24.95  ,"36,308.95  "
FireWrap® Grip Kit Black,04/20/2020,Sales Receipt,3670,,FireWrap® Grip Kit - Black,2,24.95  ,49.90  ,"36,358.85  "
FireWrap® Grip Kit Black,04/21/2020,Sales Receipt,3676,,FireWrap® Grip Kit - Black,1,24.95  ,24.95  ,"36,383.80  "
FireWrap® Grip Kit Black,04/23/2020,Sales Receipt,113-9129176-9783438,,FireWrap Grip Kit - Black (New),1,24.95  ,24.95  ,"36,408.75  "
FireWrap® Grip Kit Black,04/25/2020,Sales Receipt,113-6962002-0934657,,FireWrap Grip Kit - Black (New),1,24.95  ,24.95  ,"36,433.70  "
FireWrap® Grip Kit Black,04/27/2020,Sales Receipt,113-6882360-8022633,,FireWrap Grip Kit - Black (New),1,24.95  ,24.95  ,"36,458.65  "
FireWrap® Grip Kit Black,04/27/2020,Sales Receipt,113-4243889-6422664,,FireWrap Grip Kit - Black (New),1,24.95  ,24.95  ,"36,483.60  "
FireWrap® Grip Kit Black,04/28/2020,Sales Receipt,3703,,FireWrap® Grip Kit - Black,1,24.95  ,24.95  ,"36,508.55  "
FireWrap® Grip Kit Black,04/29/2020,Sales Receipt,3705,,FireWrap® Grip Kit - Black,1,24.95  ,24.95  ,"36,533.50  "
FireWrap® Grip Kit Black,04/29/2020,Sales Receipt,112-7298954-0466665,,FireWrap Grip Kit - Black (New),2,24.95  ,49.90  ,"36,583.40  "
FireWrap® Grip Kit Black,04/30/2020,Sales Receipt,3712,,FireWrap® Grip Kit - Black,3,24.95  ,74.85  ,"36,658.25  "
FireWrap® Grip Kit Black,04/30/2020,Sales Receipt,112-5404980-6048218,,FireWrap Grip Kit - Black (New),4,24.95  ,99.80  ,"36,758.05  "
FireWrap® Grip Kit Black,05/02/2020,Sales Receipt,114-0127942-6283460,,FireWrap Grip Kit - Black (New),1,24.95  ,24.95  ,"36,783.00  "
FireWrap® Grip Kit Black,05/04/2020,Sales Receipt,113-0198138-8491413,,FireWrap Grip Kit - Black (New),1,24.95  ,24.95  ,"36,807.95  "
FireWrap® Grip Kit Black,05/05/2020,Sales Receipt,3725,,FireWrap® Grip Kit - Black,1,24.95  ,24.95  ,"36,832.90  "
FireWrap® Grip Kit Black,05/06/2020,Sales Receipt,3729,,FireWrap® Grip Kit - Black,4,24.95  ,99.80  ,"36,932.70  "
FireWrap® Grip Kit Black,05/06/2020,Sales Receipt,3730,,FireWrap® Grip Kit - Black,10,24.95  ,249.50  ,"37,182.20  "
FireWrap® Grip Kit Black,05/06/2020,Sales Receipt,3731,,FireWrap® Grip Kit - Black,1,24.95  ,24.95  ,"37,207.15  "
FireWrap® Grip Kit Black,05/07/2020,Sales Receipt,3739,,FireWrap® Grip Kit - Black,1,24.95  ,24.95  ,"37,232.10  "
FireWrap® Grip Kit Black,05/09/2020,Sales Receipt,3748,,FireWrap® Grip Kit - Black,2,24.95  ,49.90  ,"37,282.00  "
FireWrap® Grip Kit Black,05/11/2020,Sales Receipt,3753,,FireWrap® Grip Kit - Black,2,24.95  ,49.90  ,"37,331.90  "
FireWrap® Grip Kit Black,05/13/2020,Sales Receipt,3763,,FireWrap® Grip Kit - Black,1,24.95  ,24.95  ,"37,356.85  "
FireWrap® Grip Kit Black,05/14/2020,Sales Receipt,3765,,FireWrap® Grip Kit - Black,1,24.95  ,24.95  ,"37,381.80  "
FireWrap® Grip Kit Black,05/18/2020,Sales Receipt,3776,,FireWrap® Grip Kit - Black,3,24.95  ,74.85  ,"37,456.65  "
FireWrap® Grip Kit Black,05/18/2020,Sales Receipt,3777,,FireWrap® Grip Kit - Black,1,24.95  ,24.95  ,"37,481.60  "
FireWrap® Grip Kit Black,05/19/2020,Sales Receipt,3783,,FireWrap® Grip Kit - Black,1,24.95  ,24.95  ,"37,506.55  "
FireWrap® Grip Kit Black,05/19/2020,Sales Receipt,3782,,FireWrap® Grip Kit - Black,1,24.95  ,24.95  ,"37,531.50  "
FireWrap® Grip Kit Black,05/21/2020,Sales Receipt,3785,,FireWrap® Grip Kit - Black,17,24.95  ,424.15  ,"37,955.65  "
FireWrap® Grip Kit Black,05/21/2020,Sales Receipt,3787,,FireWrap® Grip Kit - Black,1,24.95  ,24.95  ,"37,980.60  "
FireWrap® Grip Kit Black,05/22/2020,Sales Receipt,3789,,FireWrap® Grip Kit - Black,1,24.95  ,24.95  ,"38,005.55  "
FireWrap® Grip Kit Black,05/25/2020,Sales Receipt,3795,,FireWrap® Grip Kit - Black,1,24.95  ,24.95  ,"38,030.50  "
FireWrap® Grip Kit Black,05/26/2020,Sales Receipt,3799,,FireWrap® Grip Kit - Black,1,24.95  ,24.95  ,"38,055.45  "
FireWrap® Grip Kit Black,05/26/2020,Sales Receipt,3800,,FireWrap® Grip Kit - Black,1,24.95  ,24.95  ,"38,080.40  "
FireWrap® Grip Kit Black,05/28/2020,Sales Receipt,3805,,FireWrap® Grip Kit - Black,1,24.95  ,24.95  ,"38,105.35  "
FireWrap® Grip Kit Black,05/28/2020,Sales Receipt,3807,,FireWrap® Grip Kit - Black,1,24.95  ,24.95  ,"38,130.30  "
FireWrap® Grip Kit Black,05/29/2020,Sales Receipt,3811,,FireWrap® Grip Kit - Black,4,24.95  ,99.80  ,"38,230.10  "
FireWrap® Grip Kit Black,05/31/2020,Sales Receipt,3816,,FireWrap® Grip Kit - Black,1,24.95  ,24.95  ,"38,255.05  "
FireWrap® Grip Kit Black,06/01/2020,Sales Receipt,3818,,FireWrap® Grip Kit - Black,1,24.95  ,24.95  ,"38,280.00  "
FireWrap® Grip Kit Black,06/04/2020,Sales Receipt,3823,,FireWrap® Grip Kit - Black,6,24.95  ,149.70  ,"38,429.70  "
FireWrap® Grip Kit Black,06/06/2020,Sales Receipt,3829,,FireWrap® Grip Kit - Black,1,24.95  ,24.95  ,"38,454.65  "
FireWrap® Grip Kit Black,06/09/2020,Sales Receipt,3840,,FireWrap® Grip Kit - Black,1,24.95  ,24.95  ,"38,479.60  "
FireWrap® Grip Kit Black,06/09/2020,Sales Receipt,3841,,FireWrap® Grip Kit - Black,1,24.95  ,24.95  ,"38,504.55  "
FireWrap® Grip Kit Black,06/13/2020,Sales Receipt,3858,,FireWrap® Grip Kit - Black,1,24.95  ,24.95  ,"38,529.50  "
FireWrap® Grip Kit Black,06/14/2020,Sales Receipt,3859,,FireWrap® Grip Kit - Black,1,24.95  ,24.95  ,"38,554.45  "
FireWrap® Grip Kit Black,06/15/2020,Sales Receipt,3866,,FireWrap® Grip Kit - Black,1,24.95  ,24.95  ,"38,579.40  "
FireWrap® Grip Kit Black,06/15/2020,Sales Receipt,3869,,FireWrap® Grip Kit - Black,1,24.95  ,24.95  ,"38,604.35  "
FireWrap® Grip Kit Black,06/15/2020,Sales Receipt,3868,,FireWrap® Grip Kit - Black,1,24.95  ,24.95  ,"38,629.30  "
FireWrap® Grip Kit Black,06/15/2020,Sales Receipt,3862,,FireWrap® Grip Kit - Black,1,24.95  ,24.95  ,"38,654.25  "
FireWrap® Grip Kit Black,06/16/2020,Sales Receipt,3870,,FireWrap® Grip Kit - Black,6,24.95  ,149.70  ,"38,803.95  "
FireWrap® Grip Kit Black,06/17/2020,Sales Receipt,3874,,FireWrap® Grip Kit - Black,1,24.95  ,24.95  ,"38,828.90  "
FireWrap® Grip Kit Black,06/17/2020,Sales Receipt,3873,,FireWrap® Grip Kit - Black,1,24.95  ,24.95  ,"38,853.85  "
FireWrap® Grip Kit Black,06/21/2020,Sales Receipt,3927,,FireWrap® Grip Kit - Black,3,24.95  ,74.85  ,"38,928.70  "
FireWrap® Grip Kit Black,06/22/2020,Sales Receipt,3935,,FireWrap® Grip Kit - Black,1,24.95  ,24.95  ,"38,953.65  "
FireWrap® Grip Kit Black,06/22/2020,Sales Receipt,3939,,FireWrap® Grip Kit - Black,1,24.95  ,24.95  ,"38,978.60  "
FireWrap® Grip Kit Black,06/23/2020,Sales Receipt,3943,,FireWrap® Grip Kit - Black,1,24.95  ,24.95  ,"39,003.55  "
FireWrap® Grip Kit Black,06/25/2020,Sales Receipt,3950,,FireWrap® Grip Kit - Black,3,24.95  ,74.85  ,"39,078.40  "
FireWrap® Grip Kit Black,06/25/2020,Sales Receipt,3949,,FireWrap® Grip Kit - Black,1,24.95  ,24.95  ,"39,103.35  "
FireWrap® Grip Kit Black,06/26/2020,Sales Receipt,3956,,FireWrap® Grip Kit - Black,1,24.95  ,24.95  ,"39,128.30  "
FireWrap® Grip Kit Black,06/28/2020,Sales Receipt,3970,,FireWrap® Grip Kit - Black,1,24.95  ,24.95  ,"39,153.25  "
FireWrap® Grip Kit Black,06/29/2020,Sales Receipt,3972,,FireWrap® Grip Kit - Black,2,24.95  ,49.90  ,"39,203.15  "
FireWrap® Grip Kit Black,07/01/2020,Sales Receipt,3982,,FireWrap® Grip Kit - Black,1,24.95  ,24.95  ,"39,228.10  "
FireWrap® Grip Kit Black,07/03/2020,Sales Receipt,3986,,FireWrap® Grip Kit - Black,1,24.95  ,24.95  ,"39,253.05  "
FireWrap® Grip Kit Black,07/08/2020,Sales Receipt,3999,,FireWrap® Grip Kit - Black,1,24.95  ,24.95  ,"39,278.00  "
FireWrap® Grip Kit Black,07/09/2020,Sales Receipt,4001,,FireWrap® Grip Kit - Black,1,24.95  ,24.95  ,"39,302.95  "
FireWrap® Grip Kit Black,07/09/2020,Sales Receipt,4003,,FireWrap® Grip Kit - Black,4,24.95  ,99.80  ,"39,402.75  "
FireWrap® Grip Kit Black,07/10/2020,Sales Receipt,4006,,FireWrap® Grip Kit - Black,1,24.95  ,24.95  ,"39,427.70  "
FireWrap® Grip Kit Black,07/10/2020,Sales Receipt,4010,,FireWrap® Grip Kit - Black,1,24.95  ,24.95  ,"39,452.65  "
FireWrap® Grip Kit Black,07/10/2020,Sales Receipt,4009,,FireWrap® Grip Kit - Black,1,24.95  ,24.95  ,"39,477.60  "
FireWrap® Grip Kit Black,07/11/2020,Sales Receipt,4012,,FireWrap® Grip Kit - Black,1,24.95  ,24.95  ,"39,502.55  "
FireWrap® Grip Kit Black,07/13/2020,Sales Receipt,4018,,FireWrap® Grip Kit - Black,1,24.95  ,24.95  ,"39,527.50  "
FireWrap® Grip Kit Black,07/13/2020,Sales Receipt,4016,,FireWrap® Grip Kit - Black,1,24.95  ,24.95  ,"39,552.45  "
FireWrap® Grip Kit Black,07/18/2020,Sales Receipt,4032,,FireWrap® Grip Kit - Black,1,24.95  ,24.95  ,"39,577.40  "
FireWrap® Grip Kit Black,07/19/2020,Sales Receipt,4033,,FireWrap® Grip Kit - Black,1,24.95  ,24.95  ,"39,602.35  "
FireWrap® Grip Kit Black,07/22/2020,Sales Receipt,4039,,FireWrap® Grip Kit - Black,1,24.95  ,24.95  ,"39,627.30  "
FireWrap® Grip Kit Black,07/23/2020,Sales Receipt,4042,,FireWrap® Grip Kit - Black,1,24.95  ,24.95  ,"39,652.25  "
FireWrap® Grip Kit Black,07/29/2020,Sales Receipt,4063,,FireWrap® Grip Kit - Black,1,24.95  ,24.95  ,"39,677.20  "
FireWrap® Grip Kit Black,07/30/2020,Sales Receipt,4070,,FireWrap® Grip Kit - Black,1,24.95  ,24.95  ,"39,702.15  "
FireWrap® Grip Kit Black,08/04/2020,Sales Receipt,4079,,FireWrap® Grip Kit - Black,1,24.95  ,24.95  ,"39,727.10  "
FireWrap® Grip Kit Black,08/05/2020,Sales Receipt,4080,,FireWrap® Grip Kit - Black,8,24.95  ,199.60  ,"39,926.70  "
FireWrap® Grip Kit Black,08/07/2020,Sales Receipt,4084,,FireWrap® Grip Kit - Black,1,24.95  ,24.95  ,"39,951.65  "
FireWrap® Grip Kit Black,08/08/2020,Sales Receipt,4087,,FireWrap® Grip Kit - Black,1,24.95  ,24.95  ,"39,976.60  "
FireWrap® Grip Kit Black,08/10/2020,Sales Receipt,4094,,FireWrap® Grip Kit - Black,1,24.95  ,24.95  ,"40,001.55  "
FireWrap® Grip Kit Black,08/14/2020,Sales Receipt,4106,,FireWrap® Grip Kit - Black,4,24.95  ,99.80  ,"40,101.35  "
FireWrap® Grip Kit Black,08/15/2020,Sales Receipt,4108,,FireWrap® Grip Kit - Black,1,24.95  ,24.95  ,"40,126.30  "
FireWrap® Grip Kit Black,08/16/2020,Sales Receipt,4110,,FireWrap® Grip Kit - Black,1,24.95  ,24.95  ,"40,151.25  "
FireWrap® Grip Kit Black,08/17/2020,Sales Receipt,4117,,FireWrap® Grip Kit - Black,1,24.95  ,24.95  ,"40,176.20  "
FireWrap® Grip Kit Black,08/17/2020,Sales Receipt,4113,,FireWrap® Grip Kit - Black,1,24.95  ,24.95  ,"40,201.15  "
FireWrap® Grip Kit Black,08/18/2020,Sales Receipt,4118,,FireWrap® Grip Kit - Black,1,24.95  ,24.95  ,"40,226.10  "
FireWrap® Grip Kit Black,08/20/2020,Sales Receipt,4132,,FireWrap® Grip Kit - Black,1,24.95  ,24.95  ,"40,251.05  "
FireWrap® Grip Kit Black,08/20/2020,Sales Receipt,4131,,FireWrap® Grip Kit - Black,1,24.95  ,24.95  ,"40,276.00  "
FireWrap® Grip Kit Black,08/21/2020,Sales Receipt,4135,,FireWrap® Grip Kit - Black,1,24.95  ,24.95  ,"40,300.95  "
FireWrap® Grip Kit Black,08/23/2020,Sales Receipt,4146,,FireWrap® Grip Kit - Black,1,24.95  ,24.95  ,"40,325.90  "
FireWrap® Grip Kit Black,08/24/2020,Sales Receipt,4152,,FireWrap® Grip Kit - Black,2,24.95  ,49.90  ,"40,375.80  "
FireWrap® Grip Kit Black,08/24/2020,Sales Receipt,4149,,FireWrap® Grip Kit - Black,2,24.95  ,49.90  ,"40,425.70  "
FireWrap® Grip Kit Black,08/28/2020,Sales Receipt,4162,,FireWrap® Grip Kit - Black,1,24.95  ,24.95  ,"40,450.65  "
FireWrap® Grip Kit Black,08/29/2020,Sales Receipt,4165,,FireWrap® Grip Kit - Black,1,24.95  ,24.95  ,"40,475.60  "
FireWrap® Grip Kit Black,08/31/2020,Sales Receipt,4170,,FireWrap® Grip Kit - Black,1,24.95  ,24.95  ,"40,500.55  "
FireWrap® Grip Kit Black,09/01/2020,Sales Receipt,4175,,FireWrap® Grip Kit - Black,1,24.95  ,24.95  ,"40,525.50  "
FireWrap® Grip Kit Black,09/01/2020,Sales Receipt,4174,,FireWrap® Grip Kit - Black,2,24.95  ,49.90  ,"40,575.40  "
FireWrap® Grip Kit Black,09/01/2020,Sales Receipt,4177,,FireWrap® Grip Kit - Black,2,24.95  ,49.90  ,"40,625.30  "
FireWrap® Grip Kit Black,09/02/2020,Sales Receipt,4178,,FireWrap® Grip Kit - Black,2,24.95  ,49.90  ,"40,675.20  "
FireWrap® Grip Kit Black,09/02/2020,Sales Receipt,4179,,FireWrap® Grip Kit - Black,3,24.95  ,74.85  ,"40,750.05  "
FireWrap® Grip Kit Black,09/02/2020,Sales Receipt,4182,,FireWrap® Grip Kit - Black,1,24.95  ,24.95  ,"40,775.00  "
FireWrap® Grip Kit Black,09/03/2020,Sales Receipt,4188,,FireWrap® Grip Kit - Black,1,24.95  ,24.95  ,"40,799.95  "
FireWrap® Grip Kit Black,09/14/2020,Sales Receipt,4213,,FireWrap® Grip Kit - Black,2,24.95  ,49.90  ,"40,849.85  "
FireWrap® Grip Kit Black,09/15/2020,Sales Receipt,4216,,FireWrap® Grip Kit - Black,1,24.95  ,24.95  ,"40,874.80  "
FireWrap® Grip Kit Black,09/15/2020,Sales Receipt,4218,,FireWrap® Grip Kit - Black,1,24.95  ,24.95  ,"40,899.75  "
FireWrap® Grip Kit Black,09/16/2020,Sales Receipt,4221,,FireWrap® Grip Kit - Black,1,24.95  ,24.95  ,"40,924.70  "
FireWrap® Grip Kit Black,09/17/2020,Sales Receipt,4224,,FireWrap® Grip Kit - Black,1,24.95  ,24.95  ,"40,949.65  "
FireWrap® Grip Kit Black,09/17/2020,Sales Receipt,4225,,FireWrap® Grip Kit - Black,1,24.95  ,24.95  ,"40,974.60  "
FireWrap® Grip Kit Black,09/19/2020,Sales Receipt,4240,,FireWrap® Grip Kit - Black,1,24.95  ,24.95  ,"40,999.55  "
FireWrap® Grip Kit Black,09/20/2020,Sales Receipt,4243,,FireWrap® Grip Kit - Black,1,24.95  ,24.95  ,"41,024.50  "
FireWrap® Grip Kit Black,09/21/2020,Sales Receipt,4252,,FireWrap® Grip Kit - Black,1,24.95  ,24.95  ,"41,049.45  "
FireWrap® Grip Kit Black,09/21/2020,Sales Receipt,4248,,FireWrap® Grip Kit - Black,1,24.95  ,24.95  ,"41,074.40  "
FireWrap® Grip Kit Black,09/21/2020,Sales Receipt,4251,,FireWrap® Grip Kit - Black,1,24.95  ,24.95  ,"41,099.35  "
FireWrap® Grip Kit Black,09/23/2020,Sales Receipt,4263,,FireWrap® Grip Kit - Black,2,24.95  ,49.90  ,"41,149.25  "
FireWrap® Grip Kit Black,09/24/2020,Sales Receipt,4266,,FireWrap® Grip Kit - Black,1,24.95  ,24.95  ,"41,174.20  "
FireWrap® Grip Kit Black,09/24/2020,Sales Receipt,4268,,FireWrap® Grip Kit - Black,1,24.95  ,24.95  ,"41,199.15  "
FireWrap® Grip Kit Black,09/26/2020,Sales Receipt,4275,,FireWrap® Grip Kit - Black,1,24.95  ,24.95  ,"41,224.10  "
FireWrap® Grip Kit Black,09/26/2020,Sales Receipt,4276,,FireWrap® Grip Kit - Black,1,24.95  ,24.95  ,"41,249.05  "
FireWrap® Grip Kit Black,09/30/2020,Sales Receipt,4285,,FireWrap® Grip Kit - Black,1,24.95  ,24.95  ,"41,274.00  "
FireWrap® Grip Kit Black,09/30/2020,Sales Receipt,4282,,FireWrap® Grip Kit - Black,2,24.95  ,49.90  ,"41,323.90  "
FireWrap® Grip Kit Black,10/02/2020,Sales Receipt,4290,,FireWrap® Grip Kit - Black,1,24.95  ,24.95  ,"41,348.85  "
FireWrap® Grip Kit Black,10/03/2020,Sales Receipt,4294,,FireWrap® Grip Kit - Black,2,24.95  ,49.90  ,"41,398.75  "
FireWrap® Grip Kit Black,10/03/2020,Sales Receipt,4296,,FireWrap® Grip Kit - Black,1,24.95  ,24.95  ,"41,423.70  "
FireWrap® Grip Kit Black,10/04/2020,Sales Receipt,4298,,FireWrap® Grip Kit - Black,1,24.95  ,24.95  ,"41,448.65  "
FireWrap® Grip Kit Black,10/05/2020,Sales Receipt,4307,,FireWrap® Grip Kit - Black,1,24.95  ,24.95  ,"41,473.60  "
FireWrap® Grip Kit Black,10/05/2020,Sales Receipt,4306,,FireWrap® Grip Kit - Black,1,24.95  ,24.95  ,"41,498.55  "
FireWrap® Grip Kit Black,10/06/2020,Sales Receipt,4314,,FireWrap® Grip Kit - Black,5,24.95  ,124.75  ,"41,623.30  "
FireWrap® Grip Kit Black,10/08/2020,Sales Receipt,4326,,FireWrap® Grip Kit - Black,1,24.95  ,24.95  ,"41,648.25  "
FireWrap® Grip Kit Black,10/09/2020,Sales Receipt,4333,,FireWrap® Grip Kit - Black,1,24.95  ,24.95  ,"41,673.20  "
FireWrap® Grip Kit Black,10/13/2020,Sales Receipt,4347,,FireWrap® Grip Kit - Black,1,24.95  ,24.95  ,"41,698.15  "
FireWrap® Grip Kit Black,10/14/2020,Sales Receipt,4349,,FireWrap® Grip Kit - Black,1,24.95  ,24.95  ,"41,723.10  "
FireWrap® Grip Kit Black,10/17/2020,Sales Receipt,4362,,FireWrap® Grip Kit - Black,2,24.95  ,49.90  ,"41,773.00  "
FireWrap® Grip Kit Black,10/18/2020,Sales Receipt,4363,,FireWrap® Grip Kit - Black,1,24.95  ,24.95  ,"41,797.95  "
FireWrap® Grip Kit Black,10/19/2020,Sales Receipt,4372,,FireWrap® Grip Kit - Black,1,24.95  ,24.95  ,"41,822.90  "
FireWrap® Grip Kit Black,10/20/2020,Sales Receipt,4380,,FireWrap® Grip Kit - Black,1,24.95  ,24.95  ,"41,847.85  "
FireWrap® Grip Kit Black,10/20/2020,Sales Receipt,4381,,FireWrap® Grip Kit - Black,2,24.95  ,49.90  ,"41,897.75  "
FireWrap® Grip Kit Black,10/21/2020,Sales Receipt,4385,,FireWrap® Grip Kit - Black,1,24.95  ,24.95  ,"41,922.70  "
FireWrap® Grip Kit Black,10/23/2020,Sales Receipt,4399,,FireWrap® Grip Kit - Black,1,24.95  ,24.95  ,"41,947.65  "
FireWrap® Grip Kit Black,10/24/2020,Sales Receipt,4402,,FireWrap® Grip Kit - Black,1,24.95  ,24.95  ,"41,972.60  "
FireWrap® Grip Kit Black,10/26/2020,Sales Receipt,4416,,FireWrap® Grip Kit - Black,1,24.95  ,24.95  ,"41,997.55  "
FireWrap® Grip Kit Black,10/26/2020,Sales Receipt,4417,,FireWrap® Grip Kit - Black,1,24.95  ,24.95  ,"42,022.50  "
FireWrap® Grip Kit Black,10/27/2020,Sales Receipt,4425,,FireWrap® Grip Kit - Black,1,24.95  ,24.95  ,"42,047.45  "
FireWrap® Grip Kit Black,10/27/2020,Sales Receipt,4423,,FireWrap® Grip Kit - Black,10,24.95  ,249.50  ,"42,296.95  "
FireWrap® Grip Kit Black,11/01/2020,Sales Receipt,4447,,FireWrap® Grip Kit - Black,2,24.95  ,49.90  ,"42,346.85  "
FireWrap® Grip Kit Black,11/06/2020,Sales Receipt,4466,,FireWrap® Grip Kit - Black,3,24.95  ,74.85  ,"42,421.70  "
FireWrap® Grip Kit Black,11/09/2020,Sales Receipt,4482,,FireWrap® Grip Kit - Black,2,24.95  ,49.90  ,"42,471.60  "
FireWrap® Grip Kit Black,11/11/2020,Sales Receipt,4490,,FireWrap® Grip Kit - Black,1,24.95  ,24.95  ,"42,496.55  "
FireWrap® Grip Kit Black,11/12/2020,Sales Receipt,4497,,FireWrap® Grip Kit - Black,1,24.95  ,24.95  ,"42,521.50  "
FireWrap® Grip Kit Black,11/12/2020,Sales Receipt,4501,,FireWrap® Grip Kit - Black,2,24.95  ,49.90  ,"42,571.40  "
FireWrap® Grip Kit Black,11/12/2020,Sales Receipt,4499,,FireWrap® Grip Kit - Black,1,24.95  ,24.95  ,"42,596.35  "
FireWrap® Grip Kit Black,11/17/2020,Sales Receipt,4519,,FireWrap® Grip Kit - Black,3,24.95  ,74.85  ,"42,671.20  "
FireWrap® Grip Kit Black,11/19/2020,Sales Receipt,4528,,FireWrap® Grip Kit - Black,1,24.95  ,24.95  ,"42,696.15  "
FireWrap® Grip Kit Black,11/24/2020,Sales Receipt,4545,,FireWrap® Grip Kit - Black,6,24.95  ,149.70  ,"42,845.85  "
FireWrap® Grip Kit Black,11/25/2020,Sales Receipt,4552,,FireWrap® Grip Kit - Black,1,24.95  ,24.95  ,"42,870.80  "
FireWrap® Grip Kit Black,11/27/2020,Sales Receipt,4578,,FireWrap® Grip Kit - Black,1,24.95  ,24.95  ,"42,895.75  "
FireWrap® Grip Kit Black,11/28/2020,Sales Receipt,4587,,FireWrap® Grip Kit - Black,1,24.95  ,24.95  ,"42,920.70  "
FireWrap® Grip Kit Black,11/28/2020,Sales Receipt,4584,,FireWrap® Grip Kit - Black,1,24.95  ,24.95  ,"42,945.65  "
FireWrap® Grip Kit Black,11/28/2020,Sales Receipt,4590,,FireWrap® Grip Kit - Black,1,24.95  ,24.95  ,"42,970.60  "
FireWrap® Grip Kit Black,11/29/2020,Sales Receipt,4597,,FireWrap® Grip Kit - Black,1,24.95  ,24.95  ,"42,995.55  "
FireWrap® Grip Kit Black,11/29/2020,Sales Receipt,4595,,FireWrap® Grip Kit - Black,1,24.95  ,24.95  ,"43,020.50  "
FireWrap® Grip Kit Black,11/30/2020,Sales Receipt,4599,,FireWrap® Grip Kit - Black,1,24.95  ,24.95  ,"43,045.45  "
FireWrap® Grip Kit Black,11/30/2020,Sales Receipt,4609,,FireWrap® Grip Kit - Black,1,24.95  ,24.95  ,"43,070.40  "
FireWrap® Grip Kit Black,11/30/2020,Sales Receipt,4598,,FireWrap® Grip Kit - Black,1,24.95  ,24.95  ,"43,095.35  "
FireWrap® Grip Kit Black,11/30/2020,Sales Receipt,4600,,FireWrap® Grip Kit - Black,2,24.95  ,49.90  ,"43,145.25  "
FireWrap® Grip Kit Black,12/01/2020,Sales Receipt,4613,,FireWrap® Grip Kit - Black,1,24.95  ,24.95  ,"43,170.20  "
FireWrap® Grip Kit Black,12/02/2020,Sales Receipt,4616,,FireWrap® Grip Kit - Black,1,24.95  ,24.95  ,"43,195.15  "
FireWrap® Grip Kit Black,12/02/2020,Sales Receipt,4618,,FireWrap® Grip Kit - Black,1,24.95  ,24.95  ,"43,220.10  "
FireWrap® Grip Kit Black,12/03/2020,Sales Receipt,4622,,FireWrap® Grip Kit - Black,1,24.95  ,24.95  ,"43,245.05  "
FireWrap® Grip Kit Black,12/03/2020,Sales Receipt,4623,,FireWrap® Grip Kit - Black,1,24.95  ,24.95  ,"43,270.00  "
FireWrap® Grip Kit Black,12/05/2020,Sales Receipt,4631,,FireWrap® Grip Kit - Black,2,24.95  ,49.90  ,"43,319.90  "
FireWrap® Grip Kit Black,12/06/2020,Sales Receipt,4634,,FireWrap® Grip Kit - Black,1,24.95  ,24.95  ,"43,344.85  "
FireWrap® Grip Kit Black,12/06/2020,Sales Receipt,4636,,FireWrap® Grip Kit - Black,1,24.95  ,24.95  ,"43,369.80  "
FireWrap® Grip Kit Black,12/07/2020,Sales Receipt,4643,,FireWrap® Grip Kit - Black,1,24.95  ,24.95  ,"43,394.75  "
FireWrap® Grip Kit Black,12/07/2020,Sales Receipt,4644,,FireWrap® Grip Kit - Black,1,24.95  ,24.95  ,"43,419.70  "
FireWrap® Grip Kit Black,12/07/2020,Sales Receipt,4640,,FireWrap® Grip Kit - Black,1,24.95  ,24.95  ,"43,444.65  "
FireWrap® Grip Kit Black,12/09/2020,Sales Receipt,4654,,FireWrap® Grip Kit - Black,1,24.95  ,24.95  ,"43,469.60  "
FireWrap® Grip Kit Black,12/10/2020,Sales Receipt,4658,,FireWrap® Grip Kit - Black,1,24.95  ,24.95  ,"43,494.55  "
FireWrap® Grip Kit Black,12/10/2020,Sales Receipt,4659,,FireWrap® Grip Kit - Black,1,24.95  ,24.95  ,"43,519.50  "
FireWrap® Grip Kit Black,12/11/2020,Sales Receipt,4669,,FireWrap® Grip Kit - Black,1,24.95  ,24.95  ,"43,544.45  "
FireWrap® Grip Kit Black,12/12/2020,Sales Receipt,4670,,FireWrap® Grip Kit - Black,1,24.95  ,24.95  ,"43,569.40  "
FireWrap® Grip Kit Black,12/15/2020,Sales Receipt,4682,,FireWrap® Grip Kit - Black,4,24.95  ,99.80  ,"43,669.20  "
FireWrap® Grip Kit Black,12/16/2020,Sales Receipt,4687,,FireWrap® Grip Kit - Black,2,24.95  ,49.90  ,"43,719.10  "
FireWrap® Grip Kit Black,12/17/2020,Sales Receipt,4691,,FireWrap® Grip Kit - Black,1,24.95  ,24.95  ,"43,744.05  "
FireWrap® Grip Kit Black,12/18/2020,Sales Receipt,4694,,FireWrap® Grip Kit - Black,1,24.95  ,24.95  ,"43,769.00  "
FireWrap® Grip Kit Black,12/18/2020,Invoice,M-121820-006,,FireWrap® Grip Kit Black,5,18.75  ,93.75  ,"43,862.75  "
FireWrap® Grip Kit Black,12/25/2020,Sales Receipt,4737,,FireWrap® Grip Kit - Black,9,24.95  ,224.55  ,"44,087.30  "
FireWrap® Grip Kit Black,12/27/2020,Sales Receipt,4744,,FireWrap® Grip Kit - Black,1,24.95  ,24.95  ,"44,112.25  "
FireWrap® Grip Kit Black,12/27/2020,Sales Receipt,4750,,FireWrap® Grip Kit - Black,1,24.95  ,24.95  ,"44,137.20  "
FireWrap® Grip Kit Black,12/27/2020,Sales Receipt,4749,,FireWrap® Grip Kit - Black,1,24.95  ,24.95  ,"44,162.15  "
FireWrap® Grip Kit Black,12/28/2020,Sales Receipt,4754,,FireWrap® Grip Kit - Black,3,24.95  ,74.85  ,"44,237.00  "
FireWrap® Grip Kit Black,12/31/2020,Sales Receipt,4770,,FireWrap® Grip Kit - Black,1,24.95  ,24.95  ,"44,261.95  "
FireWrap® Grip Kit Black,12/31/2020,Sales Receipt,4765,,FireWrap® Grip Kit - Black,1,24.95  ,24.95  ,"44,286.90  "
FireWrap® Grip Kit Black,01/01/2021,Sales Receipt,4778,,FireWrap® Grip Kit - Black,1,24.95  ,24.95  ,"44,311.85  "
FireWrap® Grip Kit Black,01/02/2021,Sales Receipt,4781,,FireWrap® Grip Kit - Black,1,24.95  ,24.95  ,"44,336.80  "
FireWrap® Grip Kit Black,01/04/2021,Sales Receipt,4790,,FireWrap® Grip Kit - Black,1,24.95  ,24.95  ,"44,361.75  "
FireWrap® Grip Kit Black,01/04/2021,Sales Receipt,4788,,FireWrap® Grip Kit - Black,1,24.95  ,24.95  ,"44,386.70  "
FireWrap® Grip Kit Black,01/05/2021,Sales Receipt,4794,,FireWrap® Grip Kit - Black,1,24.95  ,24.95  ,"44,411.65  "
FireWrap® Grip Kit Black,01/07/2021,Sales Receipt,4798,,FireWrap® Grip Kit - Black,3,24.95  ,74.85  ,"44,486.50  "
FireWrap® Grip Kit Black,01/07/2021,Sales Receipt,4800,,FireWrap® Grip Kit - Black,1,24.95  ,24.95  ,"44,511.45  "
FireWrap® Grip Kit Black,01/09/2021,Sales Receipt,4818,,FireWrap® Grip Kit - Black,1,24.95  ,24.95  ,"44,536.40  "
FireWrap® Grip Kit Black,01/10/2021,Sales Receipt,4821,,FireWrap® Grip Kit - Black,1,24.95  ,24.95  ,"44,561.35  "
FireWrap® Grip Kit Black,01/13/2021,Sales Receipt,4832,,FireWrap® Grip Kit - Black,1,24.95  ,24.95  ,"44,586.30  "
FireWrap® Grip Kit Black,01/13/2021,Sales Receipt,4831,,FireWrap® Grip Kit - Black,2,24.95  ,49.90  ,"44,636.20  "
FireWrap® Grip Kit Black,01/14/2021,Sales Receipt,4839,,FireWrap® Grip Kit - Black,1,24.95  ,24.95  ,"44,661.15  "
FireWrap® Grip Kit Black,01/15/2021,Sales Receipt,4843,,FireWrap® Grip Kit - Black,1,24.95  ,24.95  ,"44,686.10  "
FireWrap® Grip Kit Black,01/15/2021,Sales Receipt,4852,,FireWrap® Grip Kit - Black,1,24.95  ,24.95  ,"44,711.05  "
FireWrap® Grip Kit Black,01/15/2021,Sales Receipt,4841,,FireWrap® Grip Kit - Black,1,24.95  ,24.95  ,"44,736.00  "
FireWrap® Grip Kit Black,01/15/2021,Sales Receipt,4844,,FireWrap® Grip Kit - Black,1,24.95  ,24.95  ,"44,760.95  "
FireWrap® Grip Kit Black,01/19/2021,Invoice,M-011921-008,,FireWrap® Grip Kit Black,4,18.75  ,75.00  ,"44,835.95  "
FireWrap® Grip Kit Black,01/19/2021,Invoice,M-011921-011,,FireWrap® Grip Kit Black,1,18.75  ,18.75  ,"44,854.70  "
FireWrap® Grip Kit Black,01/19/2021,Invoice,M-011921-023,,FireWrap® Grip Kit Black,40,24.95  ,998.00  ,"45,852.70  "
FireWrap® Grip Kit Black,01/19/2021,Invoice,M-011921-021,,FireWrap® Grip Kit Black,20,18.75  ,375.00  ,"46,227.70  "
FireWrap® Grip Kit Black,01/19/2021,Invoice,M-011921-015,,FireWrap® Grip Kit Black,1,18.75  ,18.75  ,"46,246.45  "
FireWrap® Grip Kit Black,01/19/2021,Invoice,M-011921-006,,FireWrap® Grip Kit Black,3,18.75  ,56.25  ,"46,302.70  "
FireWrap® Grip Kit Black,01/19/2021,Invoice,M-011921-005,,FireWrap® Grip Kit Black,3,18.75  ,56.25  ,"46,358.95  "
FireWrap® Grip Kit Black,01/19/2021,Invoice,M-011921-003,,FireWrap® Grip Kit Black,2,18.75  ,37.50  ,"46,396.45  "
FireWrap® Grip Kit Black,01/19/2021,Sales Receipt,4867,,FireWrap® Grip Kit - Black,1,24.95  ,24.95  ,"46,421.40  "
FireWrap® Grip Kit Black,01/20/2021,Sales Receipt,4874,,FireWrap® Grip Kit - Black,1,24.95  ,24.95  ,"46,446.35  "
FireWrap® Grip Kit Black,01/20/2021,Sales Receipt,4871,,FireWrap® Grip Kit - Black,1,24.95  ,24.95  ,"46,471.30  "
FireWrap® Grip Kit Black,01/20/2021,Sales Receipt,4873,,FireWrap® Grip Kit - Black,1,24.95  ,24.95  ,"46,496.25  "
FireWrap® Grip Kit Black,01/22/2021,Sales Receipt,4880,,FireWrap® Grip Kit - Black,1,24.95  ,24.95  ,"46,521.20  "
FireWrap® Grip Kit Black,01/23/2021,Sales Receipt,4882,,FireWrap® Grip Kit - Black,1,24.95  ,24.95  ,"46,546.15  "
FireWrap® Grip Kit Black,01/24/2021,Sales Receipt,4887,,FireWrap® Grip Kit - Black,1,24.95  ,24.95  ,"46,571.10  "
FireWrap® Grip Kit Black,01/25/2021,Sales Receipt,4892,,FireWrap® Grip Kit - Black,1,24.95  ,24.95  ,"46,596.05  "
FireWrap® Grip Kit Black,01/26/2021,Invoice,M-012621-013,,FireWrap® Grip Kit Black,1,18.75  ,18.75  ,"46,614.80  "
FireWrap® Grip Kit Black,01/28/2021,Sales Receipt,4896,,FireWrap® Grip Kit - Black,3,24.95  ,74.85  ,"46,689.65  "
FireWrap® Grip Kit Black,01/28/2021,Sales Receipt,4897,,FireWrap® Grip Kit - Black,1,24.95  ,24.95  ,"46,714.60  "
FireWrap® Grip Kit Black,01/31/2021,Sales Receipt,4908,,FireWrap® Grip Kit - Black,1,24.95  ,24.95  ,"46,739.55  "
FireWrap® Grip Kit Black,02/02/2021,Sales Receipt,4915,,FireWrap® Grip Kit - Black,1,24.95  ,24.95  ,"46,764.50  "
FireWrap® Grip Kit Black,02/08/2021,Sales Receipt,4938,,FireWrap® Grip Kit - Black,1,24.95  ,24.95  ,"46,789.45  "
FireWrap® Grip Kit Black,02/13/2021,Sales Receipt,4956,,"FIREWRAP® GRIP KIT
Color: Black",1,24.99  ,24.99  ,"46,814.44  "
FireWrap® Grip Kit Black,02/13/2021,Sales Receipt,4963,,"FIREWRAP® GRIP KIT
Color: Black",1,24.99  ,24.99  ,"46,839.43  "
FireWrap® Grip Kit Black,02/14/2021,Sales Receipt,4965,,"FIREWRAP® GRIP KIT
Color: Black",1,24.99  ,24.99  ,"46,864.42  "
FireWrap® Grip Kit Black,02/14/2021,Sales Receipt,4966,,"FIREWRAP® GRIP KIT
Color: Black",2,24.99  ,49.98  ,"46,914.40  "
FireWrap® Grip Kit Black,02/16/2021,Invoice,M-021621-014,,FireWrap® Grip Kit Black,5,18.75  ,93.75  ,"47,008.15  "
FireWrap® Grip Kit Black,02/16/2021,Invoice,M-021621-002,,FireWrap® Grip Kit Black,10,18.75  ,187.50  ,"47,195.65  "
FireWrap® Grip Kit Black,02/16/2021,Invoice,M-021621-004,,FireWrap® Grip Kit Black,8,18.75  ,150.00  ,"47,345.65  "
FireWrap® Grip Kit Black,02/16/2021,Invoice,M-021621-021,,FireWrap® Grip Kit Black,2,18.75  ,37.50  ,"47,383.15  "
FireWrap® Grip Kit Black,02/17/2021,Sales Receipt,4980,,"FIREWRAP® GRIP KIT
Color: Black",1,24.99  ,24.99  ,"47,408.14  "
FireWrap® Grip Kit Black,02/18/2021,Sales Receipt,4982,,"FIREWRAP® GRIP KIT
Color: Black",4,24.99  ,99.96  ,"47,508.10  "
FireWrap® Grip Kit Black,02/18/2021,Invoice,M-021821-001,,FireWrap® Grip Kit Black,6,18.75  ,112.50  ,"47,620.60  "
FireWrap® Grip Kit Black,02/18/2021,Invoice,M-021821-007,,FireWrap® Grip Kit Black,5,18.75  ,93.75  ,"47,714.35  "
FireWrap® Grip Kit Black,02/19/2021,Sales Receipt,4992,,"FIREWRAP® GRIP KIT
Color: Black",2,24.99  ,49.98  ,"47,764.33  "
FireWrap® Grip Kit Black,02/20/2021,Sales Receipt,4994,,"FIREWRAP® GRIP KIT
Color: Black",1,24.99  ,24.99  ,"47,789.32  "
FireWrap® Grip Kit Black,02/20/2021,Sales Receipt,4995,,"FIREWRAP® GRIP KIT
Color: Black",1,24.99  ,24.99  ,"47,814.31  "
FireWrap® Grip Kit Black,02/21/2021,Sales Receipt,4998,,"FIREWRAP® GRIP KIT
Color: Black",4,24.99  ,99.96  ,"47,914.27  "
FireWrap® Grip Kit Black,02/22/2021,Invoice,M-022221-001,,FireWrap® Grip Kit Black,1,18.75  ,18.75  ,"47,933.02  "
FireWrap® Grip Kit Black,02/24/2021,Sales Receipt,5024,,"FIREWRAP® GRIP KIT
Color: Black",1,24.99  ,24.99  ,"47,958.01  "
FireWrap® Grip Kit Black,02/24/2021,Invoice,M-022421-008,,FireWrap® Grip Kit Black,4,18.75  ,75.00  ,"48,033.01  "
FireWrap® Grip Kit Black,02/25/2021,Sales Receipt,5028,,"FIREWRAP® GRIP KIT - Yes, I understand.
Color: Black",1,24.99  ,24.99  ,"48,058.00  "
FireWrap® Grip Kit Black,02/25/2021,Sales Receipt,5027,,"FIREWRAP® GRIP KIT
Color: Black",1,24.99  ,24.99  ,"48,082.99  "
FireWrap® Grip Kit Black,02/26/2021,Sales Receipt,5032,,"FIREWRAP® GRIP KIT - Yes, I understand.
Color: Black",1,24.99  ,24.99  ,"48,107.98  "
FireWrap® Grip Kit Black,03/02/2021,Sales Receipt,5038,,"FIREWRAP® GRIP KIT - Yes, I understand.
Color: Black",1,24.99  ,24.99  ,"48,132.97  "
FireWrap® Grip Kit Black,03/03/2021,Sales Receipt,5042,,"FIREWRAP® GRIP KIT - Yes, I understand.
Color: Black",1,24.99  ,24.99  ,"48,157.96  "
FireWrap® Grip Kit Black,03/03/2021,Sales Receipt,5040,,"FIREWRAP® GRIP KIT - Yes, I understand.
Color: Black",2,24.99  ,49.98  ,"48,207.94  "
FireWrap® Grip Kit Black,03/06/2021,Sales Receipt,5053,,"FIREWRAP® GRIP KIT - Yes, I understand.
Color: Black",1,24.99  ,24.99  ,"48,232.93  "
FireWrap® Grip Kit Black,03/07/2021,Sales Receipt,5055,,"FIREWRAP® GRIP KIT - Yes, I understand.
Color: Black",1,24.99  ,24.99  ,"48,257.92  "
FireWrap® Grip Kit Black,03/07/2021,Sales Receipt,5056,,"FIREWRAP® GRIP KIT - Yes, I understand.
Color: Black",5,24.99  ,124.95  ,"48,382.87  "
FireWrap® Grip Kit Black,03/09/2021,Sales Receipt,5066,,"FIREWRAP® GRIP KIT - Yes, I understand.
Color: Black",1,24.99  ,24.99  ,"48,407.86  "
FireWrap® Grip Kit Black,03/10/2021,Sales Receipt,5076,,"FIREWRAP® GRIP KIT - Yes, I understand.
Color: Black",1,24.99  ,24.99  ,"48,432.85  "
FireWrap® Grip Kit Black,03/10/2021,Sales Receipt,5076,,"FIREWRAP® GRIP KIT - Yes, I understand.
Color: Black",1,24.99  ,24.99  ,"48,457.84  "
FireWrap® Grip Kit Black,03/11/2021,Sales Receipt,5090,,"FIREWRAP® GRIP KIT - Yes, I understand.
Color: Black",1,24.99  ,24.99  ,"48,482.83  "
FireWrap® Grip Kit Black,03/12/2021,Invoice,M-031221-008,,FireWrap® Grip Kit Black,16,24.95  ,399.20  ,"48,882.03  "
FireWrap® Grip Kit Black,03/12/2021,Sales Receipt,5100,,"FIREWRAP® GRIP KIT - Yes, I understand.
Color: Black",2,24.99  ,49.98  ,"48,932.01  "
FireWrap® Grip Kit Black,03/16/2021,Sales Receipt,5126,,"FIREWRAP® GRIP KIT - Yes, I understand.
Color: Black",1,24.99  ,24.99  ,"48,957.00  "
FireWrap® Grip Kit Black,03/16/2021,Sales Receipt,5122,,"FIREWRAP® GRIP KIT - Yes, I understand.
Color: Black",4,24.99  ,99.96  ,"49,056.96  "
FireWrap® Grip Kit Black,03/18/2021,Sales Receipt,5135,,"FIREWRAP® GRIP KIT - Yes, I understand.
Color: Black",1,24.99  ,24.99  ,"49,081.95  "
FireWrap® Grip Kit Black,03/18/2021,Sales Receipt,5131,,"FIREWRAP® GRIP KIT - Yes, I understand.
Color: Black",1,24.99  ,24.99  ,"49,106.94  "
FireWrap® Grip Kit Black,03/18/2021,Sales Receipt,5130,,"FIREWRAP® GRIP KIT - Yes, I understand.
Color: Black",1,24.99  ,24.99  ,"49,131.93  "
FireWrap® Grip Kit Black,03/19/2021,Sales Receipt,5139,,"FIREWRAP® GRIP KIT - Yes, I understand.
Color: Black",3,24.99  ,74.97  ,"49,206.90  "
FireWrap® Grip Kit Black,03/21/2021,Sales Receipt,5153,,"FIREWRAP® GRIP KIT - Yes, I understand.
Color: Black",3,24.99  ,74.97  ,"49,281.87  "
FireWrap® Grip Kit Black,03/21/2021,Sales Receipt,5155,,"FIREWRAP® GRIP KIT - Yes, I understand.
Color: Black",1,24.99  ,24.99  ,"49,306.86  "
FireWrap® Grip Kit Black,03/23/2021,Sales Receipt,5166,,"FIREWRAP® GRIP KIT - Yes, I understand.
Color: Black",2,24.99  ,49.98  ,"49,356.84  "
FireWrap® Grip Kit Black,03/24/2021,Sales Receipt,5169,,"FIREWRAP® GRIP KIT - Yes, I understand.
Color: Black",5,24.99  ,124.95  ,"49,481.79  "
FireWrap® Grip Kit Black,03/24/2021,Sales Receipt,5171,,"FIREWRAP® GRIP KIT - Yes, I understand.
Color: Black",3,24.99  ,74.97  ,"49,556.76  "
FireWrap® Grip Kit Black,03/25/2021,Sales Receipt,5175,,"FIREWRAP® GRIP KIT - Yes, I understand.
Color: Black",1,24.99  ,24.99  ,"49,581.75  "
FireWrap® Grip Kit Black,03/27/2021,Invoice,M-032721-001,,FireWrap® Grip Kit Black,5,18.75  ,93.75  ,"49,675.50  "
FireWrap® Grip Kit Black,03/27/2021,Invoice,M-032721-001,,FireWrap® Grip Kit Black,4,18.75  ,75.00  ,"49,750.50  "
FireWrap® Grip Kit Black,03/27/2021,Invoice,M-032721-001,,FireWrap® Grip Kit Black,12,18.75  ,225.00  ,"49,975.50  "
FireWrap® Grip Kit Black,03/27/2021,Invoice,M-032721-006,,FireWrap® Grip Kit Black,4,18.75  ,75.00  ,"50,050.50  "
FireWrap® Grip Kit Black,03/27/2021,Invoice,M-032721-006,,FireWrap® Grip Kit Black,6,18.75  ,112.50  ,"50,163.00  "
FireWrap® Grip Kit Black,03/27/2021,Invoice,M-021921-001,,FireWrap® Grip Kit Black,2,18.75  ,37.50  ,"50,200.50  "
FireWrap® Grip Kit Black,03/27/2021,Invoice,M-021921-001,,FireWrap® Grip Kit Black,4,18.75  ,75.00  ,"50,275.50  "
FireWrap® Grip Kit Black,03/28/2021,Sales Receipt,5193,,"FIREWRAP® GRIP KIT - Yes, I understand.
Color: Black",6,24.99  ,149.94  ,"50,425.44  "
FireWrap® Grip Kit Black,03/28/2021,Sales Receipt,5197,,"FIREWRAP® GRIP KIT - Yes, I understand.
Color: Black",1,24.99  ,24.99  ,"50,450.43  "
FireWrap® Grip Kit Black,03/29/2021,Sales Receipt,5200,,"FIREWRAP® GRIP KIT - Yes, I understand.
Color: Black",2,24.99  ,49.98  ,"50,500.41  "
FireWrap® Grip Kit Black,03/29/2021,Sales Receipt,5204,,"FIREWRAP® GRIP KIT - Yes, I understand.
Color: Black",1,24.99  ,24.99  ,"50,525.40  "
FireWrap® Grip Kit Black,03/29/2021,Sales Receipt,5202,,"FIREWRAP® GRIP KIT - Yes, I understand.
Color: Black",1,24.99  ,24.99  ,"50,550.39  "
FireWrap® Grip Kit Black,03/30/2021,Sales Receipt,5213,,"FIREWRAP® GRIP KIT - Yes, I understand.
Color: Black",1,24.99  ,24.99  ,"50,575.38  "
FireWrap® Grip Kit Black,03/30/2021,Invoice,M-033021-011,,FireWrap® Grip Kit Black,1,18.75  ,18.75  ,"50,594.13  "
FireWrap® Grip Kit Black,04/01/2021,Sales Receipt,5222,,"FIREWRAP® GRIP KIT - Yes, I understand.
Color: Black",1,24.99  ,24.99  ,"50,619.12  "
FireWrap® Grip Kit Black,04/02/2021,Sales Receipt,5231,,"FIREWRAP® GRIP KIT - Yes, I understand.
Color: Black",2,24.99  ,49.98  ,"50,669.10  "
FireWrap® Grip Kit Black,04/05/2021,Sales Receipt,5244,,"FIREWRAP® GRIP KIT - Yes, I understand.
Color: Black",1,24.99  ,24.99  ,"50,694.09  "
FireWrap® Grip Kit Black,04/05/2021,Sales Receipt,5239,,"FIREWRAP® GRIP KIT - Yes, I understand.
Color: Black",1,24.99  ,24.99  ,"50,719.08  "
FireWrap® Grip Kit Black,04/06/2021,Sales Receipt,5249,,"FIREWRAP® GRIP KIT - Yes, I understand.
Color: Black",1,24.99  ,24.99  ,"50,744.07  "
FireWrap® Grip Kit Black,04/07/2021,Invoice,M-040721-003,,FireWrap® Grip Kit Black,13,18.75  ,243.75  ,"50,987.82  "
FireWrap® Grip Kit Black,04/07/2021,Sales Receipt,5259,,"FIREWRAP® GRIP KIT - Yes, I understand.
Color: Black",14,24.99  ,349.86  ,"51,337.68  "
FireWrap® Grip Kit Black,04/08/2021,Sales Receipt,5267,,"FIREWRAP® GRIP KIT - Yes, I understand.
Color: Black",1,24.99  ,24.99  ,"51,362.67  "
FireWrap® Grip Kit Black,04/08/2021,Invoice,M-040821-001,,FireWrap® Grip Kit Black,1,18.75  ,18.75  ,"51,381.42  "
FireWrap® Grip Kit Black,04/09/2021,Sales Receipt,5278,,"FIREWRAP® GRIP KIT - Yes, I understand.
Color: Black",1,24.99  ,24.99  ,"51,406.41  "
FireWrap® Grip Kit Black,04/11/2021,Sales Receipt,5282,,"FIREWRAP® GRIP KIT - Yes, I understand.
Color: Black",1,24.99  ,24.99  ,"51,431.40  "
FireWrap® Grip Kit Black,04/13/2021,Invoice,M-041321-008,,FireWrap® Grip Kit Black,1,18.75  ,18.75  ,"51,450.15  "
FireWrap® Grip Kit Black,04/13/2021,Invoice,M-041321-009,,FireWrap® Grip Kit Black,6,18.75  ,112.50  ,"51,562.65  "
FireWrap® Grip Kit Black,04/14/2021,Sales Receipt,5297,,"FIREWRAP® GRIP KIT - Yes, I understand.
Color: Black",1,24.99  ,24.99  ,"51,587.64  "
FireWrap® Grip Kit Black,04/14/2021,Sales Receipt,5296,,"FIREWRAP® GRIP KIT - Yes, I understand.
Color: Black",1,24.99  ,24.99  ,"51,612.63  "
FireWrap® Grip Kit Black,04/15/2021,Sales Receipt,5301,,"FIREWRAP® GRIP KIT - Yes, I understand.
Color: Black",1,24.99  ,24.99  ,"51,637.62  "
FireWrap® Grip Kit Black,04/15/2021,Sales Receipt,5304,,"FIREWRAP® GRIP KIT - Yes, I understand.
Color: Black",1,24.99  ,24.99  ,"51,662.61  "
FireWrap® Grip Kit Black,04/16/2021,Sales Receipt,5310,,"FIREWRAP® GRIP KIT
Color: Black",1,24.99  ,24.99  ,"51,687.60  "
FireWrap® Grip Kit Black,04/16/2021,Sales Receipt,5307,,"FIREWRAP® GRIP KIT - Yes, I understand.
Color: Black",1,24.99  ,24.99  ,"51,712.59  "
FireWrap® Grip Kit Black,04/16/2021,Sales Receipt,5305,,"FIREWRAP® GRIP KIT - Yes, I understand.
Color: Black",1,24.99  ,24.99  ,"51,737.58  "
FireWrap® Grip Kit Black,04/16/2021,Sales Receipt,5311,,"FIREWRAP® GRIP KIT
Color: Black",1,24.99  ,24.99  ,"51,762.57  "
FireWrap® Grip Kit Black,04/17/2021,Sales Receipt,5319,,"FIREWRAP® GRIP KIT
Color: Black",1,24.99  ,24.99  ,"51,787.56  "
FireWrap® Grip Kit Black,04/17/2021,Sales Receipt,5312,,"FIREWRAP® GRIP KIT
Color: Black",1,24.99  ,24.99  ,"51,812.55  "
FireWrap® Grip Kit Black,04/17/2021,Sales Receipt,5315,,"FIREWRAP® GRIP KIT
Color: Black",4,24.99  ,99.96  ,"51,912.51  "
FireWrap® Grip Kit Black,04/17/2021,Sales Receipt,5321,,"FIREWRAP® GRIP KIT
Color: Black",2,24.99  ,49.98  ,"51,962.49  "
FireWrap® Grip Kit Black,04/17/2021,Sales Receipt,5317,,"FIREWRAP® GRIP KIT
Color: Black",3,24.99  ,74.97  ,"52,037.46  "
FireWrap® Grip Kit Black,04/17/2021,Sales Receipt,5316,,"FIREWRAP® GRIP KIT
Color: Black",4,24.99  ,99.96  ,"52,137.42  "
FireWrap® Grip Kit Black,04/18/2021,Sales Receipt,5324,,"FIREWRAP® GRIP KIT
Color: Black",1,24.99  ,24.99  ,"52,162.41  "
FireWrap® Grip Kit Black,04/18/2021,Sales Receipt,5322,,"FIREWRAP® GRIP KIT
Color: Black",2,24.99  ,49.98  ,"52,212.39  "
FireWrap® Grip Kit Black,04/19/2021,Sales Receipt,5331,,"FIREWRAP® GRIP KIT
Color: Black",1,24.99  ,24.99  ,"52,237.38  "
FireWrap® Grip Kit Black,04/19/2021,Sales Receipt,5328,,"FIREWRAP® GRIP KIT
Color: Black",1,24.99  ,24.99  ,"52,262.37  "
FireWrap® Grip Kit Black,04/19/2021,Invoice,M-041921-001,,FireWrap® Grip Kit Black,2,18.75  ,37.50  ,"52,299.87  "
FireWrap® Grip Kit Black,04/20/2021,Sales Receipt,5339,,"FIREWRAP® GRIP KIT
Color: Black",1,24.99  ,24.99  ,"52,324.86  "
FireWrap® Grip Kit Black,04/21/2021,Sales Receipt,5343,,"FIREWRAP® GRIP KIT
Color: Black",1,24.99  ,24.99  ,"52,349.85  "
FireWrap® Grip Kit Black,04/22/2021,Sales Receipt,5355,,"FIREWRAP® GRIP KIT
Color: Black",1,24.99  ,24.99  ,"52,374.84  "
FireWrap® Grip Kit Black,04/23/2021,Sales Receipt,5366,,"FIREWRAP® GRIP KIT
Color: Black",1,24.99  ,24.99  ,"52,399.83  "
FireWrap® Grip Kit Black,04/24/2021,Sales Receipt,5378,,"FIREWRAP® GRIP KIT
Color: Black",1,24.99  ,24.99  ,"52,424.82  "
FireWrap® Grip Kit Black,04/24/2021,Sales Receipt,5373,,"FIREWRAP® GRIP KIT
Color: Black",3,24.99  ,74.97  ,"52,499.79  "
FireWrap® Grip Kit Black,04/24/2021,Sales Receipt,5372,,"FIREWRAP® GRIP KIT
Color: Black",1,24.99  ,24.99  ,"52,524.78  "
FireWrap® Grip Kit Black,04/25/2021,Sales Receipt,5388,,"FIREWRAP® GRIP KIT
Color: Black",3,24.99  ,74.97  ,"52,599.75  "
FireWrap® Grip Kit Black,04/26/2021,Sales Receipt,5397,,"FIREWRAP® GRIP KIT
Color: Black",1,24.99  ,24.99  ,"52,624.74  "
FireWrap® Grip Kit Black,04/27/2021,Sales Receipt,5399,,"FIREWRAP® GRIP KIT
Color: Black",2,24.99  ,49.98  ,"52,674.72  "
FireWrap® Grip Kit Black,04/28/2021,Sales Receipt,5410,,"FIREWRAP® GRIP KIT
Color: Black",1,24.99  ,24.99  ,"52,699.71  "
FireWrap® Grip Kit Black,04/28/2021,Sales Receipt,5404,,"FIREWRAP® GRIP KIT
Color: Black",1,24.99  ,24.99  ,"52,724.70  "
FireWrap® Grip Kit Black,04/28/2021,Sales Receipt,5402,,"FIREWRAP® GRIP KIT
Color: Black",1,24.99  ,24.99  ,"52,749.69  "
FireWrap® Grip Kit Black,04/29/2021,Sales Receipt,5414,,"FIREWRAP® GRIP KIT
Color: Black",6,24.99  ,149.94  ,"52,899.63  "
FireWrap® Grip Kit Black,05/02/2021,Sales Receipt,5439,,"FIREWRAP® GRIP KIT
Color: Black",8,24.99  ,199.92  ,"53,099.55  "
FireWrap® Grip Kit Black,05/02/2021,Sales Receipt,5441,,"FIREWRAP® GRIP KIT
Color: Black",1,24.99  ,24.99  ,"53,124.54  "
FireWrap® Grip Kit Black,05/03/2021,Invoice,M-050321-003,,FireWrap® Grip Kit Black,9,18.75  ,168.75  ,"53,293.29  "
FireWrap® Grip Kit Black,05/05/2021,Sales Receipt,5451,,"FIREWRAP® GRIP KIT
Color: Black",1,24.99  ,24.99  ,"53,318.28  "
FireWrap® Grip Kit Black,05/07/2021,Sales Receipt,5464,,"FIREWRAP® GRIP KIT
Color: Black",1,24.99  ,24.99  ,"53,343.27  "
FireWrap® Grip Kit Black,05/08/2021,Sales Receipt,5470,,"FIREWRAP® GRIP KIT
Color: Black",1,24.99  ,24.99  ,"53,368.26  "
FireWrap® Grip Kit Black,05/09/2021,Sales Receipt,5474,,"FIREWRAP® GRIP KIT
Color: Black",2,24.99  ,49.98  ,"53,418.24  "
FireWrap® Grip Kit Black,05/09/2021,Sales Receipt,5473,,"FIREWRAP® GRIP KIT
Color: Black",1,24.99  ,24.99  ,"53,443.23  "
FireWrap® Grip Kit Black,05/10/2021,Sales Receipt,5479,,"FIREWRAP® GRIP KIT
Color: Black",1,24.99  ,24.99  ,"53,468.22  "
FireWrap® Grip Kit Black,05/10/2021,Invoice,M-050421-003,,FireWrap® Grip Kit Black,1,18.75  ,18.75  ,"53,486.97  "
FireWrap® Grip Kit Black,05/11/2021,Sales Receipt,5482,,"FIREWRAP® GRIP KIT
Color: Black",1,24.99  ,24.99  ,"53,511.96  "
FireWrap® Grip Kit Black,05/12/2021,Sales Receipt,5494,,"FIREWRAP® GRIP KIT
Color: Black",2,24.99  ,49.98  ,"53,561.94  "
FireWrap® Grip Kit Black,05/13/2021,Sales Receipt,5497,,"FIREWRAP® GRIP KIT
Color: Black",1,24.99  ,24.99  ,"53,586.93  "
FireWrap® Grip Kit Black,05/13/2021,Sales Receipt,5495,,"FIREWRAP® GRIP KIT
Color: Black",1,24.99  ,24.99  ,"53,611.92  "
FireWrap® Grip Kit Black,05/14/2021,Sales Receipt,5508,,"FIREWRAP® GRIP KIT
Color: Black",1,24.99  ,24.99  ,"53,636.91  "
FireWrap® Grip Kit Black,05/14/2021,Sales Receipt,5507,,"FIREWRAP® GRIP KIT
Color: Black",1,24.99  ,24.99  ,"53,661.90  "
FireWrap® Grip Kit Black,05/15/2021,Sales Receipt,5514,,"FIREWRAP® GRIP KIT
Color: Black",1,24.99  ,24.99  ,"53,686.89  "
FireWrap® Grip Kit Black,05/15/2021,Sales Receipt,5515,,"FIREWRAP® GRIP KIT
Color: Black",1,24.99  ,24.99  ,"53,711.88  "
FireWrap® Grip Kit Black,05/15/2021,Sales Receipt,5516,,"FIREWRAP® GRIP KIT
Color: Black",1,24.99  ,24.99  ,"53,736.87  "
FireWrap® Grip Kit Black,05/15/2021,Sales Receipt,5513,,"FIREWRAP® GRIP KIT
Color: Black",1,24.99  ,24.99  ,"53,761.86  "
FireWrap® Grip Kit Black,05/16/2021,Sales Receipt,5523,,"FIREWRAP® GRIP KIT
Color: Black",1,24.99  ,24.99  ,"53,786.85  "
FireWrap® Grip Kit Black,05/17/2021,Sales Receipt,5527,,"FIREWRAP® GRIP KIT
Color: Black",2,24.99  ,49.98  ,"53,836.83  "
FireWrap® Grip Kit Black,05/17/2021,Sales Receipt,5528,,"FIREWRAP® GRIP KIT
Color: Black",1,24.99  ,24.99  ,"53,861.82  "
FireWrap® Grip Kit Black,05/18/2021,Sales Receipt,5534,,"FIREWRAP® GRIP KIT
Color: Black",1,24.99  ,24.99  ,"53,886.81  "
FireWrap® Grip Kit Black,05/19/2021,Sales Receipt,5538,,"FIREWRAP® GRIP KIT
Color: Black",1,24.99  ,24.99  ,"53,911.80  "
FireWrap® Grip Kit Black,05/20/2021,Invoice,M-052021-001,,FireWrap® Grip Kit Black,8,18.75  ,150.00  ,"54,061.80  "
FireWrap® Grip Kit Black,05/20/2021,Sales Receipt,5540,,"FIREWRAP® GRIP KIT
Color: Black",1,24.99  ,24.99  ,"54,086.79  "
FireWrap® Grip Kit Black,05/21/2021,Sales Receipt,5550,,"FIREWRAP® GRIP KIT
Color: Black",7,24.99  ,174.93  ,"54,261.72  "
FireWrap® Grip Kit Black,05/23/2021,Sales Receipt,5558,,"FIREWRAP® GRIP KIT
Color: Black",1,24.99  ,24.99  ,"54,286.71  "
FireWrap® Grip Kit Black,05/24/2021,Sales Receipt,5571,,"FIREWRAP® GRIP KIT
Color: Black",1,24.99  ,24.99  ,"54,311.70  "
FireWrap® Grip Kit Black,05/25/2021,Sales Receipt,5573,,"FIREWRAP® GRIP KIT
Color: Black",4,24.99  ,99.96  ,"54,411.66  "
FireWrap® Grip Kit Black,05/26/2021,Sales Receipt,5580,,"FIREWRAP® GRIP KIT
Color: Black",1,24.99  ,24.99  ,"54,436.65  "
FireWrap® Grip Kit Black,05/29/2021,Sales Receipt,5597,,"FIREWRAP® GRIP KIT
Color: Black",1,24.99  ,24.99  ,"54,461.64  "
FireWrap® Grip Kit Black,05/29/2021,Sales Receipt,5591,,"FIREWRAP® GRIP KIT
Color: Black",1,24.99  ,24.99  ,"54,486.63  "
FireWrap® Grip Kit Black,05/30/2021,Sales Receipt,5605,,"FIREWRAP® GRIP KIT
Color: Black",1,24.99  ,24.99  ,"54,511.62  "
FireWrap® Grip Kit Black,05/30/2021,Sales Receipt,5602,,"FIREWRAP® GRIP KIT
Color: Black",4,24.99  ,99.96  ,"54,611.58  "
FireWrap® Grip Kit Black,06/01/2021,Invoice,M-060121-002,,FireWrap® Grip Kit Black,3,18.75  ,56.25  ,"54,667.83  "
FireWrap® Grip Kit Black,06/02/2021,Sales Receipt,5613,,"FIREWRAP® GRIP KIT
Color: Black",1,24.99  ,24.99  ,"54,692.82  "
FireWrap® Grip Kit Black,06/03/2021,Sales Receipt,5621,,"FIREWRAP® GRIP KIT
Color: Black",1,24.99  ,24.99  ,"54,717.81  "
FireWrap® Grip Kit Black,06/04/2021,Sales Receipt,5622,,"FIREWRAP® GRIP KIT
Color: Black",1,24.99  ,24.99  ,"54,742.80  "
FireWrap® Grip Kit Black,06/06/2021,Sales Receipt,5633,,"FIREWRAP® GRIP KIT
Color: Black",1,24.99  ,24.99  ,"54,767.79  "
FireWrap® Grip Kit Black,06/08/2021,Invoice,M-060821-001,,FireWrap® Grip Kit Black,11,18.75  ,206.25  ,"54,974.04  "
FireWrap® Grip Kit Black,06/10/2021,Sales Receipt,5651,,"FIREWRAP® GRIP KIT
Color: Black",5,24.99  ,124.95  ,"55,098.99  "
FireWrap® Grip Kit Black,06/12/2021,Sales Receipt,5656,,"FIREWRAP® GRIP KIT
Color: Black",1,24.99  ,24.99  ,"55,123.98  "
FireWrap® Grip Kit Black,06/14/2021,Sales Receipt,5665,,"FIREWRAP® GRIP KIT
Color: Black",1,24.99  ,24.99  ,"55,148.97  "
FireWrap® Grip Kit Black,06/15/2021,Sales Receipt,5672,,"FIREWRAP® GRIP KIT
Color: Black",1,24.99  ,24.99  ,"55,173.96  "
FireWrap® Grip Kit Black,06/15/2021,Sales Receipt,5673,,"FIREWRAP® GRIP KIT
Color: Black",1,24.99  ,24.99  ,"55,198.95  "
FireWrap® Grip Kit Black,06/16/2021,Invoice,M-061621-001,,FireWrap® Grip Kit Black,5,18.75  ,93.75  ,"55,292.70  "
FireWrap® Grip Kit Black,06/17/2021,Sales Receipt,5680,,"FIREWRAP® GRIP KIT
Color: Black",2,24.99  ,49.98  ,"55,342.68  "
FireWrap® Grip Kit Black,06/18/2021,Sales Receipt,5681,,"FIREWRAP® GRIP KIT
Color: Black",1,24.99  ,24.99  ,"55,367.67  "
FireWrap® Grip Kit Black,06/18/2021,Sales Receipt,5684,,"FIREWRAP® GRIP KIT
Color: Black",1,24.99  ,24.99  ,"55,392.66  "
FireWrap® Grip Kit Black,06/21/2021,Invoice,M-062121-001,,FireWrap® Grip Kit Black,1,24.99  ,24.99  ,"55,417.65  "
FireWrap® Grip Kit Black,06/21/2021,Sales Receipt,5692,,"FIREWRAP® GRIP KIT
Color: Black",4,24.99  ,99.96  ,"55,517.61  "
FireWrap® Grip Kit Black,06/22/2021,Sales Receipt,5695,,"FIREWRAP® GRIP KIT
Color: Black",2,24.99  ,49.98  ,"55,567.59  "
FireWrap® Grip Kit Black,06/25/2021,Invoice,M-062521-002,,FireWrap® Grip Kit Black,1,18.75  ,18.75  ,"55,586.34  "
FireWrap® Grip Kit Black,06/25/2021,Invoice,M-062521-001,,FireWrap® Grip Kit Black,3,18.75  ,56.25  ,"55,642.59  "
FireWrap® Grip Kit Black,06/25/2021,Sales Receipt,5708,,"FIREWRAP® GRIP KIT
Color: Black",2,24.99  ,49.98  ,"55,692.57  "
FireWrap® Grip Kit Black,06/29/2021,Sales Receipt,5723,,"FIREWRAP® GRIP KIT
Color: Black",1,24.99  ,24.99  ,"55,717.56  "
FireWrap® Grip Kit Black,06/29/2021,Sales Receipt,5724,,"FIREWRAP® GRIP KIT
Color: Black",10,24.99  ,249.90  ,"55,967.46  "
FireWrap® Grip Kit Black,06/30/2021,Sales Receipt,5729,,"FIREWRAP® GRIP KIT
Color: Black",1,24.99  ,24.99  ,"55,992.45  "
FireWrap® Grip Kit Black,06/30/2021,Sales Receipt,5725,,"FIREWRAP® GRIP KIT
Color: Black",1,24.99  ,24.99  ,"56,017.44  "
FireWrap® Grip Kit Black,06/30/2021,Sales Receipt,5726,,"FIREWRAP® GRIP KIT
Color: Black",2,24.99  ,49.98  ,"56,067.42  "
FireWrap® Grip Kit Black,07/02/2021,Sales Receipt,5734,,"FIREWRAP® GRIP KIT
Color: Black",8,24.99  ,199.92  ,"56,267.34  "
FireWrap® Grip Kit Black,07/04/2021,Sales Receipt,5742,,"FIREWRAP® GRIP KIT
Color: Black",1,24.99  ,24.99  ,"56,292.33  "
FireWrap® Grip Kit Black,07/07/2021,Sales Receipt,5754,,"FIREWRAP® GRIP KIT
Color: Black",1,24.99  ,24.99  ,"56,317.32  "
FireWrap® Grip Kit Black,07/07/2021,Sales Receipt,5756,,"FIREWRAP® GRIP KIT
Color: Black",1,24.99  ,24.99  ,"56,342.31  "
FireWrap® Grip Kit Black,07/08/2021,Sales Receipt,5759,,"FIREWRAP® GRIP KIT
Color: Black",2,24.99  ,49.98  ,"56,392.29  "
FireWrap® Grip Kit Black,07/08/2021,Sales Receipt,5761,,"FIREWRAP® GRIP KIT
Color: Black",1,24.99  ,24.99  ,"56,417.28  "
FireWrap® Grip Kit Black,07/09/2021,Sales Receipt,5763,,"FIREWRAP® GRIP KIT
Color: Black",1,24.99  ,24.99  ,"56,442.27  "
FireWrap® Grip Kit Black,07/09/2021,Sales Receipt,5762,,"FIREWRAP® GRIP KIT
Color: Black",1,24.99  ,24.99  ,"56,467.26  "
FireWrap® Grip Kit Black,07/11/2021,Sales Receipt,5771,,"FIREWRAP® GRIP KIT
Color: Black",1,24.99  ,24.99  ,"56,492.25  "
FireWrap® Grip Kit Black,07/12/2021,Sales Receipt,5772,,"FIREWRAP® GRIP KIT
Color: Black",1,24.99  ,24.99  ,"56,517.24  "
FireWrap® Grip Kit Black,07/14/2021,Sales Receipt,5779,,"FIREWRAP® GRIP KIT
Color: Black",1,24.99  ,24.99  ,"56,542.23  "
FireWrap® Grip Kit Black,07/14/2021,Sales Receipt,5780,,"FIREWRAP® GRIP KIT
Color: Black",2,24.99  ,49.98  ,"56,592.21  "
FireWrap® Grip Kit Black,07/14/2021,Sales Receipt,5778,,"FIREWRAP® GRIP KIT
Color: Black",1,24.99  ,24.99  ,"56,617.20  "
FireWrap® Grip Kit Black,07/15/2021,Invoice,M-052521-004,,FireWrap® Grip Kit Black,4,18.75  ,75.00  ,"56,692.20  "
FireWrap® Grip Kit Black,07/17/2021,Sales Receipt,5792,,"FIREWRAP® GRIP KIT
Color: Black",1,24.99  ,24.99  ,"56,717.19  "
FireWrap® Grip Kit Black,07/19/2021,Sales Receipt,5800,,"FIREWRAP® GRIP KIT
Color: Black",1,24.99  ,24.99  ,"56,742.18  "
FireWrap® Grip Kit Black,07/21/2021,Invoice,M-072121-001,,FireWrap® Grip Kit Black,7,18.75  ,131.25  ,"56,873.43  "
FireWrap® Grip Kit Black,07/22/2021,Sales Receipt,5813,,"FIREWRAP® GRIP KIT
Color: Black",20,24.99  ,499.80  ,"57,373.23  "
FireWrap® Grip Kit Black,07/26/2021,Invoice,M-072621-001,,FireWrap® Grip Kit Black,1,18.75  ,18.75  ,"57,391.98  "
FireWrap® Grip Kit Black,07/26/2021,Sales Receipt,5827,,"FIREWRAP® GRIP KIT
Color: Black",1,24.99  ,24.99  ,"57,416.97  "
FireWrap® Grip Kit Black,07/29/2021,Sales Receipt,5835,,"FIREWRAP® GRIP KIT
Color: Black",1,24.99  ,24.99  ,"57,441.96  "
FireWrap® Grip Kit Black,07/29/2021,Sales Receipt,5834,,"FIREWRAP® GRIP KIT
Color: Black",1,24.99  ,24.99  ,"57,466.95  "
FireWrap® Grip Kit Black,07/30/2021,Sales Receipt,5841,,"FIREWRAP® GRIP KIT
Color: Black",1,24.99  ,24.99  ,"57,491.94  "
FireWrap® Grip Kit Black,07/30/2021,Sales Receipt,5840,,"FIREWRAP® GRIP KIT
Color: Black",2,24.99  ,49.98  ,"57,541.92  "
FireWrap® Grip Kit Black,07/30/2021,Sales Receipt,5837,,"FIREWRAP® GRIP KIT
Color: Black",1,24.99  ,24.99  ,"57,566.91  "
FireWrap® Grip Kit Black,08/01/2021,Sales Receipt,5844,,"FIREWRAP® GRIP KIT
Color: Black",1,24.99  ,24.99  ,"57,591.90  "
FireWrap® Grip Kit Black,08/05/2021,Sales Receipt,5865,,"FIREWRAP® GRIP KIT
Color: Black",1,24.99  ,24.99  ,"57,616.89  "
FireWrap® Grip Kit Black,08/05/2021,Sales Receipt,5864,,"FIREWRAP® GRIP KIT
Color: Black",1,24.99  ,24.99  ,"57,641.88  "
FireWrap® Grip Kit Black,08/07/2021,Sales Receipt,5873,,"FIREWRAP® GRIP KIT
Color: Black",4,24.99  ,99.96  ,"57,741.84  "
FireWrap® Grip Kit Black,08/13/2021,Sales Receipt,5909,,"FIREWRAP® GRIP KIT
Color: Black",1,24.99  ,24.99  ,"57,766.83  "
FireWrap® Grip Kit Black,08/14/2021,Sales Receipt,5919,,"FIREWRAP® GRIP KIT
Color: Black",2,24.99  ,49.98  ,"57,816.81  "
FireWrap® Grip Kit Black,08/15/2021,Sales Receipt,5921,,"FIREWRAP® GRIP KIT
Color: Black",6,24.99  ,149.94  ,"57,966.75  "
FireWrap® Grip Kit Black,08/17/2021,Invoice,M-081221-001,,FireWrap® Grip Kit Black,2,18.75  ,37.50  ,"58,004.25  "
FireWrap® Grip Kit Black,08/17/2021,Sales Receipt,5930,,"FIREWRAP® GRIP KIT
Color: Black",10,24.99  ,249.90  ,"58,254.15  "
FireWrap® Grip Kit Black,08/18/2021,Sales Receipt,5940,,"FIREWRAP® GRIP KIT
Color: Black",2,24.99  ,49.98  ,"58,304.13  "
FireWrap® Grip Kit Black,08/20/2021,Sales Receipt,5950,,"FIREWRAP® GRIP KIT
Color: Black",1,24.99  ,24.99  ,"58,329.12  "
FireWrap® Grip Kit Black,08/20/2021,Sales Receipt,5947,,"FIREWRAP® GRIP KIT
Color: Black",1,24.99  ,24.99  ,"58,354.11  "
FireWrap® Grip Kit Black,08/23/2021,Sales Receipt,5964,,"FIREWRAP® GRIP KIT
Color: Black",1,24.99  ,24.99  ,"58,379.10  "
FireWrap® Grip Kit Black,08/24/2021,Sales Receipt,5973,,"FIREWRAP® GRIP KIT
Color: Black",1,24.99  ,24.99  ,"58,404.09  "
FireWrap® Grip Kit Black,08/26/2021,Sales Receipt,5980,,"FIREWRAP® GRIP KIT
Color: Black",6,24.99  ,149.94  ,"58,554.03  "
FireWrap® Grip Kit Black,08/26/2021,Sales Receipt,5981,,"FIREWRAP® GRIP KIT
Color: Black",1,24.99  ,24.99  ,"58,579.02  "
FireWrap® Grip Kit Black,08/27/2021,Sales Receipt,5989,,"FIREWRAP® GRIP KIT
Color: Black",1,24.99  ,24.99  ,"58,604.01  "
FireWrap® Grip Kit Black,08/29/2021,Sales Receipt,5998,,"FIREWRAP® GRIP KIT
Color: Black",2,24.99  ,49.98  ,"58,653.99  "
FireWrap® Grip Kit Black,08/30/2021,Sales Receipt,6003,,"FIREWRAP® GRIP KIT
Color: Black",1,24.99  ,24.99  ,"58,678.98  "
FireWrap® Grip Kit Black,08/31/2021,Sales Receipt,6020,,"FIREWRAP® GRIP KIT
Color: Black",1,24.99  ,24.99  ,"58,703.97  "
FireWrap® Grip Kit Black,08/31/2021,Sales Receipt,6018,,"FIREWRAP® GRIP KIT
Color: Black",1,24.99  ,24.99  ,"58,728.96  "
FireWrap® Grip Kit Black,08/31/2021,Sales Receipt,6014,,"FIREWRAP® GRIP KIT
Color: Black",1,24.99  ,24.99  ,"58,753.95  "
FireWrap® Grip Kit Black,09/01/2021,Sales Receipt,6026,,"FIREWRAP® GRIP KIT
Color: Black",1,24.99  ,24.99  ,"58,778.94  "
FireWrap® Grip Kit Black,09/01/2021,Sales Receipt,6023,,"FIREWRAP® GRIP KIT
Color: Black",1,24.99  ,24.99  ,"58,803.93  "
FireWrap® Grip Kit Black,09/02/2021,Sales Receipt,6035,,"FIREWRAP® GRIP KIT
Color: Black",2,24.99  ,49.98  ,"58,853.91  "
FireWrap® Grip Kit Black,09/03/2021,Sales Receipt,6039,,"FIREWRAP® GRIP KIT
Color: Black",1,24.99  ,24.99  ,"58,878.90  "
FireWrap® Grip Kit Black,09/05/2021,Sales Receipt,6044,,"FIREWRAP® GRIP KIT
Color: Black",1,24.99  ,24.99  ,"58,903.89  "
FireWrap® Grip Kit Black,09/07/2021,Sales Receipt,6049,,"FIREWRAP® GRIP KIT
Color: Black",3,24.99  ,74.97  ,"58,978.86  "
FireWrap® Grip Kit Black,09/09/2021,Sales Receipt,6056,,"FIREWRAP® GRIP KIT
Color: Black",1,24.99  ,24.99  ,"59,003.85  "
FireWrap® Grip Kit Black,09/09/2021,Sales Receipt,6057,,"FIREWRAP® GRIP KIT
Color: Black",1,24.99  ,24.99  ,"59,028.84  "
FireWrap® Grip Kit Black,09/10/2021,Sales Receipt,6066,,"FIREWRAP® GRIP KIT
Color: Black",1,24.99  ,24.99  ,"59,053.83  "
FireWrap® Grip Kit Black,09/12/2021,Sales Receipt,6073,,"FIREWRAP® GRIP KIT
Color: Black",1,24.99  ,24.99  ,"59,078.82  "
FireWrap® Grip Kit Black,09/16/2021,Sales Receipt,6093,,"FIREWRAP® GRIP KIT
Color: Black",1,24.99  ,24.99  ,"59,103.81  "
FireWrap® Grip Kit Black,09/19/2021,Sales Receipt,6114,,"FIREWRAP® GRIP KIT
Color: Black",1,24.99  ,24.99  ,"59,128.80  "
FireWrap® Grip Kit Black,09/20/2021,Sales Receipt,6116,,"FIREWRAP® GRIP KIT
Color: Black",1,24.99  ,24.99  ,"59,153.79  "
FireWrap® Grip Kit Black,09/22/2021,Sales Receipt,6133,,"FIREWRAP® GRIP KIT
Color: Black",1,19.99  ,19.99  ,"59,173.78  "
FireWrap® Grip Kit Black,09/22/2021,Sales Receipt,6132,,"FIREWRAP® GRIP KIT
Color: Black",1,19.99  ,19.99  ,"59,193.77  "
FireWrap® Grip Kit Black,09/22/2021,Sales Receipt,6134,,"FIREWRAP® GRIP KIT
Color: Black",1,19.99  ,19.99  ,"59,213.76  "
FireWrap® Grip Kit Black,09/23/2021,Sales Receipt,6138,,"FIREWRAP® GRIP KIT
Color: Black",1,19.99  ,19.99  ,"59,233.75  "
FireWrap® Grip Kit Black,09/23/2021,Sales Receipt,6151,,"FIREWRAP® GRIP KIT
Color: Black",2,19.99  ,39.98  ,"59,273.73  "
FireWrap® Grip Kit Black,09/24/2021,Sales Receipt,6155,,"FIREWRAP® GRIP KIT
Color: Black",1,19.99  ,19.99  ,"59,293.72  "
FireWrap® Grip Kit Black,09/24/2021,Sales Receipt,6156,,"FIREWRAP® GRIP KIT
Color: Black",1,19.99  ,19.99  ,"59,313.71  "
FireWrap® Grip Kit Black,09/26/2021,Sales Receipt,6167,,"FIREWRAP® GRIP KIT
Color: Black",1,19.99  ,19.99  ,"59,333.70  "
FireWrap® Grip Kit Black,09/27/2021,Sales Receipt,6180,,"FIREWRAP® GRIP KIT
Color: Black",1,19.99  ,19.99  ,"59,353.69  "
FireWrap® Grip Kit Black,09/29/2021,Sales Receipt,6192,,"FIREWRAP® GRIP KIT
Color: Black",8,19.99  ,159.92  ,"59,513.61  "
FireWrap® Grip Kit Black,09/30/2021,Sales Receipt,6207,,"FIREWRAP® GRIP KIT
Color: Black",8,24.95  ,199.60  ,"59,713.21  "
FireWrap® Grip Kit Black,10/02/2021,Sales Receipt,6213,,"FIREWRAP® GRIP KIT
Color: Black",2,24.95  ,49.90  ,"59,763.11  "
FireWrap® Grip Kit Black,10/03/2021,Sales Receipt,6220,,"FIREWRAP® GRIP KIT
Color: Black",2,24.95  ,49.90  ,"59,813.01  "
FireWrap® Grip Kit Black,10/04/2021,Sales Receipt,6226,,"FIREWRAP® GRIP KIT
Color: Black",1,24.95  ,24.95  ,"59,837.96  "
FireWrap® Grip Kit Black,10/04/2021,Sales Receipt,6230,,"FIREWRAP® GRIP KIT
Color: Black",6,24.95  ,149.70  ,"59,987.66  "
FireWrap® Grip Kit Black,10/04/2021,Sales Receipt,6236,,"FIREWRAP® GRIP KIT
Color: Black",1,24.95  ,24.95  ,"60,012.61  "
FireWrap® Grip Kit Black,10/06/2021,Sales Receipt,6242,,"FIREWRAP® GRIP KIT
Color: Black",1,24.95  ,24.95  ,"60,037.56  "
FireWrap® Grip Kit Black,10/07/2021,Sales Receipt,6255,,"FIREWRAP® GRIP KIT
Color: Black",1,24.95  ,24.95  ,"60,062.51  "
FireWrap® Grip Kit Black,10/07/2021,Sales Receipt,6257,,"FIREWRAP® GRIP KIT
Color: Black",1,24.95  ,24.95  ,"60,087.46  "
FireWrap® Grip Kit Black,10/08/2021,Sales Receipt,6263,,"FIREWRAP® GRIP KIT
Color: Black",1,24.95  ,24.95  ,"60,112.41  "
FireWrap® Grip Kit Black,10/08/2021,Sales Receipt,6261,,"FIREWRAP® GRIP KIT
Color: Black",1,24.95  ,24.95  ,"60,137.36  "
FireWrap® Grip Kit Black,10/09/2021,Sales Receipt,6268,,"FIREWRAP® GRIP KIT
Color: Black",1,24.95  ,24.95  ,"60,162.31  "
FireWrap® Grip Kit Black,10/09/2021,Sales Receipt,6267,,"FIREWRAP® GRIP KIT
Color: Black",1,24.95  ,24.95  ,"60,187.26  "
FireWrap® Grip Kit Black,10/11/2021,Sales Receipt,6277,,"FIREWRAP® GRIP KIT
Color: Black",1,24.95  ,24.95  ,"60,212.21  "
FireWrap® Grip Kit Black,10/12/2021,Sales Receipt,6288,,"FIREWRAP® GRIP KIT
Color: Black",1,24.95  ,24.95  ,"60,237.16  "
FireWrap® Grip Kit Black,10/14/2021,Sales Receipt,6303,,"FIREWRAP® GRIP KIT
Color: Black",1,24.95  ,24.95  ,"60,262.11  "
FireWrap® Grip Kit Black,10/15/2021,Sales Receipt,6308,,"FIREWRAP® GRIP KIT
Color: Black",2,24.95  ,49.90  ,"60,312.01  "
FireWrap® Grip Kit Black,10/15/2021,Sales Receipt,6304,,"FIREWRAP® GRIP KIT
Color: Black",1,24.95  ,24.95  ,"60,336.96  "
FireWrap® Grip Kit Black,10/16/2021,Sales Receipt,6313,,"FIREWRAP® GRIP KIT
Color: Black",1,24.95  ,24.95  ,"60,361.91  "
FireWrap® Grip Kit Black,10/16/2021,Sales Receipt,6312,,"FIREWRAP® GRIP KIT
Color: Black",1,24.95  ,24.95  ,"60,386.86  "
FireWrap® Grip Kit Black,10/17/2021,Sales Receipt,6318,,"FIREWRAP® GRIP KIT
Color: Black",1,24.95  ,24.95  ,"60,411.81  "
FireWrap® Grip Kit Black,10/20/2021,Sales Receipt,6339,,"FIREWRAP® GRIP KIT
Color: Black",15,24.95  ,374.25  ,"60,786.06  "
FireWrap® Grip Kit Black,10/20/2021,Sales Receipt,6340,,"FIREWRAP® GRIP KIT
Color: Black",1,24.95  ,24.95  ,"60,811.01  "
FireWrap® Grip Kit Black,10/21/2021,Sales Receipt,6346,,"FIREWRAP® GRIP KIT
Color: Black",1,24.95  ,24.95  ,"60,835.96  "
FireWrap® Grip Kit Black,10/22/2021,Sales Receipt,6351,,"FIREWRAP® GRIP KIT
Color: Black",1,24.95  ,24.95  ,"60,860.91  "
FireWrap® Grip Kit Black,10/27/2021,Sales Receipt,6377,,"FIREWRAP® GRIP KIT
Color: Black",2,24.95  ,49.90  ,"60,910.81  "
FireWrap® Grip Kit Black,10/27/2021,Sales Receipt,6378,,"FIREWRAP® GRIP KIT
Color: Black",1,24.95  ,24.95  ,"60,935.76  "
FireWrap® Grip Kit Black,10/27/2021,Sales Receipt,6382,,"FIREWRAP® GRIP KIT
Color: Black",1,24.95  ,24.95  ,"60,960.71  "
FireWrap® Grip Kit Black,10/28/2021,Sales Receipt,6383,,"FIREWRAP® GRIP KIT
Color: Black",1,24.95  ,24.95  ,"60,985.66  "
FireWrap® Grip Kit Black,10/29/2021,Sales Receipt,6385,,"FIREWRAP® GRIP KIT
Color: Black",3,24.95  ,74.85  ,"61,060.51  "
FireWrap® Grip Kit Black,10/31/2021,Sales Receipt,6404,,"FIREWRAP® GRIP KIT
Color: Black",1,24.95  ,24.95  ,"61,085.46  "
FireWrap® Grip Kit Black,10/31/2021,Sales Receipt,6400,,"FIREWRAP® GRIP KIT
Color: Black",1,24.95  ,24.95  ,"61,110.41  "
FireWrap® Grip Kit Black,11/01/2021,Sales Receipt,6419,,"FIREWRAP® GRIP KIT
Color: Black",1,24.95  ,24.95  ,"61,135.36  "
FireWrap® Grip Kit Black,11/03/2021,Sales Receipt,6423,,"FIREWRAP® GRIP KIT
Color: Black",1,24.95  ,24.95  ,"61,160.31  "
FireWrap® Grip Kit Black,11/04/2021,Sales Receipt,6432,,"FIREWRAP® GRIP KIT
Color: Black",1,24.95  ,24.95  ,"61,185.26  "
FireWrap® Grip Kit Black,11/05/2021,Sales Receipt,6438,,"FIREWRAP® GRIP KIT
Color: Black",2,24.95  ,49.90  ,"61,235.16  "
FireWrap® Grip Kit Black,11/05/2021,Sales Receipt,6436,,"FIREWRAP® GRIP KIT
Color: Black",1,24.95  ,24.95  ,"61,260.11  "
FireWrap® Grip Kit Black,11/05/2021,Sales Receipt,6435,,"FIREWRAP® GRIP KIT
Color: Black",1,24.95  ,24.95  ,"61,285.06  "
FireWrap® Grip Kit Black,11/05/2021,Sales Receipt,6433,,"FIREWRAP® GRIP KIT
Color: Black",1,24.95  ,24.95  ,"61,310.01  "
FireWrap® Grip Kit Black,11/06/2021,Sales Receipt,6442,,"FIREWRAP® GRIP KIT
Color: Black",2,24.95  ,49.90  ,"61,359.91  "
FireWrap® Grip Kit Black,11/09/2021,Sales Receipt,6453,,"FIREWRAP® GRIP KIT
Color: Black",1,24.95  ,24.95  ,"61,384.86  "
FireWrap® Grip Kit Black,11/10/2021,Sales Receipt,6464,,"FIREWRAP® GRIP KIT
Color: Black",1,24.95  ,24.95  ,"61,409.81  "
FireWrap® Grip Kit Black,11/12/2021,Sales Receipt,6485,,"FIREWRAP® GRIP KIT
Color: Black",2,24.95  ,49.90  ,"61,459.71  "
FireWrap® Grip Kit Black,11/12/2021,Sales Receipt,6488,,"FIREWRAP® GRIP KIT
Color: Black",2,24.95  ,49.90  ,"61,509.61  "
FireWrap® Grip Kit Black,11/13/2021,Sales Receipt,6497,,"FIREWRAP® GRIP KIT
Color: Black",1,24.95  ,24.95  ,"61,534.56  "
FireWrap® Grip Kit Black,11/13/2021,Sales Receipt,6495,,"FIREWRAP® GRIP KIT
Color: Black",1,24.95  ,24.95  ,"61,559.51  "
FireWrap® Grip Kit Black,11/13/2021,Sales Receipt,6499,,"FIREWRAP® GRIP KIT
Color: Black",1,24.95  ,24.95  ,"61,584.46  "
FireWrap® Grip Kit Black,11/14/2021,Sales Receipt,6505,,"FIREWRAP® GRIP KIT
Color: Black",4,24.95  ,99.80  ,"61,684.26  "
FireWrap® Grip Kit Black,11/15/2021,Sales Receipt,6516,,"FIREWRAP® GRIP KIT
Color: Black",1,24.95  ,24.95  ,"61,709.21  "
FireWrap® Grip Kit Black,11/16/2021,Sales Receipt,6525,,"FIREWRAP® GRIP KIT
Color: Black",1,24.95  ,24.95  ,"61,734.16  "
FireWrap® Grip Kit Black,11/18/2021,Sales Receipt,6535,,"FIREWRAP® GRIP KIT
Color: Black",1,24.95  ,24.95  ,"61,759.11  "
FireWrap® Grip Kit Black,11/19/2021,Sales Receipt,6540,,"FIREWRAP® GRIP KIT
Color: Black",1,24.95  ,24.95  ,"61,784.06  "
FireWrap® Grip Kit Black,11/19/2021,Sales Receipt,6543,,"FIREWRAP® GRIP KIT
Color: Black",1,24.95  ,24.95  ,"61,809.01  "
FireWrap® Grip Kit Black,11/19/2021,Sales Receipt,6541,,"FIREWRAP® GRIP KIT
Color: Black",12,24.95  ,299.40  ,"62,108.41  "
FireWrap® Grip Kit Black,11/20/2021,Sales Receipt,6546,,"FIREWRAP® GRIP KIT
Color: Black",1,24.95  ,24.95  ,"62,133.36  "
FireWrap® Grip Kit Black,11/21/2021,Sales Receipt,6554,,"FIREWRAP® GRIP KIT
Color: Black",1,24.95  ,24.95  ,"62,158.31  "
FireWrap® Grip Kit Black,11/22/2021,Sales Receipt,6560,,"FIREWRAP® GRIP KIT
Color: Black",1,24.95  ,24.95  ,"62,183.26  "
FireWrap® Grip Kit Black,11/22/2021,Sales Receipt,6557,,"FIREWRAP® GRIP KIT
Color: Black",1,24.95  ,24.95  ,"62,208.21  "
FireWrap® Grip Kit Black,11/22/2021,Sales Receipt,6556,,"FIREWRAP® GRIP KIT
Color: Black",1,24.95  ,24.95  ,"62,233.16  "
FireWrap® Grip Kit Black,11/24/2021,Sales Receipt,6572,,"FIREWRAP® GRIP KIT
Color: Black",1,19.99  ,19.99  ,"62,253.15  "
FireWrap® Grip Kit Black,11/24/2021,Sales Receipt,6578,,"FIREWRAP® GRIP KIT
Color: Black",1,19.99  ,19.99  ,"62,273.14  "
FireWrap® Grip Kit Black,11/24/2021,Sales Receipt,6573,,"FIREWRAP® GRIP KIT
Color: Black",2,19.99  ,39.98  ,"62,313.12  "
FireWrap® Grip Kit Black,11/25/2021,Sales Receipt,6583,,"FIREWRAP® GRIP KIT
Color: Black",1,19.99  ,19.99  ,"62,333.11  "
FireWrap® Grip Kit Black,11/26/2021,Sales Receipt,6599,,"FIREWRAP® GRIP KIT
Color: Black",1,19.99  ,19.99  ,"62,353.10  "
FireWrap® Grip Kit Black,11/26/2021,Sales Receipt,6594,,"FIREWRAP® GRIP KIT
Color: Black",2,19.99  ,39.98  ,"62,393.08  "
FireWrap® Grip Kit Black,11/27/2021,Sales Receipt,6608,,"FIREWRAP® GRIP KIT
Color: Black",2,19.99  ,39.98  ,"62,433.06  "
FireWrap® Grip Kit Black,11/27/2021,Sales Receipt,6607,,"FIREWRAP® GRIP KIT
Color: Black",1,19.99  ,19.99  ,"62,453.05  "
FireWrap® Grip Kit Black,11/27/2021,Sales Receipt,6611,,"FIREWRAP® GRIP KIT
Color: Black",1,19.99  ,19.99  ,"62,473.04  "
FireWrap® Grip Kit Black,11/28/2021,Sales Receipt,6616,,"FIREWRAP® GRIP KIT
Color: Black",2,19.99  ,39.98  ,"62,513.02  "
FireWrap® Grip Kit Black,11/29/2021,Sales Receipt,6619,,"FIREWRAP® GRIP KIT
Color: Black",1,19.99  ,19.99  ,"62,533.01  "
FireWrap® Grip Kit Black,11/30/2021,Sales Receipt,6628,,"FIREWRAP® GRIP KIT
Color: Black",6,19.99  ,119.94  ,"62,652.95  "
FireWrap® Grip Kit Black,11/30/2021,Sales Receipt,6630,,"FIREWRAP® GRIP KIT
Color: Black",1,19.99  ,19.99  ,"62,672.94  "
FireWrap® Grip Kit Black,12/01/2021,Sales Receipt,6640,,"FIREWRAP® GRIP KIT
Color: Black",2,19.99  ,39.98  ,"62,712.92  "
FireWrap® Grip Kit Black,12/01/2021,Sales Receipt,6642,,"FIREWRAP® GRIP KIT
Color: Black",1,19.99  ,19.99  ,"62,732.91  "
FireWrap® Grip Kit Black,12/02/2021,Sales Receipt,6651,,"FIREWRAP® GRIP KIT
Color: Black",1,19.99  ,19.99  ,"62,752.90  "
FireWrap® Grip Kit Black,12/02/2021,Sales Receipt,6643,,"FIREWRAP® GRIP KIT
Color: Black",1,19.99  ,19.99  ,"62,772.89  "
FireWrap® Grip Kit Black,12/03/2021,Sales Receipt,6662,,"FIREWRAP® GRIP KIT
Color: Black",2,19.99  ,39.98  ,"62,812.87  "
FireWrap® Grip Kit Black,12/03/2021,Sales Receipt,6655,,"FIREWRAP® GRIP KIT
Color: Black",12,19.99  ,239.88  ,"63,052.75  "
FireWrap® Grip Kit Black,12/04/2021,Sales Receipt,6664,,"FIREWRAP® GRIP KIT
Color: Black",2,19.99  ,39.98  ,"63,092.73  "
FireWrap® Grip Kit Black,12/05/2021,Sales Receipt,6670,,"FIREWRAP® GRIP KIT
Color: Black",1,19.99  ,19.99  ,"63,112.72  "
FireWrap® Grip Kit Black,12/05/2021,Sales Receipt,6676,,"FIREWRAP® GRIP KIT
Color: Black",1,19.99  ,19.99  ,"63,132.71  "
FireWrap® Grip Kit Black,12/06/2021,Sales Receipt,6686,,"FIREWRAP® GRIP KIT
Color: Black",1,24.95  ,24.95  ,"63,157.66  "
FireWrap® Grip Kit Black,12/06/2021,Sales Receipt,6685,,"FIREWRAP® GRIP KIT
Color: Black",1,24.95  ,24.95  ,"63,182.61  "
FireWrap® Grip Kit Black,12/07/2021,Sales Receipt,6688,,"FIREWRAP® GRIP KIT
Color: Black",4,24.95  ,99.80  ,"63,282.41  "
FireWrap® Grip Kit Black,12/08/2021,Sales Receipt,6704,,"FIREWRAP® GRIP KIT
Color: Black",1,24.95  ,24.95  ,"63,307.36  "
FireWrap® Grip Kit Black,12/09/2021,Sales Receipt,6708,,"FIREWRAP® GRIP KIT
Color: Black",1,24.95  ,24.95  ,"63,332.31  "
FireWrap® Grip Kit Black,12/09/2021,Sales Receipt,6711,,"FIREWRAP® GRIP KIT
Color: Black",2,24.95  ,49.90  ,"63,382.21  "
FireWrap® Grip Kit Black,12/10/2021,Sales Receipt,6720,,"FIREWRAP® GRIP KIT
Color: Black",1,24.95  ,24.95  ,"63,407.16  "
FireWrap® Grip Kit Black,12/10/2021,Sales Receipt,6715,,"FIREWRAP® GRIP KIT
Color: Black",1,24.95  ,24.95  ,"63,432.11  "
FireWrap® Grip Kit Black,12/12/2021,Sales Receipt,6725,,"FIREWRAP® GRIP KIT
Color: Black",1,24.95  ,24.95  ,"63,457.06  "
FireWrap® Grip Kit Black,12/13/2021,Sales Receipt,6736,,"FIREWRAP® GRIP KIT
Color: Black",1,24.95  ,24.95  ,"63,482.01  "
FireWrap® Grip Kit Black,12/13/2021,Sales Receipt,6737,,"FIREWRAP® GRIP KIT
Color: Black",1,24.95  ,24.95  ,"63,506.96  "
FireWrap® Grip Kit Black,12/14/2021,Sales Receipt,6743,,"FIREWRAP® GRIP KIT
Color: Black",1,24.95  ,24.95  ,"63,531.91  "
FireWrap® Grip Kit Black,12/15/2021,Sales Receipt,6748,,"FIREWRAP® GRIP KIT
Color: Black",1,24.95  ,24.95  ,"63,556.86  "
FireWrap® Grip Kit Black,12/15/2021,Sales Receipt,6746,,"FIREWRAP® GRIP KIT
Color: Black",2,24.95  ,49.90  ,"63,606.76  "
FireWrap® Grip Kit Black,12/15/2021,Sales Receipt,6750,,"FIREWRAP® GRIP KIT
Color: Black",1,24.95  ,24.95  ,"63,631.71  "
FireWrap® Grip Kit Black,12/16/2021,Sales Receipt,6751,,"FIREWRAP® GRIP KIT
Color: Black",1,24.95  ,24.95  ,"63,656.66  "
FireWrap® Grip Kit Black,12/16/2021,Sales Receipt,6757,,"FIREWRAP® GRIP KIT
Color: Black",1,24.95  ,24.95  ,"63,681.61  "
FireWrap® Grip Kit Black,12/17/2021,Sales Receipt,6768,,"FIREWRAP® GRIP KIT
Color: Black",1,24.95  ,24.95  ,"63,706.56  "
FireWrap® Grip Kit Black,12/18/2021,Sales Receipt,6777,,"FIREWRAP® GRIP KIT
Color: Black",1,24.95  ,24.95  ,"63,731.51  "
FireWrap® Grip Kit Black,12/19/2021,Sales Receipt,6785,,"FIREWRAP® GRIP KIT
Color: Black",1,24.95  ,24.95  ,"63,756.46  "
FireWrap® Grip Kit Black,12/21/2021,Sales Receipt,6791,,"FIREWRAP® GRIP KIT
Color: Black",1,24.95  ,24.95  ,"63,781.41  "
FireWrap® Grip Kit Black,12/23/2021,Sales Receipt,6804,,"FIREWRAP® GRIP KIT
Color: Black",1,24.95  ,24.95  ,"63,806.36  "
FireWrap® Grip Kit Black,12/23/2021,Sales Receipt,6809,,"FIREWRAP® GRIP KIT
Color: Black",1,24.95  ,24.95  ,"63,831.31  "
FireWrap® Grip Kit Black,12/25/2021,Sales Receipt,6830,,"FIREWRAP® GRIP KIT
Color: Black",1,24.95  ,24.95  ,"63,856.26  "
FireWrap® Grip Kit Black,12/25/2021,Sales Receipt,6823,,"FIREWRAP® GRIP KIT
Color: Black",1,24.95  ,24.95  ,"63,881.21  "
FireWrap® Grip Kit Black,12/25/2021,Sales Receipt,6824,,"FIREWRAP® GRIP KIT
Color: Black",1,24.95  ,24.95  ,"63,906.16  "
FireWrap® Grip Kit Black,12/26/2021,Sales Receipt,6834,,"FIREWRAP® GRIP KIT
Color: Black",1,24.95  ,24.95  ,"63,931.11  "
FireWrap® Grip Kit Black,12/27/2021,Sales Receipt,6847,,"FIREWRAP® GRIP KIT
Color: Black",1,24.95  ,24.95  ,"63,956.06  "
FireWrap® Grip Kit Black,12/27/2021,Sales Receipt,6841,,"FIREWRAP® GRIP KIT
Color: Black",1,24.95  ,24.95  ,"63,981.01  "
FireWrap® Grip Kit Black,12/27/2021,Sales Receipt,6848,,"FIREWRAP® GRIP KIT
Color: Black",1,24.95  ,24.95  ,"64,005.96  "
FireWrap® Grip Kit Black,01/02/2022,Sales Receipt,6892,,"FIREWRAP® GRIP KIT
Color: Black",1,24.95  ,24.95  ,"64,030.91  "
FireWrap® Grip Kit Black,01/03/2022,Sales Receipt,6904,,"FIREWRAP® GRIP KIT
Color: Black",1,24.95  ,24.95  ,"64,055.86  "
FireWrap® Grip Kit Black,01/03/2022,Sales Receipt,6903,,"FIREWRAP® GRIP KIT
Color: Black",1,24.95  ,24.95  ,"64,080.81  "
FireWrap® Grip Kit Black,01/05/2022,Sales Receipt,6923,,"FIREWRAP® GRIP KIT
Color: Black",2,24.95  ,49.90  ,"64,130.71  "
FireWrap® Grip Kit Black,01/05/2022,Sales Receipt,6917,,"FIREWRAP® GRIP KIT
Color: Black",1,24.95  ,24.95  ,"64,155.66  "
FireWrap® Grip Kit Black,01/05/2022,Sales Receipt,6916,,"FIREWRAP® GRIP KIT
Color: Black",1,24.95  ,24.95  ,"64,180.61  "
FireWrap® Grip Kit Black,01/07/2022,Sales Receipt,6949,,"FIREWRAP® GRIP KIT
Color: Black",1,24.95  ,24.95  ,"64,205.56  "
FireWrap® Grip Kit Black,01/10/2022,Sales Receipt,6970,,"FIREWRAP® GRIP KIT
Color: Black",2,24.95  ,49.90  ,"64,255.46  "
FireWrap® Grip Kit Black,01/10/2022,Sales Receipt,6967,,"FIREWRAP® GRIP KIT
Color: Black",8,24.95  ,199.60  ,"64,455.06  "
FireWrap® Grip Kit Black,01/10/2022,Sales Receipt,6969,,"FIREWRAP® GRIP KIT
Color: Black",3,24.95  ,74.85  ,"64,529.91  "
FireWrap® Grip Kit Black,01/10/2022,Sales Receipt,6977,,"FIREWRAP® GRIP KIT
Color: Black",1,24.95  ,24.95  ,"64,554.86  "
FireWrap® Grip Kit Black,01/11/2022,Sales Receipt,6978,,"FIREWRAP® GRIP KIT
Color: Black",10,24.95  ,249.50  ,"64,804.36  "
FireWrap® Grip Kit Black,01/12/2022,Sales Receipt,6989,,"FIREWRAP® GRIP KIT
Color: Black",1,24.95  ,24.95  ,"64,829.31  "
FireWrap® Grip Kit Black,01/13/2022,Sales Receipt,6998,,"FIREWRAP® GRIP KIT
Color: Black",1,24.95  ,24.95  ,"64,854.26  "
FireWrap® Grip Kit Black,01/13/2022,Sales Receipt,6995,,"FIREWRAP® GRIP KIT
Color: Black",1,24.95  ,24.95  ,"64,879.21  "
FireWrap® Grip Kit Black,01/13/2022,Sales Receipt,6999,,"FIREWRAP® GRIP KIT
Color: Black",1,24.95  ,24.95  ,"64,904.16  "
FireWrap® Grip Kit Black,01/14/2022,Sales Receipt,7003,,"FIREWRAP® GRIP KIT
Color: Black",1,24.95  ,24.95  ,"64,929.11  "
FireWrap® Grip Kit Black,01/15/2022,Sales Receipt,7009,,"FIREWRAP® GRIP KIT
Color: Black",1,24.95  ,24.95  ,"64,954.06  "
FireWrap® Grip Kit Black,01/17/2022,Sales Receipt,7022,,"FIREWRAP® GRIP KIT
Color: Black",1,24.95  ,24.95  ,"64,979.01  "
FireWrap® Grip Kit Black,01/17/2022,Sales Receipt,7020,,"FIREWRAP® GRIP KIT
Color: Black",1,24.95  ,24.95  ,"65,003.96  "
FireWrap® Grip Kit Black,01/18/2022,Sales Receipt,7025,,"FIREWRAP® GRIP KIT
Color: Black",6,24.95  ,149.70  ,"65,153.66  "
FireWrap® Grip Kit Black,01/18/2022,Sales Receipt,7035,,"FIREWRAP® GRIP KIT
Color: Black",1,24.95  ,24.95  ,"65,178.61  "
FireWrap® Grip Kit Black,01/18/2022,Sales Receipt,7032,,"FIREWRAP® GRIP KIT
Color: Black",2,24.95  ,49.90  ,"65,228.51  "
FireWrap® Grip Kit Black,01/18/2022,Sales Receipt,7036,,"FIREWRAP® GRIP KIT
Color: Black",2,24.95  ,49.90  ,"65,278.41  "
FireWrap® Grip Kit Black,01/19/2022,Sales Receipt,7045,,"FIREWRAP® GRIP KIT
Color: Black",1,24.95  ,24.95  ,"65,303.36  "
FireWrap® Grip Kit Black,01/19/2022,Sales Receipt,7038,,"FIREWRAP® GRIP KIT
Color: Black",1,24.95  ,24.95  ,"65,328.31  "
FireWrap® Grip Kit Black,01/19/2022,Sales Receipt,7044,,"FIREWRAP® GRIP KIT
Color: Black",1,24.95  ,24.95  ,"65,353.26  "
FireWrap® Grip Kit Black,01/19/2022,Sales Receipt,7042,,"FIREWRAP® GRIP KIT
Color: Black",1,24.95  ,24.95  ,"65,378.21  "
FireWrap® Grip Kit Black,01/21/2022,Sales Receipt,7058,,"FIREWRAP® GRIP KIT
Color: Black",1,24.95  ,24.95  ,"65,403.16  "
FireWrap® Grip Kit Black,01/21/2022,Sales Receipt,7063,,"FIREWRAP® GRIP KIT
Color: Black",1,24.95  ,24.95  ,"65,428.11  "
FireWrap® Grip Kit Black,01/22/2022,Sales Receipt,7066,,"FIREWRAP® GRIP KIT
Color: Black",1,24.95  ,24.95  ,"65,453.06  "
FireWrap® Grip Kit Black,01/24/2022,Sales Receipt,7083,,"FIREWRAP® GRIP KIT
Color: Black",1,24.95  ,24.95  ,"65,478.01  "
FireWrap® Grip Kit Black,01/25/2022,Sales Receipt,7086,,"FIREWRAP® GRIP KIT
Color: Black",2,24.95  ,49.90  ,"65,527.91  "
FireWrap® Grip Kit Black,01/25/2022,Sales Receipt,7091,,"FIREWRAP® GRIP KIT
Color: Black",2,24.95  ,49.90  ,"65,577.81  "
FireWrap® Grip Kit Black,01/25/2022,Sales Receipt,7090,,"FIREWRAP® GRIP KIT
Color: Black",5,24.95  ,124.75  ,"65,702.56  "
FireWrap® Grip Kit Black,01/25/2022,Sales Receipt,7089,,"FIREWRAP® GRIP KIT
Color: Black",3,24.95  ,74.85  ,"65,777.41  "
FireWrap® Grip Kit Black,01/25/2022,Sales Receipt,7095,,"FIREWRAP® GRIP KIT
Color: Black",1,24.95  ,24.95  ,"65,802.36  "
FireWrap® Grip Kit Black,01/25/2022,Sales Receipt,7094,,"FIREWRAP® GRIP KIT
Color: Black",1,24.95  ,24.95  ,"65,827.31  "
FireWrap® Grip Kit Black,01/26/2022,Sales Receipt,7099,,"FIREWRAP® GRIP KIT
Color: Black",2,24.95  ,49.90  ,"65,877.21  "
FireWrap® Grip Kit Black,01/26/2022,Sales Receipt,7105,,"FIREWRAP® GRIP KIT
Color: Black",1,24.95  ,24.95  ,"65,902.16  "
FireWrap® Grip Kit Black,01/27/2022,Sales Receipt,7111,,"FIREWRAP® GRIP KIT
Color: Black",5,24.95  ,124.75  ,"66,026.91  "
FireWrap® Grip Kit Black,01/28/2022,Sales Receipt,7141,,"FIREWRAP® GRIP KIT
Color: Black",1,24.95  ,24.95  ,"66,051.86  "
FireWrap® Grip Kit Black,01/28/2022,Sales Receipt,7129,,"FIREWRAP® GRIP KIT
Color: Black",4,24.95  ,99.80  ,"66,151.66  "
FireWrap® Grip Kit Black,01/28/2022,Sales Receipt,7133,,"FIREWRAP® GRIP KIT
Color: Black",2,24.95  ,49.90  ,"66,201.56  "
FireWrap® Grip Kit Black,01/30/2022,Sales Receipt,7154,,"FIREWRAP® GRIP KIT
Color: Black",2,24.95  ,49.90  ,"66,251.46  "
FireWrap® Grip Kit Black,01/30/2022,Sales Receipt,7156,,"FIREWRAP® GRIP KIT
Color: Black",1,24.95  ,24.95  ,"66,276.41  "
FireWrap® Grip Kit Black,01/31/2022,Sales Receipt,7168,,"FIREWRAP® GRIP KIT
Color: Black",1,24.95  ,24.95  ,"66,301.36  "
FireWrap® Grip Kit Black,02/02/2022,Sales Receipt,7183,,"FIREWRAP® GRIP KIT
Color: Black",1,27.95  ,27.95  ,"66,329.31  "
FireWrap® Grip Kit Black,02/03/2022,Sales Receipt,7190,,"FIREWRAP® GRIP KIT
Color: Black",4,27.95  ,111.80  ,"66,441.11  "
FireWrap® Grip Kit Black,02/04/2022,Sales Receipt,7193,,"FIREWRAP® GRIP KIT
Color: Black",1,27.95  ,27.95  ,"66,469.06  "
FireWrap® Grip Kit Black,02/05/2022,Sales Receipt,7201,,"FIREWRAP® GRIP KIT
Color: Black",6,27.95  ,167.70  ,"66,636.76  "
FireWrap® Grip Kit Black,02/06/2022,Sales Receipt,7210,,"FIREWRAP® GRIP KIT
Color: Black",1,27.95  ,27.95  ,"66,664.71  "
FireWrap® Grip Kit Black,02/07/2022,Sales Receipt,7216,,"FIREWRAP® GRIP KIT
Color: Black",1,27.95  ,27.95  ,"66,692.66  "
FireWrap® Grip Kit Black,02/07/2022,Sales Receipt,7219,,"FIREWRAP® GRIP KIT
Color: Black",4,27.95  ,111.80  ,"66,804.46  "
FireWrap® Grip Kit Black,02/07/2022,Sales Receipt,7218,,"FIREWRAP® GRIP KIT
Color: Black",1,27.95  ,27.95  ,"66,832.41  "
FireWrap® Grip Kit Black,02/08/2022,Sales Receipt,7229,,"FIREWRAP® GRIP KIT
Color: Black",1,27.95  ,27.95  ,"66,860.36  "
FireWrap® Grip Kit Black,02/09/2022,Sales Receipt,7238,,"FIREWRAP® GRIP KIT
Color: Black",1,27.95  ,27.95  ,"66,888.31  "
FireWrap® Grip Kit Black,02/09/2022,Sales Receipt,7247,,"FIREWRAP® GRIP KIT
Color: Black",7,27.95  ,195.65  ,"67,083.96  "
FireWrap® Grip Kit Black,02/09/2022,Sales Receipt,7248,,"FIREWRAP® GRIP KIT
Color: Black",1,27.95  ,27.95  ,"67,111.91  "
FireWrap® Grip Kit Black,02/09/2022,Sales Receipt,7243,,"FIREWRAP® GRIP KIT
Color: Black",2,27.95  ,55.90  ,"67,167.81  "
FireWrap® Grip Kit Black,02/09/2022,Sales Receipt,7240,,"FIREWRAP® GRIP KIT
Color: Black",4,27.95  ,111.80  ,"67,279.61  "
FireWrap® Grip Kit Black,02/09/2022,Sales Receipt,7239,,"FIREWRAP® GRIP KIT
Color: Black",1,27.95  ,27.95  ,"67,307.56  "
FireWrap® Grip Kit Black,02/10/2022,Sales Receipt,7254,,"FIREWRAP® GRIP KIT
Color: Black",1,27.95  ,27.95  ,"67,335.51  "
FireWrap® Grip Kit Black,02/12/2022,Sales Receipt,7271,,"FIREWRAP® GRIP KIT
Color: Black",1,27.95  ,27.95  ,"67,363.46  "
FireWrap® Grip Kit Black,02/13/2022,Sales Receipt,7282,,"FIREWRAP® GRIP KIT
Color: Black",1,27.95  ,27.95  ,"67,391.41  "
FireWrap® Grip Kit Black,02/13/2022,Sales Receipt,7274,,"FIREWRAP® GRIP KIT
Color: Black",1,27.95  ,27.95  ,"67,419.36  "
FireWrap® Grip Kit Black,02/15/2022,Sales Receipt,7289,,"FIREWRAP® GRIP KIT
Color: Black",1,27.95  ,27.95  ,"67,447.31  "
FireWrap® Grip Kit Black,02/16/2022,Sales Receipt,7298,,"FIREWRAP® GRIP KIT
Color: Black",1,27.95  ,27.95  ,"67,475.26  "
FireWrap® Grip Kit Black,02/16/2022,Sales Receipt,7295,,"FIREWRAP® GRIP KIT
Color: Black",1,27.95  ,27.95  ,"67,503.21  "
FireWrap® Grip Kit Black,02/16/2022,Sales Receipt,7296,,"FIREWRAP® GRIP KIT
Color: Black",1,27.95  ,27.95  ,"67,531.16  "
FireWrap® Grip Kit Black,02/18/2022,Sales Receipt,7318,,"FIREWRAP® GRIP KIT
Color: Black",1,27.95  ,27.95  ,"67,559.11  "
FireWrap® Grip Kit Black,02/20/2022,Sales Receipt,7330,,"FIREWRAP® GRIP KIT
Color: Black",1,27.95  ,27.95  ,"67,587.06  "
FireWrap® Grip Kit Black,02/20/2022,Sales Receipt,7335,,"FIREWRAP® GRIP KIT
Color: Black",1,27.95  ,27.95  ,"67,615.01  "
FireWrap® Grip Kit Black,02/21/2022,Sales Receipt,7348,,"FIREWRAP® GRIP KIT
Color: Black",1,27.95  ,27.95  ,"67,642.96  "
FireWrap® Grip Kit Black,02/21/2022,Sales Receipt,7352,,"FIREWRAP® GRIP KIT
Color: Black",1,27.95  ,27.95  ,"67,670.91  "
FireWrap® Grip Kit Black,02/22/2022,Sales Receipt,7366,,"FIREWRAP® GRIP KIT
Color: Black",1,27.95  ,27.95  ,"67,698.86  "
FireWrap® Grip Kit Black,02/22/2022,Sales Receipt,7364,,"FIREWRAP® GRIP KIT
Color: Black",2,27.95  ,55.90  ,"67,754.76  "
FireWrap® Grip Kit Black,02/22/2022,Sales Receipt,7359,,"FIREWRAP® GRIP KIT
Color: Black",1,27.95  ,27.95  ,"67,782.71  "
FireWrap® Grip Kit Black,02/22/2022,Sales Receipt,7362,,"FIREWRAP® GRIP KIT
Color: Black",4,27.95  ,111.80  ,"67,894.51  "
FireWrap® Grip Kit Black,02/22/2022,Sales Receipt,7358,,"FIREWRAP® GRIP KIT
Color: Black",1,27.95  ,27.95  ,"67,922.46  "
FireWrap® Grip Kit Black,02/24/2022,Sales Receipt,7377,,"FIREWRAP® GRIP KIT
Color: Black",1,27.95  ,27.95  ,"67,950.41  "
FireWrap® Grip Kit Black,02/25/2022,Sales Receipt,7388,,"FIREWRAP® GRIP KIT
Color: Black",1,27.95  ,27.95  ,"67,978.36  "
FireWrap® Grip Kit Black,02/25/2022,Sales Receipt,7391,,"FIREWRAP® GRIP KIT
Color: Black",1,27.95  ,27.95  ,"68,006.31  "
FireWrap® Grip Kit Black,02/25/2022,Sales Receipt,7393,,"FIREWRAP® GRIP KIT
Color: Black",3,27.95  ,83.85  ,"68,090.16  "
FireWrap® Grip Kit Black,02/27/2022,Sales Receipt,7415,,"FIREWRAP® GRIP KIT
Color: Black",1,27.95  ,27.95  ,"68,118.11  "
FireWrap® Grip Kit Black,02/27/2022,Sales Receipt,7402,,"FIREWRAP® GRIP KIT
Color: Black",2,27.95  ,55.90  ,"68,174.01  "
FireWrap® Grip Kit Black,02/28/2022,Sales Receipt,7431,,"FIREWRAP® GRIP KIT
Color: Black",1,27.95  ,27.95  ,"68,201.96  "
FireWrap® Grip Kit Black,03/01/2022,Sales Receipt,7436,,"FIREWRAP® GRIP KIT
Color: Black",1,27.95  ,27.95  ,"68,229.91  "
FireWrap® Grip Kit Black,03/02/2022,Sales Receipt,7450,,"FIREWRAP® GRIP KIT
Color: Black",1,27.95  ,27.95  ,"68,257.86  "
FireWrap® Grip Kit Black,03/03/2022,Sales Receipt,7458,,"FIREWRAP® GRIP KIT
Color: Black",1,27.95  ,27.95  ,"68,285.81  "
FireWrap® Grip Kit Black,03/03/2022,Sales Receipt,7460,,"FIREWRAP® GRIP KIT
Color: Black",1,27.95  ,27.95  ,"68,313.76  "
FireWrap® Grip Kit Black,03/03/2022,Sales Receipt,7462,,"FIREWRAP® GRIP KIT
Color: Black",1,27.95  ,27.95  ,"68,341.71  "
FireWrap® Grip Kit Black,03/04/2022,Sales Receipt,7465,,"FIREWRAP® GRIP KIT
Color: Black",1,27.95  ,27.95  ,"68,369.66  "
FireWrap® Grip Kit Black,03/04/2022,Sales Receipt,7470,,"FIREWRAP® GRIP KIT
Color: Black",1,27.95  ,27.95  ,"68,397.61  "
FireWrap® Grip Kit Black,03/05/2022,Sales Receipt,7475,,"FIREWRAP® GRIP KIT
Color: Black",1,27.95  ,27.95  ,"68,425.56  "
FireWrap® Grip Kit Black,03/05/2022,Sales Receipt,7479,,"FIREWRAP® GRIP KIT
Color: Black",1,27.95  ,27.95  ,"68,453.51  "
FireWrap® Grip Kit Black,03/06/2022,Sales Receipt,7483,,"FIREWRAP® GRIP KIT
Color: Black",1,27.95  ,27.95  ,"68,481.46  "
FireWrap® Grip Kit Black,03/07/2022,Sales Receipt,7497,,"FIREWRAP® GRIP KIT
Color: Black",1,27.95  ,27.95  ,"68,509.41  "
FireWrap® Grip Kit Black,03/07/2022,Sales Receipt,7488,,"FIREWRAP® GRIP KIT
Color: Black",1,27.95  ,27.95  ,"68,537.36  "
FireWrap® Grip Kit Black,03/07/2022,Sales Receipt,7487,,"FIREWRAP® GRIP KIT
Color: Black",2,27.95  ,55.90  ,"68,593.26  "
FireWrap® Grip Kit Black,03/07/2022,Sales Receipt,7492,,"FIREWRAP® GRIP KIT
Color: Black",1,27.95  ,27.95  ,"68,621.21  "
FireWrap® Grip Kit Black,03/09/2022,Sales Receipt,7507,,"FIREWRAP® GRIP KIT
Color: Black",1,27.95  ,27.95  ,"68,649.16  "
FireWrap® Grip Kit Black,03/11/2022,Sales Receipt,7520,,"FIREWRAP® GRIP KIT
Color: Black",1,27.95  ,27.95  ,"68,677.11  "
FireWrap® Grip Kit Black,03/11/2022,Sales Receipt,7515,,"FIREWRAP® GRIP KIT
Color: Black",1,27.95  ,27.95  ,"68,705.06  "
FireWrap® Grip Kit Black,03/11/2022,Sales Receipt,7512,,"FIREWRAP® GRIP KIT
Color: Black",1,27.95  ,27.95  ,"68,733.01  "
FireWrap® Grip Kit Black,03/12/2022,Sales Receipt,7523,,"FIREWRAP® GRIP KIT
Color: Black",1,27.95  ,27.95  ,"68,760.96  "
FireWrap® Grip Kit Black,03/12/2022,Sales Receipt,7524,,"FIREWRAP® GRIP KIT
Color: Black",1,27.95  ,27.95  ,"68,788.91  "
FireWrap® Grip Kit Black,03/14/2022,Sales Receipt,7535,,"FIREWRAP® GRIP KIT
Color: Black",1,27.95  ,27.95  ,"68,816.86  "
FireWrap® Grip Kit Black,03/14/2022,Sales Receipt,7541,,"FIREWRAP® GRIP KIT
Color: Black",2,27.95  ,55.90  ,"68,872.76  "
FireWrap® Grip Kit Black,03/14/2022,Sales Receipt,7540,,"FIREWRAP® GRIP KIT
Color: Black",1,27.95  ,27.95  ,"68,900.71  "
FireWrap® Grip Kit Black,03/14/2022,Sales Receipt,7537,,"FIREWRAP® GRIP KIT
Color: Black",1,27.95  ,27.95  ,"68,928.66  "
FireWrap® Grip Kit Black,03/17/2022,Sales Receipt,7552,,"FIREWRAP® GRIP KIT
Color: Black",1,27.95  ,27.95  ,"68,956.61  "
FireWrap® Grip Kit Black,03/18/2022,Sales Receipt,7565,,"FIREWRAP® GRIP KIT
Color: Black",2,27.95  ,55.90  ,"69,012.51  "
FireWrap® Grip Kit Black,03/18/2022,Sales Receipt,7562,,"FIREWRAP® GRIP KIT
Color: Black",3,27.95  ,83.85  ,"69,096.36  "
FireWrap® Grip Kit Black,03/18/2022,Sales Receipt,7560,,"FIREWRAP® GRIP KIT
Color: Black",1,27.95  ,27.95  ,"69,124.31  "
FireWrap® Grip Kit Black,03/20/2022,Sales Receipt,7582,,"FIREWRAP® GRIP KIT
Color: Black",1,27.95  ,27.95  ,"69,152.26  "
FireWrap® Grip Kit Black,03/20/2022,Sales Receipt,7583,,"FIREWRAP® GRIP KIT
Color: Black",1,27.95  ,27.95  ,"69,180.21  "
FireWrap® Grip Kit Black,03/20/2022,Sales Receipt,7581,,"FIREWRAP® GRIP KIT
Color: Black",1,27.95  ,27.95  ,"69,208.16  "
FireWrap® Grip Kit Black,03/21/2022,Sales Receipt,7592,,"FIREWRAP® GRIP KIT
Color: Black",1,27.95  ,27.95  ,"69,236.11  "
FireWrap® Grip Kit Black,03/21/2022,Sales Receipt,7589,,"FIREWRAP® GRIP KIT
Color: Black",2,27.95  ,55.90  ,"69,292.01  "
FireWrap® Grip Kit Black,03/22/2022,Sales Receipt,7597,,"FIREWRAP® GRIP KIT
Color: Black",1,27.95  ,27.95  ,"69,319.96  "
FireWrap® Grip Kit Black,03/23/2022,Sales Receipt,7607,,"FIREWRAP® GRIP KIT
Color: Black",1,27.95  ,27.95  ,"69,347.91  "
FireWrap® Grip Kit Black,03/24/2022,Sales Receipt,7615,,"FIREWRAP® GRIP KIT
Color: Black",1,27.95  ,27.95  ,"69,375.86  "
FireWrap® Grip Kit Black,03/26/2022,Sales Receipt,7629,,"FIREWRAP® GRIP KIT
Color: Black",2,27.95  ,55.90  ,"69,431.76  "
FireWrap® Grip Kit Black,03/27/2022,Sales Receipt,7637,,"FIREWRAP® GRIP KIT
Color: Black",1,27.95  ,27.95  ,"69,459.71  "
FireWrap® Grip Kit Black,03/29/2022,Sales Receipt,7652,,"FIREWRAP® GRIP KIT
Color: Black",1,27.95  ,27.95  ,"69,487.66  "
FireWrap® Grip Kit Black,03/30/2022,Sales Receipt,7657,,"FIREWRAP® GRIP KIT
Color: Black",2,27.95  ,55.90  ,"69,543.56  "
FireWrap® Grip Kit Black,04/01/2022,Sales Receipt,7670,,"FIREWRAP® GRIP KIT
Color: Black",1,27.95  ,27.95  ,"69,571.51  "
FireWrap® Grip Kit Black,04/02/2022,Sales Receipt,7678,,"FIREWRAP® GRIP KIT
Color: Black",5,27.95  ,139.75  ,"69,711.26  "
FireWrap® Grip Kit Black,04/02/2022,Sales Receipt,7675,,"FIREWRAP® GRIP KIT
Color: Black",1,27.95  ,27.95  ,"69,739.21  "
FireWrap® Grip Kit Black,04/03/2022,Sales Receipt,7682,,"FIREWRAP® GRIP KIT
Color: Black",1,27.95  ,27.95  ,"69,767.16  "
FireWrap® Grip Kit Black,04/03/2022,Sales Receipt,7687,,"FIREWRAP® GRIP KIT
Color: Black",1,27.95  ,27.95  ,"69,795.11  "
FireWrap® Grip Kit Black,04/04/2022,Sales Receipt,7688,,"FIREWRAP® GRIP KIT
Color: Black",5,27.95  ,139.75  ,"69,934.86  "
FireWrap® Grip Kit Black,04/06/2022,Sales Receipt,7698,,"FIREWRAP® GRIP KIT
Color: Black",2,27.95  ,55.90  ,"69,990.76  "
FireWrap® Grip Kit Black,04/08/2022,Sales Receipt,7718,,"FIREWRAP® GRIP KIT
Color: Black",2,27.95  ,55.90  ,"70,046.66  "
FireWrap® Grip Kit Black,04/08/2022,Sales Receipt,7720,,"FIREWRAP® GRIP KIT
Color: Black",1,27.95  ,27.95  ,"70,074.61  "
FireWrap® Grip Kit Black,04/09/2022,Sales Receipt,7722,,"FIREWRAP® GRIP KIT
Color: Black",1,27.95  ,27.95  ,"70,102.56  "
FireWrap® Grip Kit Black,04/11/2022,Sales Receipt,7735,,"FIREWRAP® GRIP KIT
Color: Black",2,27.95  ,55.90  ,"70,158.46  "
FireWrap® Grip Kit Black,04/11/2022,Sales Receipt,7736,,"FIREWRAP® GRIP KIT
Color: Black",2,27.95  ,55.90  ,"70,214.36  "
FireWrap® Grip Kit Black,04/11/2022,Sales Receipt,7733,,"FIREWRAP® GRIP KIT
Color: Black",20,27.95  ,559.00  ,"70,773.36  "
FireWrap® Grip Kit Black,04/13/2022,Sales Receipt,7746,,"FIREWRAP® GRIP KIT
Color: Black",2,27.95  ,55.90  ,"70,829.26  "
FireWrap® Grip Kit Black,04/13/2022,Sales Receipt,7744,,"FIREWRAP® GRIP KIT
Color: Black",4,27.95  ,111.80  ,"70,941.06  "
FireWrap® Grip Kit Black,04/13/2022,Sales Receipt,7751,,"FIREWRAP® GRIP KIT
Color: Black",1,27.95  ,27.95  ,"70,969.01  "
FireWrap® Grip Kit Black,04/20/2022,Sales Receipt,7789,,"FIREWRAP® GRIP KIT
Color: Black",1,27.95  ,27.95  ,"70,996.96  "
FireWrap® Grip Kit Black,04/26/2022,Sales Receipt,7815,,"FIREWRAP® GRIP KIT
Color: Black",1,27.95  ,27.95  ,"71,024.91  "
FireWrap® Grip Kit Black,04/27/2022,Sales Receipt,7825,,"FIREWRAP® GRIP KIT
Color: Black",3,27.95  ,83.85  ,"71,108.76  "
FireWrap® Grip Kit Black,04/28/2022,Sales Receipt,7830,,"FIREWRAP® GRIP KIT
Color: Black",1,22.95  ,22.95  ,"71,131.71  "
FireWrap® Grip Kit Black,04/28/2022,Sales Receipt,7829,,"FIREWRAP® GRIP KIT
Color: Black",1,22.95  ,22.95  ,"71,154.66  "
FireWrap® Grip Kit Black,04/29/2022,Sales Receipt,7844,,"FIREWRAP® GRIP KIT
Color: Black",2,22.95  ,45.90  ,"71,200.56  "
FireWrap® Grip Kit Black,04/29/2022,Sales Receipt,7851,,"FIREWRAP® GRIP KIT
Color: Black",1,22.95  ,22.95  ,"71,223.51  "
FireWrap® Grip Kit Black,04/29/2022,Sales Receipt,7846,,"FIREWRAP® GRIP KIT
Color: Black",1,22.95  ,22.95  ,"71,246.46  "
FireWrap® Grip Kit Black,04/29/2022,Sales Receipt,7849,,"FIREWRAP® GRIP KIT
Color: Black",1,22.95  ,22.95  ,"71,269.41  "
FireWrap® Grip Kit Black,04/30/2022,Sales Receipt,7857,,"FIREWRAP® GRIP KIT
Color: Black",1,22.95  ,22.95  ,"71,292.36  "
FireWrap® Grip Kit Black,05/01/2022,Sales Receipt,7867,,"FIREWRAP® GRIP KIT
Color: Black",3,22.95  ,68.85  ,"71,361.21  "
FireWrap® Grip Kit Black,05/03/2022,Sales Receipt,7893,,"FIREWRAP® GRIP KIT
Color: Black",2,22.95  ,45.90  ,"71,407.11  "
FireWrap® Grip Kit Black,05/03/2022,Sales Receipt,7888,,"FIREWRAP® GRIP KIT
Color: Black",1,22.95  ,22.95  ,"71,430.06  "
FireWrap® Grip Kit Black,05/03/2022,Sales Receipt,7895,,"FIREWRAP® GRIP KIT
Color: Black",2,22.95  ,45.90  ,"71,475.96  "
FireWrap® Grip Kit Black,05/05/2022,Sales Receipt,7906,,"FIREWRAP® GRIP KIT
Color: Black",1,22.95  ,22.95  ,"71,498.91  "
FireWrap® Grip Kit Black,05/06/2022,Sales Receipt,7913,,"FIREWRAP® GRIP KIT
Color: Black",1,22.95  ,22.95  ,"71,521.86  "
FireWrap® Grip Kit Black,05/07/2022,Sales Receipt,7916,,"FIREWRAP® GRIP KIT
Color: Black",10,22.95  ,229.50  ,"71,751.36  "
FireWrap® Grip Kit Black,05/08/2022,Sales Receipt,7925,,"FIREWRAP® GRIP KIT
Color: Black",2,27.95  ,55.90  ,"71,807.26  "
FireWrap® Grip Kit Black,05/08/2022,Sales Receipt,7922,,"FIREWRAP® GRIP KIT
Color: Black",1,27.95  ,27.95  ,"71,835.21  "
FireWrap® Grip Kit Black,05/09/2022,Sales Receipt,7926,,"FIREWRAP® GRIP KIT
Color: Black",1,27.95  ,27.95  ,"71,863.16  "
FireWrap® Grip Kit Black,05/10/2022,Sales Receipt,7927,,"FIREWRAP® GRIP KIT
Color: Black",3,27.95  ,83.85  ,"71,947.01  "
FireWrap® Grip Kit Black,05/12/2022,Sales Receipt,7938,,"FIREWRAP® GRIP KIT
Color: Black",1,27.95  ,27.95  ,"71,974.96  "
FireWrap® Grip Kit Black,05/12/2022,Sales Receipt,7941,,"FIREWRAP® GRIP KIT
Color: Black",1,27.95  ,27.95  ,"72,002.91  "
FireWrap® Grip Kit Black,05/13/2022,Sales Receipt,7944,,"FIREWRAP® GRIP KIT
Color: Black",1,27.95  ,27.95  ,"72,030.86  "
FireWrap® Grip Kit Black,05/13/2022,Sales Receipt,7946,,"FIREWRAP® GRIP KIT
Color: Black",5,27.95  ,139.75  ,"72,170.61  "
FireWrap® Grip Kit Black,05/14/2022,Sales Receipt,7953,,"FIREWRAP® GRIP KIT
Color: Black",2,27.95  ,55.90  ,"72,226.51  "
FireWrap® Grip Kit Black,05/15/2022,Sales Receipt,7956,,"FIREWRAP® GRIP KIT
Color: Black",16,27.95  ,447.20  ,"72,673.71  "
FireWrap® Grip Kit Black,05/17/2022,Sales Receipt,7964,,"FIREWRAP® GRIP KIT
Color: Black",1,27.95  ,27.95  ,"72,701.66  "
FireWrap® Grip Kit Black,05/18/2022,Sales Receipt,7975,,"FIREWRAP® GRIP KIT
Color: Black",2,27.95  ,55.90  ,"72,757.56  "
FireWrap® Grip Kit Black,05/18/2022,Sales Receipt,7977,,"FIREWRAP® GRIP KIT
Color: Black",1,27.95  ,27.95  ,"72,785.51  "
FireWrap® Grip Kit Black,05/21/2022,Sales Receipt,7988,,"FIREWRAP® GRIP KIT
Color: Black",2,27.95  ,55.90  ,"72,841.41  "
FireWrap® Grip Kit Black,05/21/2022,Sales Receipt,7987,,"FIREWRAP® GRIP KIT
Color: Black",1,27.95  ,27.95  ,"72,869.36  "
FireWrap® Grip Kit Black,05/22/2022,Sales Receipt,7989,,"FIREWRAP® GRIP KIT
Color: Black",1,27.95  ,27.95  ,"72,897.31  "
FireWrap® Grip Kit Black,05/27/2022,Sales Receipt,8007,,"FIREWRAP® GRIP KIT
Color: Black",1,27.95  ,27.95  ,"72,925.26  "
FireWrap® Grip Kit Black,05/29/2022,Sales Receipt,8021,,"FIREWRAP® GRIP KIT
Color: Black",1,27.95  ,27.95  ,"72,953.21  "
FireWrap® Grip Kit Black,06/01/2022,Sales Receipt,8036,,"FIREWRAP® GRIP KIT
Color: Black",1,27.95  ,27.95  ,"72,981.16  "
FireWrap® Grip Kit Black,06/01/2022,Sales Receipt,8034,,"FIREWRAP® GRIP KIT
Color: Black",1,27.95  ,27.95  ,"73,009.11  "
FireWrap® Grip Kit Black,06/02/2022,Sales Receipt,8041,,"FIREWRAP® GRIP KIT
Color: Black",2,27.95  ,55.90  ,"73,065.01  "
FireWrap® Grip Kit Black,06/02/2022,Sales Receipt,8044,,"FIREWRAP® GRIP KIT
Color: Black",2,27.95  ,55.90  ,"73,120.91  "
FireWrap® Grip Kit Black,06/07/2022,Sales Receipt,8063,,"FIREWRAP® GRIP KIT
Color: Black",1,27.95  ,27.95  ,"73,148.86  "
FireWrap® Grip Kit Black,06/08/2022,Sales Receipt,8081,,"FIREWRAP® GRIP KIT
Color: Black",1,27.95  ,27.95  ,"73,176.81  "
FireWrap® Grip Kit Black,06/09/2022,Sales Receipt,8087,,"FIREWRAP® GRIP KIT
Color: Black",1,27.95  ,27.95  ,"73,204.76  "
FireWrap® Grip Kit Black,06/09/2022,Sales Receipt,8083,,"FIREWRAP® GRIP KIT
Color: Black",1,27.95  ,27.95  ,"73,232.71  "
FireWrap® Grip Kit Black,06/10/2022,Sales Receipt,8091,,"FIREWRAP® GRIP KIT
Color: Black",2,27.95  ,55.90  ,"73,288.61  "
FireWrap® Grip Kit Black,06/10/2022,Sales Receipt,8097,,"FIREWRAP® GRIP KIT
Color: Black",1,27.95  ,27.95  ,"73,316.56  "
FireWrap® Grip Kit Black,06/10/2022,Sales Receipt,8102,,"FIREWRAP® GRIP KIT
Color: Black",1,27.95  ,27.95  ,"73,344.51  "
FireWrap® Grip Kit Black,06/11/2022,Sales Receipt,8103,,"FIREWRAP® GRIP KIT
Color: Black",1,27.95  ,27.95  ,"73,372.46  "
FireWrap® Grip Kit Black,06/11/2022,Sales Receipt,8108,,"FIREWRAP® GRIP KIT
Color: Black",1,27.95  ,27.95  ,"73,400.41  "
FireWrap® Grip Kit Black,06/13/2022,Sales Receipt,8121,,"FIREWRAP® GRIP KIT
Color: Black",1,27.95  ,27.95  ,"73,428.36  "
FireWrap® Grip Kit Black,06/13/2022,Sales Receipt,8116,,"FIREWRAP® GRIP KIT
Color: Black",1,27.95  ,27.95  ,"73,456.31  "
FireWrap® Grip Kit Black,06/14/2022,Sales Receipt,8123,,"FIREWRAP® GRIP KIT
Color: Black",1,27.95  ,27.95  ,"73,484.26  "
FireWrap® Grip Kit Black,06/15/2022,Sales Receipt,8129,,"FIREWRAP® GRIP KIT
Color: Black",1,27.95  ,27.95  ,"73,512.21  "
FireWrap® Grip Kit Black,06/16/2022,Sales Receipt,8136,,"FIREWRAP® GRIP KIT
Color: Black",2,27.95  ,55.90  ,"73,568.11  "
FireWrap® Grip Kit Black,06/16/2022,Sales Receipt,8137,,"FIREWRAP® GRIP KIT
Color: Black",2,27.95  ,55.90  ,"73,624.01  "
FireWrap® Grip Kit Black,06/17/2022,Sales Receipt,8144,,"FIREWRAP® GRIP KIT
Color: Black",1,27.95  ,27.95  ,"73,651.96  "
FireWrap® Grip Kit Black,06/17/2022,Sales Receipt,8141,,"FIREWRAP® GRIP KIT
Color: Black",1,27.95  ,27.95  ,"73,679.91  "
FireWrap® Grip Kit Black,06/17/2022,Sales Receipt,8146,,"FIREWRAP® GRIP KIT
Color: Black",3,27.95  ,83.85  ,"73,763.76  "
FireWrap® Grip Kit Black,06/18/2022,Sales Receipt,8152,,"FIREWRAP® GRIP KIT
Color: Black",1,27.95  ,27.95  ,"73,791.71  "
FireWrap® Grip Kit Black,06/20/2022,Sales Receipt,8158,,"FIREWRAP® GRIP KIT
Color: Black",1,27.95  ,27.95  ,"73,819.66  "
FireWrap® Grip Kit Black,06/24/2022,Sales Receipt,8174,,"FIREWRAP® GRIP KIT
Color: Black",1,27.95  ,27.95  ,"73,847.61  "
FireWrap® Grip Kit Black,06/28/2022,Sales Receipt,8201,,"FIREWRAP® GRIP KIT
Color: Black",1,27.95  ,27.95  ,"73,875.56  "
FireWrap® Grip Kit Black,06/28/2022,Sales Receipt,8202,,"FIREWRAP® GRIP KIT
Color: Black",1,27.95  ,27.95  ,"73,903.51  "
FireWrap® Grip Kit Black,06/28/2022,Sales Receipt,8200,,"FIREWRAP® GRIP KIT
Color: Black",1,27.95  ,27.95  ,"73,931.46  "
FireWrap® Grip Kit Black,06/29/2022,Sales Receipt,8204,,"FIREWRAP® GRIP KIT
Color: Black",1,27.95  ,27.95  ,"73,959.41  "
FireWrap® Grip Kit Black,06/29/2022,Sales Receipt,8205,,"FIREWRAP® GRIP KIT
Color: Black",1,27.95  ,27.95  ,"73,987.36  "
FireWrap® Grip Kit Black,07/01/2022,Sales Receipt,8225,,"FIREWRAP® GRIP KIT
Color: Black",2,27.95  ,55.90  ,"74,043.26  "
FireWrap® Grip Kit Black,07/01/2022,Sales Receipt,8220,,"FIREWRAP® GRIP KIT
Color: Black",1,27.95  ,27.95  ,"74,071.21  "
FireWrap® Grip Kit Black,07/02/2022,Sales Receipt,8231,,"FIREWRAP® GRIP KIT
Color: Black",1,27.95  ,27.95  ,"74,099.16  "
FireWrap® Grip Kit Black,07/04/2022,Sales Receipt,8243,,"FIREWRAP® GRIP KIT
Color: Black",1,27.95  ,27.95  ,"74,127.11  "
FireWrap® Grip Kit Black,07/04/2022,Sales Receipt,8241,,"FIREWRAP® GRIP KIT
Color: Black",1,27.95  ,27.95  ,"74,155.06  "
FireWrap® Grip Kit Black,07/07/2022,Sales Receipt,8263,,"FIREWRAP® GRIP KIT
Color: Black",2,27.95  ,55.90  ,"74,210.96  "
FireWrap® Grip Kit Black,07/07/2022,Sales Receipt,8253,,"FIREWRAP® GRIP KIT
Color: Black",1,27.95  ,27.95  ,"74,238.91  "
FireWrap® Grip Kit Black,07/07/2022,Sales Receipt,8261,,"FIREWRAP® GRIP KIT
Color: Black",1,27.95  ,27.95  ,"74,266.86  "
FireWrap® Grip Kit Black,07/08/2022,Sales Receipt,8269,,"FIREWRAP® GRIP KIT
Color: Black",3,27.95  ,83.85  ,"74,350.71  "
FireWrap® Grip Kit Black,07/08/2022,Sales Receipt,8267,,"FIREWRAP® GRIP KIT
Color: Black",1,27.95  ,27.95  ,"74,378.66  "
FireWrap® Grip Kit Black,07/08/2022,Sales Receipt,8271,,"FIREWRAP® GRIP KIT
Color: Black",1,27.95  ,27.95  ,"74,406.61  "
FireWrap® Grip Kit Black,07/10/2022,Sales Receipt,8279,,"FIREWRAP® GRIP KIT
Color: Black",1,27.95  ,27.95  ,"74,434.56  "
FireWrap® Grip Kit Black,07/10/2022,Sales Receipt,8277,,"FIREWRAP® GRIP KIT
Color: Black",1,27.95  ,27.95  ,"74,462.51  "
FireWrap® Grip Kit Black,07/14/2022,Sales Receipt,8303,,"FIREWRAP® GRIP KIT
Color: Black",1,27.95  ,27.95  ,"74,490.46  "
FireWrap® Grip Kit Black,07/14/2022,Sales Receipt,8301,,"FIREWRAP® GRIP KIT
Color: Black",1,27.95  ,27.95  ,"74,518.41  "
FireWrap® Grip Kit Black,07/14/2022,Sales Receipt,8297,,"FIREWRAP® GRIP KIT
Color: Black",1,27.95  ,27.95  ,"74,546.36  "
FireWrap® Grip Kit Black,07/14/2022,Sales Receipt,8300,,"FIREWRAP® GRIP KIT
Color: Black",1,27.95  ,27.95  ,"74,574.31  "
FireWrap® Grip Kit Black,07/15/2022,Sales Receipt,8310,,"FIREWRAP® GRIP KIT
Color: Black",1,27.95  ,27.95  ,"74,602.26  "
FireWrap® Grip Kit Black,07/15/2022,Sales Receipt,8307,,"FIREWRAP® GRIP KIT
Color: Black",1,27.95  ,27.95  ,"74,630.21  "
FireWrap® Grip Kit Black,07/18/2022,Sales Receipt,8321,,"FIREWRAP® GRIP KIT
Color: Black",1,27.95  ,27.95  ,"74,658.16  "
FireWrap® Grip Kit Black,07/19/2022,Sales Receipt,8332,,"FIREWRAP® GRIP KIT
Color: Black",1,27.95  ,27.95  ,"74,686.11  "
FireWrap® Grip Kit Black,07/20/2022,Sales Receipt,8335,,"FIREWRAP® GRIP KIT
Color: Black",1,27.95  ,27.95  ,"74,714.06  "
FireWrap® Grip Kit Black,07/21/2022,Sales Receipt,8338,,"FIREWRAP® GRIP KIT
Color: Black",1,27.95  ,27.95  ,"74,742.01  "
FireWrap® Grip Kit Black,07/22/2022,Sales Receipt,8342,,"FIREWRAP® GRIP KIT
Color: Black",1,27.95  ,27.95  ,"74,769.96  "
FireWrap® Grip Kit Black,07/23/2022,Sales Receipt,8346,,"FIREWRAP® GRIP KIT
Color: Black",1,27.95  ,27.95  ,"74,797.91  "
FireWrap® Grip Kit Black,07/25/2022,Sales Receipt,8363,,"FIREWRAP® GRIP KIT
Color: Black",1,27.95  ,27.95  ,"74,825.86  "
FireWrap® Grip Kit Black,07/26/2022,Sales Receipt,8367,,"FIREWRAP® GRIP KIT
Color: Black",1,27.95  ,27.95  ,"74,853.81  "
FireWrap® Grip Kit Black,07/26/2022,Sales Receipt,8366,,"FIREWRAP® GRIP KIT
Color: Black",1,27.95  ,27.95  ,"74,881.76  "
FireWrap® Grip Kit Black,07/27/2022,Sales Receipt,8370,,"FIREWRAP® GRIP KIT
Color: Black",3,27.95  ,83.85  ,"74,965.61  "
FireWrap® Grip Kit Black,07/27/2022,Sales Receipt,8374,,"FIREWRAP® GRIP KIT
Color: Black",1,27.95  ,27.95  ,"74,993.56  "
FireWrap® Grip Kit Black,07/28/2022,Sales Receipt,8382,,"FIREWRAP® GRIP KIT
Color: Black",1,27.95  ,27.95  ,"75,021.51  "
FireWrap® Grip Kit Black,07/28/2022,Sales Receipt,8381,,"FIREWRAP® GRIP KIT
Color: Black",2,27.95  ,55.90  ,"75,077.41  "
FireWrap® Grip Kit Black,07/29/2022,Sales Receipt,8388,,"FIREWRAP® GRIP KIT
Color: Black",1,27.95  ,27.95  ,"75,105.36  "
FireWrap® Grip Kit Black,07/29/2022,Sales Receipt,8392,,"FIREWRAP® GRIP KIT
Color: Black",1,27.95  ,27.95  ,"75,133.31  "
FireWrap® Grip Kit Black,07/30/2022,Sales Receipt,8402,,"FIREWRAP® GRIP KIT
Color: Black",1,27.95  ,27.95  ,"75,161.26  "
FireWrap® Grip Kit Black,07/30/2022,Sales Receipt,8398,,"FIREWRAP® GRIP KIT
Color: Black",1,27.95  ,27.95  ,"75,189.21  "
FireWrap® Grip Kit Black,07/30/2022,Sales Receipt,8404,,"FIREWRAP® GRIP KIT
Color: Black",1,27.95  ,27.95  ,"75,217.16  "
FireWrap® Grip Kit Black,07/30/2022,Sales Receipt,8397,,"FIREWRAP® GRIP KIT
Color: Black",3,27.95  ,83.85  ,"75,301.01  "
FireWrap® Grip Kit Black,08/01/2022,Sales Receipt,8413,,"FIREWRAP® GRIP KIT
Color: Black",1,27.95  ,27.95  ,"75,328.96  "
FireWrap® Grip Kit Black,08/03/2022,Sales Receipt,8422,,"FIREWRAP® GRIP KIT
Color: Black",1,27.95  ,27.95  ,"75,356.91  "
FireWrap® Grip Kit Black,08/03/2022,Sales Receipt,8421,,"FIREWRAP® GRIP KIT
Color: Black",1,27.95  ,27.95  ,"75,384.86  "
FireWrap® Grip Kit Black,08/04/2022,Sales Receipt,8431,,"FIREWRAP® GRIP KIT
Color: Black",1,27.95  ,27.95  ,"75,412.81  "
FireWrap® Grip Kit Black,08/04/2022,Sales Receipt,8427,,"FIREWRAP® GRIP KIT
Color: Black",1,27.95  ,27.95  ,"75,440.76  "
FireWrap® Grip Kit Black,08/05/2022,Sales Receipt,8435,,"FIREWRAP® GRIP KIT
Color: Black",1,27.95  ,27.95  ,"75,468.71  "
FireWrap® Grip Kit Black,08/08/2022,Sales Receipt,8449,,"FIREWRAP® GRIP KIT
Color: Black",1,27.95  ,27.95  ,"75,496.66  "
FireWrap® Grip Kit Black,08/09/2022,Sales Receipt,8453,,"FIREWRAP® GRIP KIT
Color: Black",1,27.95  ,27.95  ,"75,524.61  "
FireWrap® Grip Kit Black,08/09/2022,Sales Receipt,8456,,"FIREWRAP® GRIP KIT
Color: Black",1,27.95  ,27.95  ,"75,552.56  "
FireWrap® Grip Kit Black,08/09/2022,Sales Receipt,8451,,"FIREWRAP® GRIP KIT
Color: Black",2,27.95  ,55.90  ,"75,608.46  "
FireWrap® Grip Kit Black,08/10/2022,Sales Receipt,8459,,"FIREWRAP® GRIP KIT
Color: Black",2,27.95  ,55.90  ,"75,664.36  "
FireWrap® Grip Kit Black,08/10/2022,Sales Receipt,8458,,"FIREWRAP® GRIP KIT
Color: Black",1,27.95  ,27.95  ,"75,692.31  "
FireWrap® Grip Kit Black,08/11/2022,Sales Receipt,8470,,"FIREWRAP® GRIP KIT
Color: Black",2,27.95  ,55.90  ,"75,748.21  "
FireWrap® Grip Kit Black,08/12/2022,Sales Receipt,8473,,"FIREWRAP® GRIP KIT
Color: Black",1,27.95  ,27.95  ,"75,776.16  "
FireWrap® Grip Kit Black,08/13/2022,Sales Receipt,8480,,"FIREWRAP® GRIP KIT
Color: Black",1,27.95  ,27.95  ,"75,804.11  "
FireWrap® Grip Kit Black,08/15/2022,Sales Receipt,8488,,"FIREWRAP® GRIP KIT
Color: Black",1,27.95  ,27.95  ,"75,832.06  "
FireWrap® Grip Kit Black,08/16/2022,Sales Receipt,8497,,"FIREWRAP® GRIP KIT
Color: Black",1,27.95  ,27.95  ,"75,860.01  "
FireWrap® Grip Kit Black,08/16/2022,Sales Receipt,8496,,"FIREWRAP® GRIP KIT
Color: Black",1,27.95  ,27.95  ,"75,887.96  "
FireWrap® Grip Kit Black,08/17/2022,Sales Receipt,8498,,"FIREWRAP® GRIP KIT
Color: Black",1,27.95  ,27.95  ,"75,915.91  "
FireWrap® Grip Kit Black,08/17/2022,Sales Receipt,8501,,"FIREWRAP® GRIP KIT
Color: Black",1,27.95  ,27.95  ,"75,943.86  "
FireWrap® Grip Kit Black,08/19/2022,Sales Receipt,8522,,"FIREWRAP® GRIP KIT
Color: Black",1,27.95  ,27.95  ,"75,971.81  "
FireWrap® Grip Kit Black,08/20/2022,Sales Receipt,8525,,"FIREWRAP® GRIP KIT
Color: Black",1,27.95  ,27.95  ,"75,999.76  "
FireWrap® Grip Kit Black,08/21/2022,Sales Receipt,8532,,"FIREWRAP® GRIP KIT
Color: Black",1,27.95  ,27.95  ,"76,027.71  "
FireWrap® Grip Kit Black,08/21/2022,Sales Receipt,8529,,"FIREWRAP® GRIP KIT
Color: Black",1,27.95  ,27.95  ,"76,055.66  "
FireWrap® Grip Kit Black,08/22/2022,Sales Receipt,8537,,"FIREWRAP® GRIP KIT
Color: Black",1,27.95  ,27.95  ,"76,083.61  "
FireWrap® Grip Kit Black,08/22/2022,Sales Receipt,8538,,"FIREWRAP® GRIP KIT
Color: Black",1,27.95  ,27.95  ,"76,111.56  "
FireWrap® Grip Kit Black,08/23/2022,Sales Receipt,8540,,"FIREWRAP® GRIP KIT
Color: Black",1,27.95  ,27.95  ,"76,139.51  "
FireWrap® Grip Kit Black,08/24/2022,Sales Receipt,8548,,"FIREWRAP® GRIP KIT
Color: Black",8,27.95  ,223.60  ,"76,363.11  "
FireWrap® Grip Kit Black,08/27/2022,Sales Receipt,8568,,"FIREWRAP® GRIP KIT
Color: Black",1,27.95  ,27.95  ,"76,391.06  "
FireWrap® Grip Kit Black,08/27/2022,Sales Receipt,8573,,"FIREWRAP® GRIP KIT
Color: Black",1,27.95  ,27.95  ,"76,419.01  "
FireWrap® Grip Kit Black,08/27/2022,Sales Receipt,8567,,"FIREWRAP® GRIP KIT
Color: Black",1,27.95  ,27.95  ,"76,446.96  "
FireWrap® Grip Kit Black,08/28/2022,Sales Receipt,8583,,"FIREWRAP® GRIP KIT
Color: Black",1,27.95  ,27.95  ,"76,474.91  "
FireWrap® Grip Kit Black,08/31/2022,Sales Receipt,8598,,"FIREWRAP® GRIP KIT
Color: Black",3,27.95  ,83.85  ,"76,558.76  "
FireWrap® Grip Kit Black,09/01/2022,Sales Receipt,8602,,"FIREWRAP® GRIP KIT
Color: Black",1,27.95  ,27.95  ,"76,586.71  "
FireWrap® Grip Kit Black,09/03/2022,Sales Receipt,8615,,"FIREWRAP® GRIP KIT
Color: Black",1,27.95  ,27.95  ,"76,614.66  "
FireWrap® Grip Kit Black,09/04/2022,Sales Receipt,8620,,"FIREWRAP® GRIP KIT
Color: Black",2,27.95  ,55.90  ,"76,670.56  "
FireWrap® Grip Kit Black,09/05/2022,Sales Receipt,8622,,"FIREWRAP® GRIP KIT
Color: Black",1,27.95  ,27.95  ,"76,698.51  "
FireWrap® Grip Kit Black,09/06/2022,Sales Receipt,8633,,"FIREWRAP® GRIP KIT
Color: Black",1,27.95  ,27.95  ,"76,726.46  "
FireWrap® Grip Kit Black,09/07/2022,Sales Receipt,8647,,"FIREWRAP® GRIP KIT
Color: Black",1,27.95  ,27.95  ,"76,754.41  "
FireWrap® Grip Kit Black,09/10/2022,Sales Receipt,8657,,"FIREWRAP® GRIP KIT
Color: Black",6,27.95  ,167.70  ,"76,922.11  "
FireWrap® Grip Kit Black,09/10/2022,Sales Receipt,8658,,"FIREWRAP® GRIP KIT
Color: Black",1,27.95  ,27.95  ,"76,950.06  "
FireWrap® Grip Kit Black,09/12/2022,Sales Receipt,8668,,"FIREWRAP® GRIP KIT
Color: Black",1,27.95  ,27.95  ,"76,978.01  "
FireWrap® Grip Kit Black,09/12/2022,Sales Receipt,8672,,"FIREWRAP® GRIP KIT
Color: Black",1,27.95  ,27.95  ,"77,005.96  "
FireWrap® Grip Kit Black,09/13/2022,Sales Receipt,8679,,"FIREWRAP® GRIP KIT
Color: Black",1,27.95  ,27.95  ,"77,033.91  "
FireWrap® Grip Kit Black,09/13/2022,Sales Receipt,8677,,"FIREWRAP® GRIP KIT
Color: Black",1,27.95  ,27.95  ,"77,061.86  "
FireWrap® Grip Kit Black,09/13/2022,Sales Receipt,8674,,"FIREWRAP® GRIP KIT
Color: Black",1,27.95  ,27.95  ,"77,089.81  "
FireWrap® Grip Kit Black,09/13/2022,Sales Receipt,8675,,"FIREWRAP® GRIP KIT
Color: Black",1,27.95  ,27.95  ,"77,117.76  "
FireWrap® Grip Kit Black,09/14/2022,Sales Receipt,8686,,"FIREWRAP® GRIP KIT
Color: Black",1,27.95  ,27.95  ,"77,145.71  "
FireWrap® Grip Kit Black,09/14/2022,Sales Receipt,8688,,"FIREWRAP® GRIP KIT
Color: Black",1,27.95  ,27.95  ,"77,173.66  "
FireWrap® Grip Kit Black,09/17/2022,Sales Receipt,8701,,"FIREWRAP® GRIP KIT
Color: Black",1,27.95  ,27.95  ,"77,201.61  "
FireWrap® Grip Kit Black,09/17/2022,Sales Receipt,8702,,"FIREWRAP® GRIP KIT
Color: Black",1,27.95  ,27.95  ,"77,229.56  "
FireWrap® Grip Kit Black,09/18/2022,Sales Receipt,8707,,"FIREWRAP® GRIP KIT
Color: Black",1,27.95  ,27.95  ,"77,257.51  "
FireWrap® Grip Kit Black,09/19/2022,Sales Receipt,8711,,"FIREWRAP® GRIP KIT
Color: Black",1,27.95  ,27.95  ,"77,285.46  "
FireWrap® Grip Kit Black,09/19/2022,Sales Receipt,8717,,"FIREWRAP® GRIP KIT
Color: Black",1,27.95  ,27.95  ,"77,313.41  "
FireWrap® Grip Kit Black,09/20/2022,Sales Receipt,8723,,"FIREWRAP® GRIP KIT
Color: Black",1,27.95  ,27.95  ,"77,341.36  "
FireWrap® Grip Kit Black,09/22/2022,Sales Receipt,8733,,"FIREWRAP® GRIP KIT
Color: Black",5,27.95  ,139.75  ,"77,481.11  "
FireWrap® Grip Kit Black,09/23/2022,Sales Receipt,8742,,"FIREWRAP® GRIP KIT
Color: Black",1,27.95  ,27.95  ,"77,509.06  "
FireWrap® Grip Kit Black,09/26/2022,Sales Receipt,8754,,"FIREWRAP® GRIP KIT
Color: Black",1,27.95  ,27.95  ,"77,537.01  "
FireWrap® Grip Kit Black,09/27/2022,Sales Receipt,8759,,"FIREWRAP® GRIP KIT
Color: Black",1,27.95  ,27.95  ,"77,564.96  "
FireWrap® Grip Kit Black,09/28/2022,Sales Receipt,8779,,"FIREWRAP® GRIP KIT
Color: Black",1,27.95  ,27.95  ,"77,592.91  "
FireWrap® Grip Kit Black,09/28/2022,Sales Receipt,8778,,"FIREWRAP® GRIP KIT
Color: Black",1,27.95  ,27.95  ,"77,620.86  "
FireWrap® Grip Kit Black,09/29/2022,Sales Receipt,8790,,"FIREWRAP® GRIP KIT
Color: Black",1,27.95  ,27.95  ,"77,648.81  "
FireWrap® Grip Kit Black,09/30/2022,Sales Receipt,8814,,"FIREWRAP® GRIP KIT
Color: Black",5,27.95  ,139.75  ,"77,788.56  "
FireWrap® Grip Kit Black,10/03/2022,Sales Receipt,8831,,"FIREWRAP® GRIP KIT
Color: Black",6,27.95  ,167.70  ,"77,956.26  "
FireWrap® Grip Kit Black,10/04/2022,Sales Receipt,8838,,"FIREWRAP® GRIP KIT
Color: Black",2,27.95  ,55.90  ,"78,012.16  "
FireWrap® Grip Kit Black,10/04/2022,Sales Receipt,8842,,"FIREWRAP® GRIP KIT
Color: Black",1,27.95  ,27.95  ,"78,040.11  "
FireWrap® Grip Kit Black,10/04/2022,Sales Receipt,8840,,"FIREWRAP® GRIP KIT
Color: Black",1,27.95  ,27.95  ,"78,068.06  "
FireWrap® Grip Kit Black,10/05/2022,Sales Receipt,8844,,"FIREWRAP® GRIP KIT
Color: Black",1,27.95  ,27.95  ,"78,096.01  "
FireWrap® Grip Kit Black,10/07/2022,Sales Receipt,8855,,"FIREWRAP® GRIP KIT
Color: Black",1,27.95  ,27.95  ,"78,123.96  "
FireWrap® Grip Kit Black,10/07/2022,Sales Receipt,8860,,"FIREWRAP® GRIP KIT
Color: Black",1,27.95  ,27.95  ,"78,151.91  "
FireWrap® Grip Kit Black,10/08/2022,Sales Receipt,8868,,"FIREWRAP® GRIP KIT
Color: Black",1,27.95  ,27.95  ,"78,179.86  "
FireWrap® Grip Kit Black,10/09/2022,Sales Receipt,8870,,"FIREWRAP® GRIP KIT
Color: Black",1,27.95  ,27.95  ,"78,207.81  "
FireWrap® Grip Kit Black,10/09/2022,Sales Receipt,8871,,"FIREWRAP® GRIP KIT
Color: Black",1,27.95  ,27.95  ,"78,235.76  "
FireWrap® Grip Kit Black,10/10/2022,Sales Receipt,8878,,"FIREWRAP® GRIP KIT
Color: Black",1,27.95  ,27.95  ,"78,263.71  "
FireWrap® Grip Kit Black,10/10/2022,Sales Receipt,8877,,"FIREWRAP® GRIP KIT
Color: Black",2,27.95  ,55.90  ,"78,319.61  "
FireWrap® Grip Kit Black,10/12/2022,Sales Receipt,8900,,"FIREWRAP® GRIP KIT
Color: Black",1,27.95  ,27.95  ,"78,347.56  "
FireWrap® Grip Kit Black,10/12/2022,Sales Receipt,8899,,"FIREWRAP® GRIP KIT
Color: Black",1,27.95  ,27.95  ,"78,375.51  "
FireWrap® Grip Kit Black,10/12/2022,Sales Receipt,8902,,"FIREWRAP® GRIP KIT
Color: Black",1,27.95  ,27.95  ,"78,403.46  "
FireWrap® Grip Kit Black,10/16/2022,Sales Receipt,8922,,"FIREWRAP® GRIP KIT
Color: Black",5,27.95  ,139.75  ,"78,543.21  "
FireWrap® Grip Kit Black,10/18/2022,Sales Receipt,8929,,"FIREWRAP® GRIP KIT
Color: Black",1,27.95  ,27.95  ,"78,571.16  "
FireWrap® Grip Kit Black,10/20/2022,Sales Receipt,8948,,"FIREWRAP® GRIP KIT
Color: Black",1,27.95  ,27.95  ,"78,599.11  "
FireWrap® Grip Kit Black,10/20/2022,Sales Receipt,8946,,"FIREWRAP® GRIP KIT
Color: Black",2,27.95  ,55.90  ,"78,655.01  "
FireWrap® Grip Kit Black,10/21/2022,Sales Receipt,8956,,"FIREWRAP® GRIP KIT
Color: Black",1,27.95  ,27.95  ,"78,682.96  "
FireWrap® Grip Kit Black,10/21/2022,Sales Receipt,8959,,"FIREWRAP® GRIP KIT
Color: Black",4,27.95  ,111.80  ,"78,794.76  "
FireWrap® Grip Kit Black,10/22/2022,Sales Receipt,8963,,"FIREWRAP® GRIP KIT
Color: Black",1,27.95  ,27.95  ,"78,822.71  "
FireWrap® Grip Kit Black,10/22/2022,Sales Receipt,8965,,"FIREWRAP® GRIP KIT
Color: Black",1,27.95  ,27.95  ,"78,850.66  "
FireWrap® Grip Kit Black,10/23/2022,Sales Receipt,8967,,"FIREWRAP® GRIP KIT
Color: Black",1,27.95  ,27.95  ,"78,878.61  "
FireWrap® Grip Kit Black,10/27/2022,Sales Receipt,8985,,"FIREWRAP® GRIP KIT
Color: Black",2,27.95  ,55.90  ,"78,934.51  "
FireWrap® Grip Kit Black,10/31/2022,Sales Receipt,9009,,"FIREWRAP® GRIP KIT
Color: Black",1,27.95  ,27.95  ,"78,962.46  "
FireWrap® Grip Kit Black,11/03/2022,Invoice,M-110322-001,,FireWrap® Grip Kit Black,2,21.75  ,43.50  ,"79,005.96  "
FireWrap® Grip Kit Black,11/04/2022,Sales Receipt,9025,,"FIREWRAP® GRIP KIT
Color: Black",1,27.95  ,27.95  ,"79,033.91  "
FireWrap® Grip Kit Black,11/04/2022,Sales Receipt,9026,,"FIREWRAP® GRIP KIT
Color: Black",1,27.95  ,27.95  ,"79,061.86  "
FireWrap® Grip Kit Black,11/05/2022,Sales Receipt,M-114-9317428-8675419,,FireWrap® Grip Kit - Black,1,28.95  ,28.95  ,"79,090.81  "
FireWrap® Grip Kit Black,11/06/2022,Sales Receipt,9033,,"FIREWRAP® GRIP KIT
Color: Black",1,27.95  ,27.95  ,"79,118.76  "
FireWrap® Grip Kit Black,11/07/2022,Sales Receipt,9035,,"FIREWRAP® GRIP KIT
Color: Black",1,27.95  ,27.95  ,"79,146.71  "
FireWrap® Grip Kit Black,11/08/2022,Sales Receipt,9046,,"FIREWRAP® GRIP KIT
Color: Black",1,27.95  ,27.95  ,"79,174.66  "
FireWrap® Grip Kit Black,11/08/2022,Sales Receipt,9042,,"FIREWRAP® GRIP KIT
Color: Black",2,27.95  ,55.90  ,"79,230.56  "
FireWrap® Grip Kit Black,11/08/2022,Sales Receipt,9045,,"FIREWRAP® GRIP KIT
Color: Black",1,27.95  ,27.95  ,"79,258.51  "
FireWrap® Grip Kit Black,11/08/2022,Sales Receipt,9044,,"FIREWRAP® GRIP KIT
Color: Black",6,27.95  ,167.70  ,"79,426.21  "
FireWrap® Grip Kit Black,11/09/2022,Sales Receipt,9049,,"FIREWRAP® GRIP KIT
Color: Black",1,27.95  ,27.95  ,"79,454.16  "
FireWrap® Grip Kit Black,11/09/2022,Sales Receipt,9054,,"FIREWRAP® GRIP KIT
Color: Black",1,27.95  ,27.95  ,"79,482.11  "
FireWrap® Grip Kit Black,11/10/2022,Sales Receipt,9058,,"FIREWRAP® GRIP KIT
Color: Black",1,27.95  ,27.95  ,"79,510.06  "
FireWrap® Grip Kit Black,11/10/2022,Sales Receipt,9059,,"FIREWRAP® GRIP KIT
Color: Black",2,27.95  ,55.90  ,"79,565.96  "
FireWrap® Grip Kit Black,11/12/2022,Sales Receipt,9066,,"FIREWRAP® GRIP KIT
Color: Black",1,27.95  ,27.95  ,"79,593.91  "
FireWrap® Grip Kit Black,11/12/2022,Sales Receipt,M-111-0670909-9497009,,FireWrap® Grip Kit - Black,1,28.95  ,28.95  ,"79,622.86  "
FireWrap® Grip Kit Black,11/13/2022,Sales Receipt,9069,,"FIREWRAP® GRIP KIT
Color: Black",1,27.95  ,27.95  ,"79,650.81  "
FireWrap® Grip Kit Black,11/13/2022,Sales Receipt,9073,,"FIREWRAP® GRIP KIT
Color: Black",3,27.95  ,83.85  ,"79,734.66  "
FireWrap® Grip Kit Black,11/14/2022,Sales Receipt,9081,,"FIREWRAP® GRIP KIT
Color: Black",1,27.95  ,27.95  ,"79,762.61  "
FireWrap® Grip Kit Black,11/14/2022,Sales Receipt,M-111-5001179-1285826,,FireWrap® Grip Kit - Black,1,28.95  ,28.95  ,"79,791.56  "
FireWrap® Grip Kit Black,11/15/2022,Sales Receipt,M-114-5918349-9998606,,FireWrap® Grip Kit - Black,2,28.95  ,57.90  ,"79,849.46  "
FireWrap® Grip Kit Black,11/15/2022,Sales Receipt,9087,,"FIREWRAP® GRIP KIT
Color: Black",6,27.95  ,167.70  ,"80,017.16  "
FireWrap® Grip Kit Black,11/16/2022,Sales Receipt,9101,,"FIREWRAP® GRIP KIT
Color: Black",1,27.95  ,27.95  ,"80,045.11  "
FireWrap® Grip Kit Black,11/17/2022,Sales Receipt,M-113-0187657-2573039,,FireWrap® Grip Kit - Black,1,28.95  ,28.95  ,"80,074.06  "
FireWrap® Grip Kit Black,11/17/2022,Sales Receipt,M-112-2924860-5672248,,FireWrap® Grip Kit - Black,1,28.95  ,28.95  ,"80,103.01  "
FireWrap® Grip Kit Black,11/18/2022,Sales Receipt,9116,,"FIREWRAP® GRIP KIT
Color: Black",1,27.95  ,27.95  ,"80,130.96  "
FireWrap® Grip Kit Black,11/18/2022,Sales Receipt,9113,,"FIREWRAP® GRIP KIT
Color: Black",6,27.95  ,167.70  ,"80,298.66  "
FireWrap® Grip Kit Black,11/18/2022,Sales Receipt,9110,,"FIREWRAP® GRIP KIT
Color: Black",1,27.95  ,27.95  ,"80,326.61  "
FireWrap® Grip Kit Black,11/19/2022,Sales Receipt,9120,,"FIREWRAP® GRIP KIT
Color: Black",2,27.95  ,55.90  ,"80,382.51  "
FireWrap® Grip Kit Black,11/20/2022,Sales Receipt,M-113-8906886-6837021,,FireWrap® Grip Kit - Black,1,28.95  ,28.95  ,"80,411.46  "
FireWrap® Grip Kit Black,11/21/2022,Sales Receipt,9132,,"FIREWRAP® GRIP KIT
Color: Black",1,27.95  ,27.95  ,"80,439.41  "
FireWrap® Grip Kit Black,11/22/2022,Sales Receipt,9137,,"FIREWRAP® GRIP KIT
Color: Black",5,27.95  ,139.75  ,"80,579.16  "
FireWrap® Grip Kit Black,11/22/2022,Sales Receipt,M-111-2776630-4377839,,FireWrap® Grip Kit - Black,2,28.95  ,57.90  ,"80,637.06  "
FireWrap® Grip Kit Black,11/22/2022,Sales Receipt,9140,,"FIREWRAP® GRIP KIT
Color: Black",2,27.95  ,55.90  ,"80,692.96  "
FireWrap® Grip Kit Black,11/23/2022,Sales Receipt,M-112-4651128-0666601,,FireWrap® Grip Kit - Black,1,28.95  ,28.95  ,"80,721.91  "
FireWrap® Grip Kit Black,11/23/2022,Sales Receipt,9143,,"FIREWRAP® GRIP KIT
Color: Black",1,27.95  ,27.95  ,"80,749.86  "
FireWrap® Grip Kit Black,11/24/2022,Sales Receipt,9156,,"FIREWRAP® GRIP KIT
Color: Black",1,27.95  ,27.95  ,"80,777.81  "
FireWrap® Grip Kit Black,11/24/2022,Sales Receipt,9153,,"FIREWRAP® GRIP KIT
Color: Black",3,27.95  ,83.85  ,"80,861.66  "
FireWrap® Grip Kit Black,11/25/2022,Sales Receipt,9168,,"FIREWRAP® GRIP KIT
Color: Black",5,27.95  ,139.75  ,"81,001.41  "
FireWrap® Grip Kit Black,11/26/2022,Sales Receipt,M-112-8065178-1298645,,FireWrap® Grip Kit - Black,2,28.95  ,57.90  ,"81,059.31  "
FireWrap® Grip Kit Black,11/26/2022,Sales Receipt,M-112-2798722-0990621,,FireWrap® Grip Kit - Black,1,28.95  ,28.95  ,"81,088.26  "
FireWrap® Grip Kit Black,11/26/2022,Sales Receipt,M-113-3631426-0637811,,FireWrap® Grip Kit - Black,1,28.95  ,28.95  ,"81,117.21  "
FireWrap® Grip Kit Black,11/28/2022,Sales Receipt,9202,,"FIREWRAP® GRIP KIT
Color: Black",8,27.95  ,223.60  ,"81,340.81  "
FireWrap® Grip Kit Black,11/29/2022,Sales Receipt,9207,,"FIREWRAP® GRIP KIT
Color: Black",1,27.95  ,27.95  ,"81,368.76  "
FireWrap® Grip Kit Black,11/29/2022,Sales Receipt,M-113-4814959-5466623,,FireWrap® Grip Kit - Black,1,28.95  ,28.95  ,"81,397.71  "
FireWrap® Grip Kit Black,11/29/2022,Sales Receipt,M-114-7590300-5865803,,FireWrap® Grip Kit - Black,2,28.95  ,57.90  ,"81,455.61  "
FireWrap® Grip Kit Black,11/29/2022,Sales Receipt,M-111-0849775-9190609,,FireWrap® Grip Kit - Black,1,28.95  ,28.95  ,"81,484.56  "
FireWrap® Grip Kit Black,11/30/2022,Sales Receipt,M-114-8106992-1417852,,FireWrap® Grip Kit - Black,1,28.95  ,28.95  ,"81,513.51  "
FireWrap® Grip Kit Black,12/01/2022,Sales Receipt,M-112-6638354-2714652,,FireWrap® Grip Kit - Black,1,28.95  ,28.95  ,"81,542.46  "
FireWrap® Grip Kit Black,12/02/2022,Sales Receipt,M-114-6849781-1342601,,FireWrap® Grip Kit - Black,1,28.95  ,28.95  ,"81,571.41  "
FireWrap® Grip Kit Black,12/03/2022,Sales Receipt,9242,,"FIREWRAP® GRIP KIT
Color: Black",1,27.95  ,27.95  ,"81,599.36  "
FireWrap® Grip Kit Black,12/03/2022,Sales Receipt,M-113-2927290-1983463,,FireWrap® Grip Kit - Black,1,28.95  ,28.95  ,"81,628.31  "
FireWrap® Grip Kit Black,12/04/2022,Sales Receipt,9246,,"FIREWRAP® GRIP KIT
Color: Black",1,27.95  ,27.95  ,"81,656.26  "
FireWrap® Grip Kit Black,12/04/2022,Sales Receipt,9248,,"FIREWRAP® GRIP KIT
Color: Black",2,27.95  ,55.90  ,"81,712.16  "
FireWrap® Grip Kit Black,12/04/2022,Sales Receipt,9252,,"FIREWRAP® GRIP KIT
Color: Black",1,27.95  ,27.95  ,"81,740.11  "
FireWrap® Grip Kit Black,12/04/2022,Sales Receipt,9247,,"FIREWRAP® GRIP KIT
Color: Black",2,27.95  ,55.90  ,"81,796.01  "
FireWrap® Grip Kit Black,12/04/2022,Sales Receipt,9245,,"FIREWRAP® GRIP KIT
Color: Black",1,27.95  ,27.95  ,"81,823.96  "
FireWrap® Grip Kit Black,12/05/2022,Sales Receipt,M-114-4261649-3278664,,FireWrap® Grip Kit - Black,1,28.95  ,28.95  ,"81,852.91  "
FireWrap® Grip Kit Black,12/06/2022,Sales Receipt,M-112-7857685-0677856,,FireWrap® Grip Kit - Black,1,28.95  ,28.95  ,"81,881.86  "
FireWrap® Grip Kit Black,12/06/2022,Sales Receipt,9262,,"FIREWRAP® GRIP KIT
Color: Black",6,27.95  ,167.70  ,"82,049.56  "
FireWrap® Grip Kit Black,12/06/2022,Sales Receipt,M-113-3333482-9937054,,FireWrap® Grip Kit - Black,1,28.95  ,28.95  ,"82,078.51  "
FireWrap® Grip Kit Black,12/06/2022,Sales Receipt,M-112-4082286-5108238,,FireWrap® Grip Kit - Black,1,28.95  ,28.95  ,"82,107.46  "
FireWrap® Grip Kit Black,12/07/2022,Sales Receipt,M-112-0106439-8742625,,FireWrap® Grip Kit - Black,1,28.95  ,28.95  ,"82,136.41  "
FireWrap® Grip Kit Black,12/07/2022,Sales Receipt,9265,,"FIREWRAP® GRIP KIT
Color: Black",1,27.95  ,27.95  ,"82,164.36  "
FireWrap® Grip Kit Black,12/09/2022,Sales Receipt,9288,,"FIREWRAP® GRIP KIT
Color: Black",1,27.95  ,27.95  ,"82,192.31  "
FireWrap® Grip Kit Black,12/09/2022,Sales Receipt,9285,,"FIREWRAP® GRIP KIT
Color: Black",2,27.95  ,55.90  ,"82,248.21  "
FireWrap® Grip Kit Black,12/09/2022,Sales Receipt,M-111-3610784-3309812,,FireWrap® Grip Kit - Black,1,28.95  ,28.95  ,"82,277.16  "
FireWrap® Grip Kit Black,12/10/2022,Sales Receipt,M-112-8917890-0373065,,FireWrap® Grip Kit - Black,1,28.95  ,28.95  ,"82,306.11  "
FireWrap® Grip Kit Black,12/11/2022,Sales Receipt,9308,,"FIREWRAP® GRIP KIT
Color: Black",1,27.95  ,27.95  ,"82,334.06  "
FireWrap® Grip Kit Black,12/11/2022,Sales Receipt,M-112-7701665-7993028,,FireWrap® Grip Kit - Black,1,28.95  ,28.95  ,"82,363.01  "
FireWrap® Grip Kit Black,12/11/2022,Sales Receipt,M-114-0023664-3913033,,FireWrap® Grip Kit - Black,1,28.95  ,28.95  ,"82,391.96  "
FireWrap® Grip Kit Black,12/11/2022,Sales Receipt,9311,,"FIREWRAP® GRIP KIT
Color: Black",1,27.95  ,27.95  ,"82,419.91  "
FireWrap® Grip Kit Black,12/14/2022,Sales Receipt,9324,,"FIREWRAP® GRIP KIT
Color: Black",4,27.95  ,111.80  ,"82,531.71  "
FireWrap® Grip Kit Black,12/15/2022,Sales Receipt,9326,,"FIREWRAP® GRIP KIT
Color: Black",1,27.95  ,27.95  ,"82,559.66  "
FireWrap® Grip Kit Black,12/15/2022,Sales Receipt,M-111-1099738-3509832,,FireWrap® Grip Kit - Black,1,28.95  ,28.95  ,"82,588.61  "
FireWrap® Grip Kit Black,12/15/2022,Sales Receipt,M-113-5037286-4919407,,FireWrap® Grip Kit - Black,1,28.95  ,28.95  ,"82,617.56  "
FireWrap® Grip Kit Black,12/16/2022,Sales Receipt,9342,,"FIREWRAP® GRIP KIT
Color: Black",1,27.95  ,27.95  ,"82,645.51  "
FireWrap® Grip Kit Black,12/16/2022,Sales Receipt,M-111-5917585-3193825,,FireWrap® Grip Kit - Black,1,28.95  ,28.95  ,"82,674.46  "
FireWrap® Grip Kit Black,12/17/2022,Sales Receipt,M-113-1440649-3969062,,FireWrap® Grip Kit - Black,1,28.95  ,28.95  ,"82,703.41  "
FireWrap® Grip Kit Black,12/18/2022,Sales Receipt,M-113-2795223-9912211,,FireWrap® Grip Kit - Black,1,28.95  ,28.95  ,"82,732.36  "
FireWrap® Grip Kit Black,12/18/2022,Sales Receipt,M-113-0542325-3569019,,FireWrap® Grip Kit - Black,1,28.95  ,28.95  ,"82,761.31  "
FireWrap® Grip Kit Black,12/19/2022,Sales Receipt,M-114-8376404-1936261,,FireWrap® Grip Kit - Black,2,28.95  ,57.90  ,"82,819.21  "
FireWrap® Grip Kit Black,12/19/2022,Sales Receipt,9358,,"FIREWRAP® GRIP KIT
Color: Black",1,27.95  ,27.95  ,"82,847.16  "
FireWrap® Grip Kit Black,12/20/2022,Sales Receipt,M-112-5159014-7370637,,FireWrap® Grip Kit - Black,2,28.95  ,57.90  ,"82,905.06  "
FireWrap® Grip Kit Black,12/20/2022,Sales Receipt,9373,,"FIREWRAP® GRIP KIT
Color: Black",1,27.95  ,27.95  ,"82,933.01  "
FireWrap® Grip Kit Black,12/20/2022,Sales Receipt,9371,,"FIREWRAP® GRIP KIT
Color: Black",1,27.95  ,27.95  ,"82,960.96  "
FireWrap® Grip Kit Black,12/21/2022,Sales Receipt,M-113-3771641-4899448,,FireWrap® Grip Kit - Black,1,28.95  ,28.95  ,"82,989.91  "
FireWrap® Grip Kit Black,12/22/2022,Sales Receipt,M-111-7624760-6522610,,FireWrap® Grip Kit - Black,1,28.95  ,28.95  ,"83,018.86  "
FireWrap® Grip Kit Black,12/24/2022,Sales Receipt,M-111-5043981-6295427,,FireWrap® Grip Kit - Black,1,28.95  ,28.95  ,"83,047.81  "
FireWrap® Grip Kit Black,12/25/2022,Sales Receipt,9395,,"FIREWRAP® GRIP KIT
Color: Black",2,27.95  ,55.90  ,"83,103.71  "
FireWrap® Grip Kit Black,12/27/2022,Sales Receipt,M-112-1999031-3266641,,FireWrap® Grip Kit - Black,1,28.95  ,28.95  ,"83,132.66  "
FireWrap® Grip Kit Black,12/28/2022,Sales Receipt,9411,,"FIREWRAP® GRIP KIT
Color: Black",1,27.95  ,27.95  ,"83,160.61  "
FireWrap® Grip Kit Black,12/29/2022,Sales Receipt,M-113-0572553-2776217,,FireWrap® Grip Kit - Black,1,28.95  ,28.95  ,"83,189.56  "
FireWrap® Grip Kit Black,12/29/2022,Sales Receipt,9421,,"FIREWRAP® GRIP KIT
Color: Black",2,27.95  ,55.90  ,"83,245.46  "
FireWrap® Grip Kit Black,12/29/2022,Sales Receipt,M-112-0258268-5194606,,FireWrap® Grip Kit - Black,1,28.95  ,28.95  ,"83,274.41  "
FireWrap® Grip Kit Black,12/30/2022,Sales Receipt,9427,,"FIREWRAP® GRIP KIT
Color: Black",1,27.95  ,27.95  ,"83,302.36  "
FireWrap® Grip Kit Black,12/30/2022,Sales Receipt,9431,,"FIREWRAP® GRIP KIT
Color: Black",1,27.95  ,27.95  ,"83,330.31  "
FireWrap® Grip Kit Black,12/30/2022,Sales Receipt,M-114-4375699-1436212,,FireWrap® Grip Kit - Black,1,28.95  ,28.95  ,"83,359.26  "
FireWrap® Grip Kit Black,12/30/2022,Sales Receipt,9425,,"FIREWRAP® GRIP KIT
Color: Black",1,27.95  ,27.95  ,"83,387.21  "
FireWrap® Grip Kit Black,12/31/2022,Sales Receipt,M-112-5015319-3954634,,FireWrap® Grip Kit - Black,2,28.95  ,57.90  ,"83,445.11  "
FireWrap® Grip Kit Black,01/02/2023,Sales Receipt,M-112-0864315-5706606,,FireWrap® Grip Kit - Black,1,28.95  ,28.95  ,"83,474.06  "
FireWrap® Grip Kit Black,01/02/2023,Sales Receipt,9447,,"FIREWRAP® GRIP KIT
Color: Black",1,27.95  ,27.95  ,"83,502.01  "
FireWrap® Grip Kit Black,01/02/2023,Sales Receipt,9446,,"FIREWRAP® GRIP KIT
Color: Black",1,27.95  ,27.95  ,"83,529.96  "
FireWrap® Grip Kit Black,01/02/2023,Sales Receipt,M-114-9534476-1068202,,FireWrap® Grip Kit - Black,1,28.95  ,28.95  ,"83,558.91  "
FireWrap® Grip Kit Black,01/03/2023,Sales Receipt,M-112-1914042-2163443,,FireWrap® Grip Kit - Black,2,28.95  ,57.90  ,"83,616.81  "
FireWrap® Grip Kit Black,01/04/2023,Sales Receipt,M-111-4324464-8793819,,FireWrap® Grip Kit - Black,1,28.95  ,28.95  ,"83,645.76  "
FireWrap® Grip Kit Black,01/04/2023,Sales Receipt,9456,,"FIREWRAP® GRIP KIT
Color: Black",2,27.95  ,55.90  ,"83,701.66  "
FireWrap® Grip Kit Black,01/04/2023,Sales Receipt,M-112-0061138-9990676,,FireWrap® Grip Kit - Black,1,28.95  ,28.95  ,"83,730.61  "
FireWrap® Grip Kit Black,01/05/2023,Sales Receipt,M-112-4193897-6692228,,FireWrap® Grip Kit - Black,1,28.95  ,28.95  ,"83,759.56  "
FireWrap® Grip Kit Black,01/05/2023,Sales Receipt,9458,,"FIREWRAP® GRIP KIT
Color: Black",3,27.95  ,83.85  ,"83,843.41  "
FireWrap® Grip Kit Black,01/05/2023,Sales Receipt,M-111-0277305-0764246,,FireWrap® Grip Kit - Black,1,28.95  ,28.95  ,"83,872.36  "
FireWrap® Grip Kit Black,01/06/2023,Sales Receipt,9468,,"FIREWRAP® GRIP KIT
Color: Black",1,27.95  ,27.95  ,"83,900.31  "
FireWrap® Grip Kit Black,01/06/2023,Sales Receipt,M-112-2853939-9553811,,FireWrap® Grip Kit - Black,1,28.95  ,28.95  ,"83,929.26  "
FireWrap® Grip Kit Black,01/08/2023,Sales Receipt,9476,,"FIREWRAP® GRIP KIT
Color: Black",1,27.95  ,27.95  ,"83,957.21  "
FireWrap® Grip Kit Black,01/09/2023,Sales Receipt,9482,,"FIREWRAP® GRIP KIT
Color: Black",1,27.95  ,27.95  ,"83,985.16  "
Total for FireWrap® Grip Kit Black,,,,,,3143,,"$	83,985.16  ",
FireWrap® Grip Kit Blue,,,,,,,,,
FireWrap® Grip Kit Blue,03/24/2018,Sales Receipt,#1401,,FireWrap  Grip Kit - Pre-Order,1,24.95  ,24.95  ,24.95  
FireWrap® Grip Kit Blue,03/24/2018,Sales Receipt,#1398,,FireWrap  Grip Kit - Pre-Order,4,24.95  ,99.80  ,124.75  
FireWrap® Grip Kit Blue,03/30/2018,Sales Receipt,#1419,,FireWrap  Grip Kit - Pre-Order,1,24.95  ,24.95  ,149.70  
FireWrap® Grip Kit Blue,03/31/2018,Sales Receipt,#1421,,FireWrap  Grip Kit - Pre-Order,1,24.95  ,24.95  ,174.65  
FireWrap® Grip Kit Blue,04/01/2018,Sales Receipt,#1422,,FireWrap  Grip Kit - Pre-Order,1,24.95  ,24.95  ,199.60  
FireWrap® Grip Kit Blue,04/14/2018,Sales Receipt,#1444,,FireWrap  Grip Kit - Pre-Order,1,24.95  ,24.95  ,224.55  
FireWrap® Grip Kit Blue,04/26/2018,Sales Receipt,#1475,,FireWrap  Grip Kit - Pre-Order,1,24.95  ,24.95  ,249.50  
FireWrap® Grip Kit Blue,04/26/2018,Sales Receipt,#1476,,FireWrap  Grip Kit - Pre-Order,2,24.95  ,49.90  ,299.40  
FireWrap® Grip Kit Blue,04/26/2018,Sales Receipt,#1474,,FireWrap  Grip Kit - Pre-Order,1,24.95  ,24.95  ,324.35  
FireWrap® Grip Kit Blue,04/26/2018,Sales Receipt,#1501,,FireWrap  Grip Kit - Pre-Order,1,24.95  ,24.95  ,349.30  
FireWrap® Grip Kit Blue,04/27/2018,Sales Receipt,#1520,,FireWrap  Grip Kit - Pre-Order,1,24.95  ,24.95  ,374.25  
FireWrap® Grip Kit Blue,04/28/2018,Sales Receipt,#1560,,FireWrap  Grip Kit - Pre-Order,1,24.95  ,24.95  ,399.20  
FireWrap® Grip Kit Blue,04/28/2018,Sales Receipt,#1557,,FireWrap  Grip Kit - Pre-Order,1,24.95  ,24.95  ,424.15  
FireWrap® Grip Kit Blue,04/30/2018,Invoice,1111,,,3,20.00  ,60.00  ,484.15  
FireWrap® Grip Kit Blue,04/30/2018,Invoice,1113,,,3,20.00  ,60.00  ,544.15  
FireWrap® Grip Kit Blue,04/30/2018,Sales Receipt,#1581,,FireWrap  Grip Kit - Pre-Order,1,24.95  ,24.95  ,569.10  
FireWrap® Grip Kit Blue,04/30/2018,Sales Receipt,#1580,,FireWrap  Grip Kit - Pre-Order,1,24.95  ,24.95  ,594.05  
FireWrap® Grip Kit Blue,05/01/2018,Sales Receipt,#1587,,FireWrap  Grip Kit - Pre-Order,1,24.95  ,24.95  ,619.00  
FireWrap® Grip Kit Blue,05/02/2018,Sales Receipt,#1591,,FireWrap  Grip Kit,1,34.95  ,34.95  ,653.95  
FireWrap® Grip Kit Blue,05/09/2018,Sales Receipt,#1609,,FireWrap  Grip Kit,4,34.95  ,139.80  ,793.75  
FireWrap® Grip Kit Blue,05/09/2018,Invoice,1114,,,2,30.00  ,60.00  ,853.75  
FireWrap® Grip Kit Blue,05/12/2018,Invoice,1115,,,4,26.00  ,104.00  ,957.75  
FireWrap® Grip Kit Blue,05/14/2018,Sales Receipt,#1618,,FireWrap  Grip Kit,2,34.95  ,69.90  ,"1,027.65  "
FireWrap® Grip Kit Blue,05/18/2018,Sales Receipt,#1624,,FireWrap  Grip Kit,1,34.95  ,34.95  ,"1,062.60  "
FireWrap® Grip Kit Blue,05/18/2018,Sales Receipt,#1628,,FireWrap  Grip Kit,1,34.95  ,34.95  ,"1,097.55  "
FireWrap® Grip Kit Blue,06/04/2018,Invoice,1124,,,1,34.95  ,34.95  ,"1,132.50  "
FireWrap® Grip Kit Blue,06/12/2018,Sales Receipt,#1673,,FireWrap  Grip Kit,1,34.95  ,34.95  ,"1,167.45  "
FireWrap® Grip Kit Blue,06/13/2018,Invoice,1129,,,5,34.95  ,174.75  ,"1,342.20  "
FireWrap® Grip Kit Blue,06/19/2018,Invoice,1132,,,2,30.00  ,60.00  ,"1,402.20  "
FireWrap® Grip Kit Blue,06/22/2018,Invoice,1133,,,15,26.00  ,390.00  ,"1,792.20  "
FireWrap® Grip Kit Blue,06/27/2018,Sales Receipt,#1691,,FireWrap  Grip Kit,1,34.95  ,34.95  ,"1,827.15  "
FireWrap® Grip Kit Blue,06/29/2018,Sales Receipt,#1695,,FireWrap  Grip Kit,1,34.95  ,34.95  ,"1,862.10  "
FireWrap® Grip Kit Blue,07/03/2018,Sales Receipt,#1701,,FireWrap  Grip Kit,1,34.95  ,34.95  ,"1,897.05  "
FireWrap® Grip Kit Blue,07/06/2018,Sales Receipt,#1704,,FireWrap  Grip Kit,1,34.95  ,34.95  ,"1,932.00  "
FireWrap® Grip Kit Blue,07/13/2018,Invoice,1139,,,20,34.95  ,699.00  ,"2,631.00  "
FireWrap® Grip Kit Blue,07/16/2018,Sales Receipt,#1723,,FireWrap  Grip Kit,1,34.95  ,34.95  ,"2,665.95  "
FireWrap® Grip Kit Blue,07/19/2018,Invoice,1141,,,2,34.95  ,69.90  ,"2,735.85  "
FireWrap® Grip Kit Blue,07/21/2018,Sales Receipt,#1733,,FireWrap  Grip Kit,1,34.95  ,34.95  ,"2,770.80  "
FireWrap® Grip Kit Blue,08/06/2018,Sales Receipt,#1759,,FireWrap  Grip Kit,2,34.95  ,69.90  ,"2,840.70  "
FireWrap® Grip Kit Blue,08/12/2018,Invoice,1157,,,3,34.95  ,104.85  ,"2,945.55  "
FireWrap® Grip Kit Blue,08/15/2018,Sales Receipt,#1776,,FireWrap  Grip Kit,8,34.95  ,279.60  ,"3,225.15  "
FireWrap® Grip Kit Blue,08/19/2018,Sales Receipt,#1779,,FireWrap  Grip Kit,1,34.95  ,34.95  ,"3,260.10  "
FireWrap® Grip Kit Blue,08/21/2018,Invoice,1163,,,5,28.00  ,140.00  ,"3,400.10  "
FireWrap® Grip Kit Blue,08/24/2018,Invoice,1165,,,2,30.00  ,60.00  ,"3,460.10  "
FireWrap® Grip Kit Blue,08/26/2018,Sales Receipt,#1793,,FireWrap  Grip Kit,1,34.95  ,34.95  ,"3,495.05  "
FireWrap® Grip Kit Blue,08/30/2018,Sales Receipt,#1802,,FireWrap  Grip Kit,1,34.95  ,34.95  ,"3,530.00  "
FireWrap® Grip Kit Blue,09/05/2018,Sales Receipt,#1812,,FireWrap  Grip Kit,1,34.95  ,34.95  ,"3,564.95  "
FireWrap® Grip Kit Blue,09/10/2018,Sales Receipt,#1821,,FireWrap  Grip Kit,1,34.95  ,34.95  ,"3,599.90  "
FireWrap® Grip Kit Blue,09/12/2018,Sales Receipt,#1832,,FireWrap  Grip Kit,1,34.95  ,34.95  ,"3,634.85  "
FireWrap® Grip Kit Blue,09/21/2018,Sales Receipt,#1857,,FireWrap  Grip Kit,4,34.95  ,139.80  ,"3,774.65  "
FireWrap® Grip Kit Blue,09/27/2018,Sales Receipt,#1874,,FireWrap  Grip Kit,1,34.95  ,34.95  ,"3,809.60  "
FireWrap® Grip Kit Blue,10/02/2018,Sales Receipt,#1883,,FireWrap  Grip Kit,1,34.95  ,34.95  ,"3,844.55  "
FireWrap® Grip Kit Blue,10/03/2018,Sales Receipt,#1885,,FireWrap  Grip Kit,1,34.95  ,34.95  ,"3,879.50  "
FireWrap® Grip Kit Blue,10/04/2018,Invoice,1177,,"Capt. Dan McCleese
DFR- FS 06
13712 Dumfries Road
Manassas VA 20112
United States",6,26.00  ,156.00  ,"4,035.50  "
FireWrap® Grip Kit Blue,10/10/2018,Invoice,1178,,,1,34.95  ,34.95  ,"4,070.45  "
FireWrap® Grip Kit Blue,10/12/2018,Sales Receipt,#1899,,FireWrap  Grip Kit,2,34.95  ,69.90  ,"4,140.35  "
FireWrap® Grip Kit Blue,10/16/2018,Sales Receipt,#1905,,FireWrap  Grip Kit,1,34.95  ,34.95  ,"4,175.30  "
FireWrap® Grip Kit Blue,10/18/2018,Sales Receipt,#1930,,FireWrap  Grip Kit,3,34.95  ,104.85  ,"4,280.15  "
FireWrap® Grip Kit Blue,10/19/2018,Sales Receipt,#1952,,FireWrap  Grip Kit,1,34.95  ,34.95  ,"4,315.10  "
FireWrap® Grip Kit Blue,10/21/2018,Sales Receipt,#1953,,FireWrap  Grip Kit,1,34.95  ,34.95  ,"4,350.05  "
FireWrap® Grip Kit Blue,10/23/2018,Invoice,1184,,,6,28.00  ,168.00  ,"4,518.05  "
FireWrap® Grip Kit Blue,10/23/2018,Sales Receipt,#1957,,FireWrap  Grip Kit,1,34.95  ,34.95  ,"4,553.00  "
FireWrap® Grip Kit Blue,10/25/2018,Sales Receipt,#1960,,FireWrap  Grip Kit,1,34.95  ,34.95  ,"4,587.95  "
FireWrap® Grip Kit Blue,10/29/2018,Sales Receipt,#1967,,FireWrap  Grip Kit,4,34.95  ,139.80  ,"4,727.75  "
FireWrap® Grip Kit Blue,10/29/2018,Invoice,1192,,,34,24.00  ,816.00  ,"5,543.75  "
FireWrap® Grip Kit Blue,11/03/2018,Sales Receipt,#1984,,FireWrap  Grip Kit,2,34.95  ,69.90  ,"5,613.65  "
FireWrap® Grip Kit Blue,11/05/2018,Sales Receipt,#1986,,FireWrap  Grip Kit,2,34.95  ,69.90  ,"5,683.55  "
FireWrap® Grip Kit Blue,11/13/2018,Sales Receipt,#1997,,FireWrap  Grip Kit,1,34.95  ,34.95  ,"5,718.50  "
FireWrap® Grip Kit Blue,11/13/2018,Invoice,1203,,,4,28.00  ,112.00  ,"5,830.50  "
FireWrap® Grip Kit Blue,11/14/2018,Invoice,1204,,,2,34.95  ,69.90  ,"5,900.40  "
FireWrap® Grip Kit Blue,11/24/2018,Sales Receipt,#2027,,FireWrap  Grip Kit,1,34.95  ,34.95  ,"5,935.35  "
FireWrap® Grip Kit Blue,12/05/2018,Invoice,1215,,,6,25.00  ,150.00  ,"6,085.35  "
FireWrap® Grip Kit Blue,12/07/2018,Invoice,1217,,,4,26.00  ,104.00  ,"6,189.35  "
FireWrap® Grip Kit Blue,12/12/2018,Sales Receipt,#2083,,FireWrap  Grip Kit,1,34.95  ,34.95  ,"6,224.30  "
FireWrap® Grip Kit Blue,12/13/2018,Sales Receipt,#2086,,FireWrap  Grip Kit,2,34.95  ,69.90  ,"6,294.20  "
FireWrap® Grip Kit Blue,12/17/2018,Invoice,1227,,,1,30.00  ,30.00  ,"6,324.20  "
FireWrap® Grip Kit Blue,12/21/2018,Invoice,1237,,,2,34.95  ,69.90  ,"6,394.10  "
FireWrap® Grip Kit Blue,12/30/2018,Sales Receipt,#2148,,FireWrap  Grip Kit,1,34.95  ,34.95  ,"6,429.05  "
FireWrap® Grip Kit Blue,12/30/2018,Invoice,1233,,PO#:  949766,3,30.00  ,90.00  ,"6,519.05  "
FireWrap® Grip Kit Blue,12/30/2018,Invoice,1233,,PO#:  949770,1,30.00  ,30.00  ,"6,549.05  "
FireWrap® Grip Kit Blue,12/30/2018,Invoice,1240,,,1,30.00  ,30.00  ,"6,579.05  "
FireWrap® Grip Kit Blue,12/30/2018,Invoice,1235,,,1,30.00  ,30.00  ,"6,609.05  "
FireWrap® Grip Kit Blue,01/11/2019,Sales Receipt,#2188,,FireWrap  Grip Kit,1,34.95  ,34.95  ,"6,644.00  "
FireWrap® Grip Kit Blue,01/13/2019,Invoice,1232,,,1,30.00  ,30.00  ,"6,674.00  "
FireWrap® Grip Kit Blue,01/16/2019,Sales Receipt,#2203,,FireWrap  Grip Kit,1,34.95  ,34.95  ,"6,708.95  "
FireWrap® Grip Kit Blue,01/17/2019,Sales Receipt,#2212,,FireWrap Grip Kit,1,34.95  ,34.95  ,"6,743.90  "
FireWrap® Grip Kit Blue,01/18/2019,Sales Receipt,#2217,,FireWrap  Grip Kit,1,34.95  ,34.95  ,"6,778.85  "
FireWrap® Grip Kit Blue,01/23/2019,Invoice,1254,,,1,30.00  ,30.00  ,"6,808.85  "
FireWrap® Grip Kit Blue,01/25/2019,Invoice,1248,,,4,26.00  ,104.00  ,"6,912.85  "
FireWrap® Grip Kit Blue,01/25/2019,Sales Receipt,#2233,,FireWrap  Grip Kit,1,34.95  ,34.95  ,"6,947.80  "
FireWrap® Grip Kit Blue,01/31/2019,Sales Receipt,#2256,,FireWrap  Grip Kit,1,34.95  ,34.95  ,"6,982.75  "
FireWrap® Grip Kit Blue,02/02/2019,Sales Receipt,#2266,,FireWrap  Grip Kit,6,34.95  ,209.70  ,"7,192.45  "
FireWrap® Grip Kit Blue,02/02/2019,Invoice,1242,,P.O. Number: 19-0103-11,1,30.00  ,30.00  ,"7,222.45  "
FireWrap® Grip Kit Blue,02/02/2019,Invoice,1242,,P.O. Number: 19-0129-2,5,30.00  ,150.00  ,"7,372.45  "
FireWrap® Grip Kit Blue,02/18/2019,Invoice,1277,,,1,29.00  ,29.00  ,"7,401.45  "
FireWrap® Grip Kit Blue,02/18/2019,Invoice,1271,,,7,25.00  ,175.00  ,"7,576.45  "
FireWrap® Grip Kit Blue,02/18/2019,Sales Receipt,#2312,,FireWrap  Grip Kit,1,34.95  ,34.95  ,"7,611.40  "
FireWrap® Grip Kit Blue,02/20/2019,Invoice,1270,,,3,30.00  ,90.00  ,"7,701.40  "
FireWrap® Grip Kit Blue,02/22/2019,Sales Receipt,#2327,,FireWrap  Grip Kit,1,34.95  ,34.95  ,"7,736.35  "
FireWrap® Grip Kit Blue,02/27/2019,Invoice,1280,,,8,28.00  ,224.00  ,"7,960.35  "
FireWrap® Grip Kit Blue,03/01/2019,Invoice,1289,,,2,30.00  ,60.00  ,"8,020.35  "
FireWrap® Grip Kit Blue,03/05/2019,Sales Receipt,#2369,,FireWrap  Grip Kit,1,34.95  ,34.95  ,"8,055.30  "
FireWrap® Grip Kit Blue,03/07/2019,Sales Receipt,#2381,,FireWrap  Grip Kit,1,34.95  ,34.95  ,"8,090.25  "
FireWrap® Grip Kit Blue,03/07/2019,Sales Receipt,#2386,,FireWrap  Grip Kit,1,34.95  ,34.95  ,"8,125.20  "
FireWrap® Grip Kit Blue,03/08/2019,Sales Receipt,#2390,,FireWrap  Grip Kit,4,34.95  ,139.80  ,"8,265.00  "
FireWrap® Grip Kit Blue,03/11/2019,Invoice,1298,,,3,30.00  ,90.00  ,"8,355.00  "
FireWrap® Grip Kit Blue,03/11/2019,Sales Receipt,#2399,,FireWrap  Grip Kit,2,34.95  ,69.90  ,"8,424.90  "
FireWrap® Grip Kit Blue,03/12/2019,Sales Receipt,#2404,,FireWrap  Grip Kit,1,34.95  ,34.95  ,"8,459.85  "
FireWrap® Grip Kit Blue,03/13/2019,Sales Receipt,#2409,,FireWrap  Grip Kit,1,34.95  ,34.95  ,"8,494.80  "
FireWrap® Grip Kit Blue,03/19/2019,Sales Receipt,#2425,,FireWrap  Grip Kit,1,34.95  ,34.95  ,"8,529.75  "
FireWrap® Grip Kit Blue,03/21/2019,Sales Receipt,#2430,,FireWrap  Grip Kit,1,34.95  ,34.95  ,"8,564.70  "
FireWrap® Grip Kit Blue,03/31/2019,Sales Receipt,#2463,,FireWrap® Grip Kit,1,34.95  ,34.95  ,"8,599.65  "
FireWrap® Grip Kit Blue,04/01/2019,Refund,#2465 (Refund 1),,FireWrap® Grip Kit,-1,34.95  ,-34.95  ,"8,564.70  "
FireWrap® Grip Kit Blue,04/01/2019,Sales Receipt,#2465,,FireWrap® Grip Kit,1,34.95  ,34.95  ,"8,599.65  "
FireWrap® Grip Kit Blue,04/03/2019,Sales Receipt,#2479,,FireWrap® Grip Kit,1,34.95  ,34.95  ,"8,634.60  "
FireWrap® Grip Kit Blue,04/05/2019,Sales Receipt,#2491,,FireWrap® Grip Kit,1,34.95  ,34.95  ,"8,669.55  "
FireWrap® Grip Kit Blue,04/25/2019,Invoice,1333,,,3,30.00  ,90.00  ,"8,759.55  "
FireWrap® Grip Kit Blue,05/24/2019,Invoice,1341,,,11,28.00  ,308.00  ,"9,067.55  "
FireWrap® Grip Kit Blue,06/03/2019,Invoice,1339,,"P.O. Number: 19-0519-2 
Michael Gafford
1160 Belt Line Rd
Collinsville, IL 62234",2,30.00  ,60.00  ,"9,127.55  "
FireWrap® Grip Kit Blue,06/03/2019,Invoice,1339,,"P.O. Number: 19-0517-2 
Jake Rusch
2143 Longhunter Chase Dr
Spring Hill, TN 37174",2,30.00  ,60.00  ,"9,187.55  "
FireWrap® Grip Kit Blue,06/03/2019,Invoice,1340,,,2,30.00  ,60.00  ,"9,247.55  "
FireWrap® Grip Kit Blue,06/04/2019,Invoice,1364,,,1,30.00  ,30.00  ,"9,277.55  "
FireWrap® Grip Kit Blue,06/05/2019,Invoice,1360,,,1,30.00  ,30.00  ,"9,307.55  "
FireWrap® Grip Kit Blue,06/11/2019,Sales Receipt,#2679,,FireWrap® Grip Kit,2,34.95  ,69.90  ,"9,377.45  "
FireWrap® Grip Kit Blue,06/15/2019,Sales Receipt,#2695,,FireWrap® Grip Kit,10,34.95  ,349.50  ,"9,726.95  "
FireWrap® Grip Kit Blue,06/22/2019,Sales Receipt,#2715,,FireWrap® Grip Kit,1,34.95  ,34.95  ,"9,761.90  "
FireWrap® Grip Kit Blue,06/24/2019,Sales Receipt,#2726,,FireWrap® Grip Kit,1,34.95  ,34.95  ,"9,796.85  "
FireWrap® Grip Kit Blue,06/28/2019,Invoice,1372,,"Craig Jarman
Southwood Fire Dept.
1211 Strawberry Branch Dr
Kingston NC 28501",6,30.00  ,180.00  ,"9,976.85  "
FireWrap® Grip Kit Blue,06/28/2019,Invoice,1372,,"Drew Belue
7892 East 400 North
Rolling Prairie IN 46371",1,30.00  ,30.00  ,"10,006.85  "
FireWrap® Grip Kit Blue,06/28/2019,Invoice,1372,,"Dustin Ford
1052 Belmont Rd
Sardis MS 38666",3,30.00  ,90.00  ,"10,096.85  "
FireWrap® Grip Kit Blue,06/30/2019,Sales Receipt,#2738,,FireWrap Grip Kit,1,34.95  ,34.95  ,"10,131.80  "
FireWrap® Grip Kit Blue,07/02/2019,Invoice,1361,,P.O. Number: 19-0624-3,1,30.00  ,30.00  ,"10,161.80  "
FireWrap® Grip Kit Blue,07/02/2019,Invoice,1373,,,1,30.00  ,30.00  ,"10,191.80  "
FireWrap® Grip Kit Blue,07/02/2019,Invoice,1361,,"P.O. Number: 19-0610-2 
Tyler Cannaday
576 Rosedale Dr
Aynor, SC 29511",1,30.00  ,30.00  ,"10,221.80  "
FireWrap® Grip Kit Blue,07/02/2019,Sales Receipt,#2745,,FireWrap® Grip Kit,1,34.95  ,34.95  ,"10,256.75  "
FireWrap® Grip Kit Blue,07/03/2019,Sales Receipt,#2748,,FireWrap® Grip Kit,3,34.95  ,104.85  ,"10,361.60  "
FireWrap® Grip Kit Blue,07/15/2019,Sales Receipt,114-8717291-3389013,,FireWrap Grip Kit,1,34.95  ,34.95  ,"10,396.55  "
FireWrap® Grip Kit Blue,07/19/2019,Sales Receipt,112-6108885-1407426,,FireWrap Grip Kit (New),1,34.95  ,34.95  ,"10,431.50  "
FireWrap® Grip Kit Blue,07/25/2019,Sales Receipt,111-9805681-6183413,,FireWrap Grip Kit,1,34.95  ,34.95  ,"10,466.45  "
FireWrap® Grip Kit Blue,10/02/2019,Sales Receipt,112-3633542-9689866,,FireWrap Grip Kit (New),1,34.95  ,34.95  ,"10,501.40  "
FireWrap® Grip Kit Blue,10/03/2019,Invoice,M-100319-001,,,2,34.95  ,69.90  ,"10,571.30  "
FireWrap® Grip Kit Blue,11/03/2019,Sales Receipt,114-7337402-8040205,,FireWrap Grip Kit (New),2,34.95  ,69.90  ,"10,641.20  "
FireWrap® Grip Kit Blue,11/08/2019,Sales Receipt,113-5125710-4261010,,FireWrap Grip Kit - Blue (New),1,34.95  ,34.95  ,"10,676.15  "
FireWrap® Grip Kit Blue,11/24/2019,Sales Receipt,111-3620154-0611406,,FireWrap Grip Kit - Blue,8,34.95  ,279.60  ,"10,955.75  "
FireWrap® Grip Kit Blue,12/02/2019,Sales Receipt,113-1783065-3782606,,FireWrap Grip Kit - Blue (New),1,34.95  ,34.95  ,"10,990.70  "
FireWrap® Grip Kit Blue,12/10/2019,Sales Receipt,112-5446688-4961800,,FireWrap Grip Kit - Blue (New),1,34.95  ,34.95  ,"11,025.65  "
FireWrap® Grip Kit Blue,12/11/2019,Sales Receipt,111-7672641-3242651,,FireWrap Grip Kit - Blue (New),1,34.95  ,34.95  ,"11,060.60  "
FireWrap® Grip Kit Blue,12/23/2019,Sales Receipt,112-8030524-4139402,,FireWrap Grip Kit - Blue (New),1,34.95  ,34.95  ,"11,095.55  "
FireWrap® Grip Kit Blue,12/26/2019,Sales Receipt,114-6240682-6078610,,FireWrap Grip Kit - Blue (New),1,34.95  ,34.95  ,"11,130.50  "
FireWrap® Grip Kit Blue,01/22/2020,Sales Receipt,114-8906853-7169822,,FireWrap Grip Kit - Blue (New),1,24.95  ,24.95  ,"11,155.45  "
FireWrap® Grip Kit Blue,01/24/2020,Sales Receipt,113-3804811-2628230,,FireWrap Grip Kit - Blue (New),1,24.95  ,24.95  ,"11,180.40  "
FireWrap® Grip Kit Blue,02/02/2020,Sales Receipt,112-9740791-3833819,,FireWrap Grip Kit - Blue (New),1,24.95  ,24.95  ,"11,205.35  "
FireWrap® Grip Kit Blue,02/10/2020,Sales Receipt,114-4970473-3696238,,FireWrap Grip Kit - Blue (New),1,24.95  ,24.95  ,"11,230.30  "
FireWrap® Grip Kit Blue,03/13/2020,Sales Receipt,113-9124577-3767401,,FireWrap Grip Kit - Blue (New),1,24.95  ,24.95  ,"11,255.25  "
FireWrap® Grip Kit Blue,04/01/2020,Sales Receipt,3599,,FireWrap® Grip Kit - Blue,3,24.95  ,74.85  ,"11,330.10  "
FireWrap® Grip Kit Blue,04/03/2020,Sales Receipt,3609,,FireWrap® Grip Kit - Blue,1,24.95  ,24.95  ,"11,355.05  "
FireWrap® Grip Kit Blue,04/07/2020,Sales Receipt,112-5738305-1993003,,FireWrap Grip Kit - Blue (New),1,24.95  ,24.95  ,"11,380.00  "
FireWrap® Grip Kit Blue,04/16/2020,Sales Receipt,112-8793525-7389001,,FireWrap Grip Kit - Blue (New),2,24.95  ,49.90  ,"11,429.90  "
FireWrap® Grip Kit Blue,04/17/2020,Sales Receipt,3652,,FireWrap® Grip Kit - Blue,1,24.95  ,24.95  ,"11,454.85  "
FireWrap® Grip Kit Blue,04/17/2020,Sales Receipt,3650,,FireWrap® Grip Kit - Blue,1,24.95  ,24.95  ,"11,479.80  "
FireWrap® Grip Kit Blue,04/20/2020,Sales Receipt,3664,,FireWrap® Grip Kit - Blue,1,24.95  ,24.95  ,"11,504.75  "
FireWrap® Grip Kit Blue,04/20/2020,Sales Receipt,3665,,FireWrap® Grip Kit - Blue,1,24.95  ,24.95  ,"11,529.70  "
FireWrap® Grip Kit Blue,04/24/2020,Sales Receipt,3686,,FireWrap® Grip Kit - Blue,1,24.95  ,24.95  ,"11,554.65  "
FireWrap® Grip Kit Blue,04/25/2020,Sales Receipt,3687,,FireWrap® Grip Kit - Blue,1,24.95  ,24.95  ,"11,579.60  "
FireWrap® Grip Kit Blue,04/26/2020,Sales Receipt,3690,,FireWrap® Grip Kit - Blue,1,24.95  ,24.95  ,"11,604.55  "
FireWrap® Grip Kit Blue,04/29/2020,Sales Receipt,111-8218568-9666650,,FireWrap Grip Kit - Blue (New),1,24.95  ,24.95  ,"11,629.50  "
FireWrap® Grip Kit Blue,04/29/2020,Sales Receipt,3705,,FireWrap® Grip Kit - Blue,2,24.95  ,49.90  ,"11,679.40  "
FireWrap® Grip Kit Blue,05/01/2020,Sales Receipt,3715,,FireWrap® Grip Kit - Blue,1,24.95  ,24.95  ,"11,704.35  "
FireWrap® Grip Kit Blue,05/13/2020,Sales Receipt,3760,,FireWrap® Grip Kit - Blue,1,24.95  ,24.95  ,"11,729.30  "
FireWrap® Grip Kit Blue,05/24/2020,Sales Receipt,3793,,FireWrap® Grip Kit - Blue,1,24.95  ,24.95  ,"11,754.25  "
FireWrap® Grip Kit Blue,05/26/2020,Sales Receipt,3797,,FireWrap® Grip Kit - Blue,1,24.95  ,24.95  ,"11,779.20  "
FireWrap® Grip Kit Blue,05/26/2020,Sales Receipt,3800,,FireWrap® Grip Kit - Blue,1,24.95  ,24.95  ,"11,804.15  "
FireWrap® Grip Kit Blue,06/04/2020,Sales Receipt,3823,,FireWrap® Grip Kit - Blue,5,24.95  ,124.75  ,"11,928.90  "
FireWrap® Grip Kit Blue,06/09/2020,Sales Receipt,3840,,FireWrap® Grip Kit - Blue,1,24.95  ,24.95  ,"11,953.85  "
FireWrap® Grip Kit Blue,06/11/2020,Sales Receipt,3848,,FireWrap® Grip Kit - Blue,3,24.95  ,74.85  ,"12,028.70  "
FireWrap® Grip Kit Blue,06/12/2020,Sales Receipt,3851,,FireWrap® Grip Kit - Blue,2,24.95  ,49.90  ,"12,078.60  "
FireWrap® Grip Kit Blue,06/13/2020,Sales Receipt,3857,,FireWrap® Grip Kit - Blue,2,24.95  ,49.90  ,"12,128.50  "
FireWrap® Grip Kit Blue,06/19/2020,Sales Receipt,3880,,FireWrap® Grip Kit - Blue,15,24.95  ,374.25  ,"12,502.75  "
FireWrap® Grip Kit Blue,06/23/2020,Sales Receipt,3943,,FireWrap® Grip Kit - Blue,3,24.95  ,74.85  ,"12,577.60  "
FireWrap® Grip Kit Blue,06/29/2020,Sales Receipt,3975,,FireWrap® Grip Kit - Blue,1,24.95  ,24.95  ,"12,602.55  "
FireWrap® Grip Kit Blue,06/30/2020,Sales Receipt,3978,,FireWrap® Grip Kit - Blue,1,24.95  ,24.95  ,"12,627.50  "
FireWrap® Grip Kit Blue,06/30/2020,Sales Receipt,3977,,FireWrap® Grip Kit - Blue,1,24.95  ,24.95  ,"12,652.45  "
FireWrap® Grip Kit Blue,07/01/2020,Sales Receipt,3980,,FireWrap® Grip Kit - Blue,1,24.95  ,24.95  ,"12,677.40  "
FireWrap® Grip Kit Blue,07/07/2020,Sales Receipt,3997,,FireWrap® Grip Kit - Blue,1,24.95  ,24.95  ,"12,702.35  "
FireWrap® Grip Kit Blue,07/09/2020,Sales Receipt,4004,,FireWrap® Grip Kit - Blue,2,24.95  ,49.90  ,"12,752.25  "
FireWrap® Grip Kit Blue,07/18/2020,Sales Receipt,4032,,FireWrap® Grip Kit - Blue,1,24.95  ,24.95  ,"12,777.20  "
FireWrap® Grip Kit Blue,07/23/2020,Sales Receipt,4044,,FireWrap® Grip Kit - Blue,2,24.95  ,49.90  ,"12,827.10  "
FireWrap® Grip Kit Blue,07/23/2020,Sales Receipt,4042,,FireWrap® Grip Kit - Blue,1,24.95  ,24.95  ,"12,852.05  "
FireWrap® Grip Kit Blue,07/26/2020,Sales Receipt,4056,,FireWrap® Grip Kit - Blue,1,24.95  ,24.95  ,"12,877.00  "
FireWrap® Grip Kit Blue,07/29/2020,Sales Receipt,4062,,FireWrap® Grip Kit - Blue,2,24.95  ,49.90  ,"12,926.90  "
FireWrap® Grip Kit Blue,07/30/2020,Sales Receipt,4066,,FireWrap® Grip Kit - Blue,1,24.95  ,24.95  ,"12,951.85  "
FireWrap® Grip Kit Blue,08/07/2020,Sales Receipt,4083,,FireWrap® Grip Kit - Blue,1,24.95  ,24.95  ,"12,976.80  "
FireWrap® Grip Kit Blue,08/09/2020,Sales Receipt,4090,,FireWrap® Grip Kit - Blue,1,24.95  ,24.95  ,"13,001.75  "
FireWrap® Grip Kit Blue,08/09/2020,Sales Receipt,4091,,FireWrap® Grip Kit - Blue,1,24.95  ,24.95  ,"13,026.70  "
FireWrap® Grip Kit Blue,08/15/2020,Sales Receipt,4107,,FireWrap® Grip Kit - Blue,1,24.95  ,24.95  ,"13,051.65  "
FireWrap® Grip Kit Blue,08/17/2020,Sales Receipt,4115,,FireWrap® Grip Kit - Blue,2,24.95  ,49.90  ,"13,101.55  "
FireWrap® Grip Kit Blue,08/18/2020,Sales Receipt,4123,,FireWrap® Grip Kit - Blue,1,24.95  ,24.95  ,"13,126.50  "
FireWrap® Grip Kit Blue,08/22/2020,Sales Receipt,4140,,FireWrap® Grip Kit - Blue,1,24.95  ,24.95  ,"13,151.45  "
FireWrap® Grip Kit Blue,08/22/2020,Sales Receipt,4139,,FireWrap® Grip Kit - Blue,1,24.95  ,24.95  ,"13,176.40  "
FireWrap® Grip Kit Blue,08/23/2020,Sales Receipt,4143,,FireWrap® Grip Kit - Blue,1,24.95  ,24.95  ,"13,201.35  "
FireWrap® Grip Kit Blue,08/27/2020,Sales Receipt,4158,,FireWrap® Grip Kit - Blue,1,24.95  ,24.95  ,"13,226.30  "
FireWrap® Grip Kit Blue,09/02/2020,Sales Receipt,4178,,FireWrap® Grip Kit - Blue,1,24.95  ,24.95  ,"13,251.25  "
FireWrap® Grip Kit Blue,09/12/2020,Sales Receipt,4209,,FireWrap® Grip Kit - Blue,1,24.95  ,24.95  ,"13,276.20  "
FireWrap® Grip Kit Blue,09/17/2020,Sales Receipt,4227,,FireWrap® Grip Kit - Blue,9,24.95  ,224.55  ,"13,500.75  "
FireWrap® Grip Kit Blue,09/24/2020,Sales Receipt,4272,,FireWrap® Grip Kit - Blue,1,24.95  ,24.95  ,"13,525.70  "
FireWrap® Grip Kit Blue,09/30/2020,Sales Receipt,4282,,FireWrap® Grip Kit - Blue,3,24.95  ,74.85  ,"13,600.55  "
FireWrap® Grip Kit Blue,09/30/2020,Sales Receipt,4284,,FireWrap® Grip Kit - Blue,8,24.95  ,199.60  ,"13,800.15  "
FireWrap® Grip Kit Blue,10/05/2020,Sales Receipt,4302,,FireWrap® Grip Kit - Blue,2,24.95  ,49.90  ,"13,850.05  "
FireWrap® Grip Kit Blue,10/05/2020,Sales Receipt,4305,,FireWrap® Grip Kit - Blue,3,24.95  ,74.85  ,"13,924.90  "
FireWrap® Grip Kit Blue,10/06/2020,Sales Receipt,4309,,FireWrap® Grip Kit - Blue,2,24.95  ,49.90  ,"13,974.80  "
FireWrap® Grip Kit Blue,10/08/2020,Sales Receipt,4322,,FireWrap® Grip Kit - Blue,1,24.95  ,24.95  ,"13,999.75  "
FireWrap® Grip Kit Blue,10/15/2020,Sales Receipt,4356,,FireWrap® Grip Kit - Blue,10,24.95  ,249.50  ,"14,249.25  "
FireWrap® Grip Kit Blue,10/18/2020,Sales Receipt,4364,,FireWrap® Grip Kit - Blue,2,24.95  ,49.90  ,"14,299.15  "
FireWrap® Grip Kit Blue,10/27/2020,Sales Receipt,4418,,FireWrap® Grip Kit - Blue,2,24.95  ,49.90  ,"14,349.05  "
FireWrap® Grip Kit Blue,10/27/2020,Sales Receipt,4421,,FireWrap® Grip Kit - Blue,1,24.95  ,24.95  ,"14,374.00  "
FireWrap® Grip Kit Blue,10/28/2020,Sales Receipt,4428,,FireWrap® Grip Kit - Blue,7,24.95  ,174.65  ,"14,548.65  "
FireWrap® Grip Kit Blue,10/29/2020,Sales Receipt,4432,,FireWrap® Grip Kit - Blue,1,24.95  ,24.95  ,"14,573.60  "
FireWrap® Grip Kit Blue,10/31/2020,Sales Receipt,4446,,FireWrap® Grip Kit - Blue,1,24.95  ,24.95  ,"14,598.55  "
FireWrap® Grip Kit Blue,11/01/2020,Sales Receipt,4451,,FireWrap® Grip Kit - Blue,1,24.95  ,24.95  ,"14,623.50  "
FireWrap® Grip Kit Blue,11/01/2020,Sales Receipt,4450,,FireWrap® Grip Kit - Blue,1,24.95  ,24.95  ,"14,648.45  "
FireWrap® Grip Kit Blue,11/03/2020,Sales Receipt,4458,,FireWrap® Grip Kit - Blue,1,24.95  ,24.95  ,"14,673.40  "
FireWrap® Grip Kit Blue,11/03/2020,Sales Receipt,4461,,FireWrap® Grip Kit - Blue,1,24.95  ,24.95  ,"14,698.35  "
FireWrap® Grip Kit Blue,11/04/2020,Sales Receipt,4464,,FireWrap® Grip Kit - Blue,1,24.95  ,24.95  ,"14,723.30  "
FireWrap® Grip Kit Blue,11/06/2020,Sales Receipt,4469,,FireWrap® Grip Kit - Blue,4,24.95  ,99.80  ,"14,823.10  "
FireWrap® Grip Kit Blue,11/08/2020,Sales Receipt,4478,,FireWrap® Grip Kit - Blue,1,24.95  ,24.95  ,"14,848.05  "
FireWrap® Grip Kit Blue,11/15/2020,Sales Receipt,4512,,FireWrap® Grip Kit - Blue,1,24.95  ,24.95  ,"14,873.00  "
FireWrap® Grip Kit Blue,11/15/2020,Sales Receipt,4510,,FireWrap® Grip Kit - Blue,1,24.95  ,24.95  ,"14,897.95  "
FireWrap® Grip Kit Blue,11/16/2020,Sales Receipt,4514,,FireWrap® Grip Kit - Blue,2,24.95  ,49.90  ,"14,947.85  "
FireWrap® Grip Kit Blue,11/17/2020,Sales Receipt,4519,,FireWrap® Grip Kit - Blue,2,24.95  ,49.90  ,"14,997.75  "
FireWrap® Grip Kit Blue,11/18/2020,Sales Receipt,4525,,FireWrap® Grip Kit - Blue,2,24.95  ,49.90  ,"15,047.65  "
FireWrap® Grip Kit Blue,11/22/2020,Sales Receipt,4540,,FireWrap® Grip Kit - Blue,1,24.95  ,24.95  ,"15,072.60  "
FireWrap® Grip Kit Blue,11/25/2020,Sales Receipt,4556,,FireWrap® Grip Kit - Blue,1,24.95  ,24.95  ,"15,097.55  "
FireWrap® Grip Kit Blue,11/29/2020,Sales Receipt,4592,,FireWrap® Grip Kit - Blue,6,24.95  ,149.70  ,"15,247.25  "
FireWrap® Grip Kit Blue,11/30/2020,Sales Receipt,4609,,FireWrap® Grip Kit - Blue,1,24.95  ,24.95  ,"15,272.20  "
FireWrap® Grip Kit Blue,11/30/2020,Sales Receipt,4602,,FireWrap® Grip Kit - Blue,1,24.95  ,24.95  ,"15,297.15  "
FireWrap® Grip Kit Blue,12/05/2020,Sales Receipt,4629,,FireWrap® Grip Kit - Blue,1,24.95  ,24.95  ,"15,322.10  "
FireWrap® Grip Kit Blue,12/13/2020,Sales Receipt,4676,,FireWrap® Grip Kit - Blue,1,24.95  ,24.95  ,"15,347.05  "
FireWrap® Grip Kit Blue,12/18/2020,Sales Receipt,4695,,FireWrap® Grip Kit - Blue,1,24.95  ,24.95  ,"15,372.00  "
FireWrap® Grip Kit Blue,12/18/2020,Invoice,M-121820-006,,FireWrap® Grip Kit Blue,10,18.75  ,187.50  ,"15,559.50  "
FireWrap® Grip Kit Blue,12/18/2020,Invoice,M-121820-005,,FireWrap® Grip Kit Blue,1,18.75  ,18.75  ,"15,578.25  "
FireWrap® Grip Kit Blue,12/18/2020,Sales Receipt,4696,,FireWrap® Grip Kit - Blue,1,24.95  ,24.95  ,"15,603.20  "
FireWrap® Grip Kit Blue,12/19/2020,Sales Receipt,4700,,FireWrap® Grip Kit - Blue,1,24.95  ,24.95  ,"15,628.15  "
FireWrap® Grip Kit Blue,12/21/2020,Sales Receipt,4710,,FireWrap® Grip Kit - Blue,1,24.95  ,24.95  ,"15,653.10  "
FireWrap® Grip Kit Blue,12/29/2020,Invoice,M-122920-003,,FireWrap® Grip Kit Blue,2,24.95  ,49.90  ,"15,703.00  "
FireWrap® Grip Kit Blue,01/17/2021,Sales Receipt,4862,,FireWrap® Grip Kit - Blue,4,24.95  ,99.80  ,"15,802.80  "
FireWrap® Grip Kit Blue,01/19/2021,Invoice,M-011921-020,,FireWrap® Grip Kit Blue,1,18.75  ,18.75  ,"15,821.55  "
FireWrap® Grip Kit Blue,01/19/2021,Invoice,M-011921-005,,FireWrap® Grip Kit Blue,2,18.75  ,37.50  ,"15,859.05  "
FireWrap® Grip Kit Blue,01/19/2021,Invoice,M-011921-023,,FireWrap® Grip Kit Blue,6,24.95  ,149.70  ,"16,008.75  "
FireWrap® Grip Kit Blue,01/19/2021,Invoice,M-011921-007,,FireWrap® Grip Kit Blue,3,18.75  ,56.25  ,"16,065.00  "
FireWrap® Grip Kit Blue,01/19/2021,Invoice,M-011921-016,,FireWrap® Grip Kit Blue,1,18.75  ,18.75  ,"16,083.75  "
FireWrap® Grip Kit Blue,01/19/2021,Invoice,M-011921-010,,FireWrap® Grip Kit Blue,2,18.75  ,37.50  ,"16,121.25  "
FireWrap® Grip Kit Blue,01/19/2021,Invoice,M-011921-008,,FireWrap® Grip Kit Blue,1,18.75  ,18.75  ,"16,140.00  "
FireWrap® Grip Kit Blue,01/25/2021,Sales Receipt,4889,,FireWrap® Grip Kit - Blue,1,24.95  ,24.95  ,"16,164.95  "
FireWrap® Grip Kit Blue,01/26/2021,Sales Receipt,4894,,FireWrap® Grip Kit - Blue,6,24.95  ,149.70  ,"16,314.65  "
FireWrap® Grip Kit Blue,01/26/2021,Invoice,M-012621-007,,FireWrap® Grip Kit Blue,1,18.75  ,18.75  ,"16,333.40  "
FireWrap® Grip Kit Blue,01/26/2021,Invoice,M-012621-002,,FireWrap® Grip Kit Blue,1,18.75  ,18.75  ,"16,352.15  "
FireWrap® Grip Kit Blue,01/26/2021,Invoice,M-012621-009,,FireWrap® Grip Kit Blue,2,18.75  ,37.50  ,"16,389.65  "
FireWrap® Grip Kit Blue,02/06/2021,Sales Receipt,4931,,FireWrap® Grip Kit - Blue,1,24.95  ,24.95  ,"16,414.60  "
FireWrap® Grip Kit Blue,02/07/2021,Sales Receipt,4932,,FireWrap® Grip Kit - Blue,2,24.95  ,49.90  ,"16,464.50  "
FireWrap® Grip Kit Blue,02/13/2021,Sales Receipt,4961,,"FIREWRAP® GRIP KIT
Color: Blue",1,24.99  ,24.99  ,"16,489.49  "
FireWrap® Grip Kit Blue,02/14/2021,Sales Receipt,4964,,"FIREWRAP® GRIP KIT
Color: Blue",1,24.99  ,24.99  ,"16,514.48  "
FireWrap® Grip Kit Blue,02/14/2021,Sales Receipt,4967,,"FIREWRAP® GRIP KIT
Color: Blue",1,24.99  ,24.99  ,"16,539.47  "
FireWrap® Grip Kit Blue,02/16/2021,Invoice,M-021621-021,,FireWrap® Grip Kit Blue,2,18.75  ,37.50  ,"16,576.97  "
FireWrap® Grip Kit Blue,02/16/2021,Sales Receipt,4976,,"FIREWRAP® GRIP KIT
Color: Blue",2,24.99  ,49.98  ,"16,626.95  "
FireWrap® Grip Kit Blue,02/18/2021,Sales Receipt,4984,,"FIREWRAP® GRIP KIT
Color: Blue",1,24.99  ,24.99  ,"16,651.94  "
FireWrap® Grip Kit Blue,02/21/2021,Sales Receipt,5000,,"FIREWRAP® GRIP KIT
Color: Blue",1,24.99  ,24.99  ,"16,676.93  "
FireWrap® Grip Kit Blue,02/22/2021,Sales Receipt,5005,,"FIREWRAP® GRIP KIT
Color: Blue",2,24.99  ,49.98  ,"16,726.91  "
FireWrap® Grip Kit Blue,02/22/2021,Sales Receipt,5008,,"FIREWRAP® GRIP KIT
Color: Blue",1,24.99  ,24.99  ,"16,751.90  "
FireWrap® Grip Kit Blue,02/24/2021,Invoice,M-022421-002,,FireWrap® Grip Kit Blue,1,18.75  ,18.75  ,"16,770.65  "
FireWrap® Grip Kit Blue,02/24/2021,Invoice,M-022421-009,,FireWrap® Grip Kit Blue,5,18.75  ,93.75  ,"16,864.40  "
FireWrap® Grip Kit Blue,02/24/2021,Invoice,M-022421-006,,FireWrap® Grip Kit Blue,1,18.75  ,18.75  ,"16,883.15  "
FireWrap® Grip Kit Blue,02/27/2021,Sales Receipt,5033,,"FIREWRAP® GRIP KIT - Yes, I understand.
Color: Blue",2,24.99  ,49.98  ,"16,933.13  "
FireWrap® Grip Kit Blue,03/08/2021,Sales Receipt,5061,,"FIREWRAP® GRIP KIT - Yes, I understand.
Color: Blue",1,24.99  ,24.99  ,"16,958.12  "
FireWrap® Grip Kit Blue,03/09/2021,Sales Receipt,5062,,"FIREWRAP® GRIP KIT - Yes, I understand.
Color: Blue",1,24.99  ,24.99  ,"16,983.11  "
FireWrap® Grip Kit Blue,03/09/2021,Sales Receipt,5063,,"FIREWRAP® GRIP KIT - Yes, I understand.
Color: Blue",13,24.99  ,324.87  ,"17,307.98  "
FireWrap® Grip Kit Blue,03/12/2021,Invoice,M-031221-008,,FireWrap® Grip Kit Blue,15,24.95  ,374.25  ,"17,682.23  "
FireWrap® Grip Kit Blue,03/19/2021,Sales Receipt,5139,,"FIREWRAP® GRIP KIT - Yes, I understand.
Color: Blue",1,24.99  ,24.99  ,"17,707.22  "
FireWrap® Grip Kit Blue,03/22/2021,Sales Receipt,5160,,"FIREWRAP® GRIP KIT - Yes, I understand.
Color: Blue",4,24.99  ,99.96  ,"17,807.18  "
FireWrap® Grip Kit Blue,03/22/2021,Sales Receipt,5162,,"FIREWRAP® GRIP KIT - Yes, I understand.
Color: Blue",4,24.99  ,99.96  ,"17,907.14  "
FireWrap® Grip Kit Blue,03/24/2021,Sales Receipt,5168,,"FIREWRAP® GRIP KIT - Yes, I understand.
Color: Blue",1,24.99  ,24.99  ,"17,932.13  "
FireWrap® Grip Kit Blue,03/25/2021,Sales Receipt,5177,,"FIREWRAP® GRIP KIT - Yes, I understand.
Color: Blue",10,24.99  ,249.90  ,"18,182.03  "
FireWrap® Grip Kit Blue,03/27/2021,Invoice,M-032721-001,,FireWrap® Grip Kit Blue,4,18.75  ,75.00  ,"18,257.03  "
FireWrap® Grip Kit Blue,03/27/2021,Invoice,M-021921-001,,FireWrap® Grip Kit Blue,2,18.75  ,37.50  ,"18,294.53  "
FireWrap® Grip Kit Blue,03/27/2021,Invoice,M-032721-001,,FireWrap® Grip Kit Blue,5,18.75  ,93.75  ,"18,388.28  "
FireWrap® Grip Kit Blue,03/27/2021,Invoice,M-032721-006,,FireWrap® Grip Kit Blue,6,18.75  ,112.50  ,"18,500.78  "
FireWrap® Grip Kit Blue,03/27/2021,Invoice,M-032721-006,,FireWrap® Grip Kit Blue,6,18.75  ,112.50  ,"18,613.28  "
FireWrap® Grip Kit Blue,03/27/2021,Invoice,M-032721-001,,FireWrap® Grip Kit Blue,4,18.75  ,75.00  ,"18,688.28  "
FireWrap® Grip Kit Blue,03/29/2021,Sales Receipt,5204,,"FIREWRAP® GRIP KIT - Yes, I understand.
Color: Blue",1,24.99  ,24.99  ,"18,713.27  "
FireWrap® Grip Kit Blue,03/30/2021,Invoice,M-033021-005,,FireWrap® Grip Kit Blue,1,18.75  ,18.75  ,"18,732.02  "
FireWrap® Grip Kit Blue,03/30/2021,Invoice,M-033021-008,,FireWrap® Grip Kit Blue,2,18.75  ,37.50  ,"18,769.52  "
FireWrap® Grip Kit Blue,04/02/2021,Sales Receipt,5226,,"FIREWRAP® GRIP KIT - Yes, I understand.
Color: Blue",4,24.99  ,99.96  ,"18,869.48  "
FireWrap® Grip Kit Blue,04/05/2021,Sales Receipt,5242,,"FIREWRAP® GRIP KIT - Yes, I understand.
Color: Blue",1,24.99  ,24.99  ,"18,894.47  "
FireWrap® Grip Kit Blue,04/07/2021,Sales Receipt,5256,,"FIREWRAP® GRIP KIT - Yes, I understand.
Color: Blue",6,24.99  ,149.94  ,"19,044.41  "
FireWrap® Grip Kit Blue,04/07/2021,Invoice,M-040721-003,,FireWrap® Grip Kit Blue,7,18.75  ,131.25  ,"19,175.66  "
FireWrap® Grip Kit Blue,04/13/2021,Sales Receipt,5291,,"FIREWRAP® GRIP KIT - Yes, I understand.
Color: Blue",1,24.99  ,24.99  ,"19,200.65  "
FireWrap® Grip Kit Blue,04/13/2021,Invoice,M-041321-002,,FireWrap® Grip Kit Blue,1,18.75  ,18.75  ,"19,219.40  "
FireWrap® Grip Kit Blue,04/14/2021,Invoice,M-041421-002,,FireWrap® Grip Kit Blue,4,18.75  ,75.00  ,"19,294.40  "
FireWrap® Grip Kit Blue,04/16/2021,Sales Receipt,5308,,"FIREWRAP® GRIP KIT - Yes, I understand.
Color: Blue",6,24.99  ,149.94  ,"19,444.34  "
FireWrap® Grip Kit Blue,04/19/2021,Invoice,M-041921-001,,FireWrap® Grip Kit Blue,14,18.75  ,262.50  ,"19,706.84  "
FireWrap® Grip Kit Blue,04/21/2021,Sales Receipt,5347,,"FIREWRAP® GRIP KIT
Color: Blue",1,24.99  ,24.99  ,"19,731.83  "
FireWrap® Grip Kit Blue,04/23/2021,Invoice,M-042321-005,,FireWrap® Grip Kit Blue,2,24.95  ,49.90  ,"19,781.73  "
FireWrap® Grip Kit Blue,04/24/2021,Sales Receipt,5370,,"FIREWRAP® GRIP KIT
Color: Blue",2,24.99  ,49.98  ,"19,831.71  "
FireWrap® Grip Kit Blue,04/25/2021,Sales Receipt,5385,,"FIREWRAP® GRIP KIT
Color: Blue",2,24.99  ,49.98  ,"19,881.69  "
FireWrap® Grip Kit Blue,05/02/2021,Sales Receipt,5438,,"FIREWRAP® GRIP KIT
Color: Blue",1,24.99  ,24.99  ,"19,906.68  "
FireWrap® Grip Kit Blue,05/03/2021,Invoice,M-050321-003,,FireWrap® Grip Kit Blue,5,18.75  ,93.75  ,"20,000.43  "
FireWrap® Grip Kit Blue,05/06/2021,Sales Receipt,5455,,"FIREWRAP® GRIP KIT
Color: Blue",6,24.99  ,149.94  ,"20,150.37  "
FireWrap® Grip Kit Blue,05/10/2021,Invoice,M-050421-003,,FireWrap® Grip Kit Blue,1,18.75  ,18.75  ,"20,169.12  "
FireWrap® Grip Kit Blue,05/10/2021,Sales Receipt,5478,,"FIREWRAP® GRIP KIT
Color: Blue",1,24.99  ,24.99  ,"20,194.11  "
FireWrap® Grip Kit Blue,05/10/2021,Sales Receipt,5480,,"FIREWRAP® GRIP KIT
Color: Blue",1,24.99  ,24.99  ,"20,219.10  "
FireWrap® Grip Kit Blue,05/14/2021,Invoice,M-051421-001,,FireWrap® Grip Kit Blue,4,18.75  ,75.00  ,"20,294.10  "
FireWrap® Grip Kit Blue,05/17/2021,Sales Receipt,5524,,"FIREWRAP® GRIP KIT
Color: Blue",1,24.99  ,24.99  ,"20,319.09  "
FireWrap® Grip Kit Blue,05/18/2021,Sales Receipt,5531,,"FIREWRAP® GRIP KIT
Color: Blue",2,24.99  ,49.98  ,"20,369.07  "
FireWrap® Grip Kit Blue,05/21/2021,Sales Receipt,5550,,"FIREWRAP® GRIP KIT
Color: Blue",5,24.99  ,124.95  ,"20,494.02  "
FireWrap® Grip Kit Blue,05/23/2021,Sales Receipt,5563,,"FIREWRAP® GRIP KIT
Color: Blue",1,24.99  ,24.99  ,"20,519.01  "
FireWrap® Grip Kit Blue,05/23/2021,Sales Receipt,5559,,"FIREWRAP® GRIP KIT
Color: Blue",1,24.99  ,24.99  ,"20,544.00  "
FireWrap® Grip Kit Blue,05/26/2021,Sales Receipt,5582,,"FIREWRAP® GRIP KIT
Color: Blue",2,24.99  ,49.98  ,"20,593.98  "
FireWrap® Grip Kit Blue,05/27/2021,Sales Receipt,5585,,"FIREWRAP® GRIP KIT
Color: Blue",2,24.99  ,49.98  ,"20,643.96  "
FireWrap® Grip Kit Blue,05/29/2021,Sales Receipt,5593,,"FIREWRAP® GRIP KIT
Color: Blue",1,24.99  ,24.99  ,"20,668.95  "
FireWrap® Grip Kit Blue,05/30/2021,Sales Receipt,5602,,"FIREWRAP® GRIP KIT
Color: Blue",4,24.99  ,99.96  ,"20,768.91  "
FireWrap® Grip Kit Blue,06/03/2021,Invoice,M-060321-002,,FireWrap® Grip Kit Blue,6,18.75  ,112.50  ,"20,881.41  "
FireWrap® Grip Kit Blue,06/06/2021,Sales Receipt,5635,,"FIREWRAP® GRIP KIT
Color: Blue",2,24.99  ,49.98  ,"20,931.39  "
FireWrap® Grip Kit Blue,06/07/2021,Sales Receipt,5639,,"FIREWRAP® GRIP KIT
Color: Blue",2,24.99  ,49.98  ,"20,981.37  "
FireWrap® Grip Kit Blue,06/11/2021,Sales Receipt,5654,,"FIREWRAP® GRIP KIT
Color: Blue",1,24.99  ,24.99  ,"21,006.36  "
FireWrap® Grip Kit Blue,06/15/2021,Sales Receipt,5671,,"FIREWRAP® GRIP KIT
Color: Blue",2,24.99  ,49.98  ,"21,056.34  "
FireWrap® Grip Kit Blue,06/16/2021,Invoice,M-061621-001,,FireWrap® Grip Kit Blue,4,18.75  ,75.00  ,"21,131.34  "
FireWrap® Grip Kit Blue,06/21/2021,Invoice,M-062121-001,,FireWrap® Grip Kit Blue,3,24.99  ,74.97  ,"21,206.31  "
FireWrap® Grip Kit Blue,06/22/2021,Invoice,M-062221-004,,FireWrap® Grip Kit Blue,1,24.99  ,24.99  ,"21,231.30  "
FireWrap® Grip Kit Blue,06/25/2021,Sales Receipt,5709,,"FIREWRAP® GRIP KIT
Color: Blue",1,24.99  ,24.99  ,"21,256.29  "
FireWrap® Grip Kit Blue,06/28/2021,Sales Receipt,5715,,"FIREWRAP® GRIP KIT
Color: Blue",1,24.99  ,24.99  ,"21,281.28  "
FireWrap® Grip Kit Blue,07/10/2021,Sales Receipt,5765,,"FIREWRAP® GRIP KIT
Color: Blue",2,24.99  ,49.98  ,"21,331.26  "
FireWrap® Grip Kit Blue,07/13/2021,Sales Receipt,5776,,"FIREWRAP® GRIP KIT
Color: Blue",1,24.99  ,24.99  ,"21,356.25  "
FireWrap® Grip Kit Blue,07/13/2021,Invoice,M-071321-004,,FireWrap® Grip Kit Blue,10,18.75  ,187.50  ,"21,543.75  "
FireWrap® Grip Kit Blue,07/14/2021,Sales Receipt,5778,,"FIREWRAP® GRIP KIT
Color: Blue",4,24.99  ,99.96  ,"21,643.71  "
FireWrap® Grip Kit Blue,07/15/2021,Invoice,M-052521-004,,FireWrap® Grip Kit Blue,3,18.75  ,56.25  ,"21,699.96  "
FireWrap® Grip Kit Blue,07/29/2021,Sales Receipt,5836,,"FIREWRAP® GRIP KIT
Color: Blue",1,24.99  ,24.99  ,"21,724.95  "
FireWrap® Grip Kit Blue,08/02/2021,Sales Receipt,5849,,"FIREWRAP® GRIP KIT
Color: Blue",1,24.99  ,24.99  ,"21,749.94  "
FireWrap® Grip Kit Blue,08/05/2021,Sales Receipt,5860,,"FIREWRAP® GRIP KIT
Color: Blue",2,24.99  ,49.98  ,"21,799.92  "
FireWrap® Grip Kit Blue,08/09/2021,Sales Receipt,5889,,"FIREWRAP® GRIP KIT
Color: Blue",1,24.99  ,24.99  ,"21,824.91  "
FireWrap® Grip Kit Blue,08/09/2021,Sales Receipt,5886,,"FIREWRAP® GRIP KIT
Color: Blue",4,24.99  ,99.96  ,"21,924.87  "
FireWrap® Grip Kit Blue,08/11/2021,Sales Receipt,5896,,"FIREWRAP® GRIP KIT
Color: Blue",2,24.99  ,49.98  ,"21,974.85  "
FireWrap® Grip Kit Blue,08/16/2021,Sales Receipt,5928,,"FIREWRAP® GRIP KIT
Color: Blue",3,24.99  ,74.97  ,"22,049.82  "
FireWrap® Grip Kit Blue,08/17/2021,Sales Receipt,5930,,"FIREWRAP® GRIP KIT
Color: Blue",8,24.99  ,199.92  ,"22,249.74  "
FireWrap® Grip Kit Blue,08/25/2021,Sales Receipt,5976,,"FIREWRAP® GRIP KIT
Color: Blue",2,24.99  ,49.98  ,"22,299.72  "
FireWrap® Grip Kit Blue,08/26/2021,Sales Receipt,5981,,"FIREWRAP® GRIP KIT
Color: Blue",1,24.99  ,24.99  ,"22,324.71  "
FireWrap® Grip Kit Blue,08/30/2021,Sales Receipt,6002,,"FIREWRAP® GRIP KIT
Color: Blue",1,24.99  ,24.99  ,"22,349.70  "
FireWrap® Grip Kit Blue,08/31/2021,Sales Receipt,6022,,"FIREWRAP® GRIP KIT
Color: Blue",1,24.99  ,24.99  ,"22,374.69  "
FireWrap® Grip Kit Blue,09/01/2021,Sales Receipt,6027,,"FIREWRAP® GRIP KIT
Color: Blue",2,24.99  ,49.98  ,"22,424.67  "
FireWrap® Grip Kit Blue,09/01/2021,Sales Receipt,6028,,"FIREWRAP® GRIP KIT
Color: Blue",2,24.99  ,49.98  ,"22,474.65  "
FireWrap® Grip Kit Blue,09/15/2021,Sales Receipt,6085,,"FIREWRAP® GRIP KIT
Color: Blue",2,24.99  ,49.98  ,"22,524.63  "
FireWrap® Grip Kit Blue,09/15/2021,Sales Receipt,6081,,"FIREWRAP® GRIP KIT
Color: Blue",1,24.99  ,24.99  ,"22,549.62  "
FireWrap® Grip Kit Blue,09/23/2021,Sales Receipt,6142,,"FIREWRAP® GRIP KIT
Color: Blue",1,19.99  ,19.99  ,"22,569.61  "
FireWrap® Grip Kit Blue,09/27/2021,Sales Receipt,6175,,"FIREWRAP® GRIP KIT
Color: Blue",1,19.99  ,19.99  ,"22,589.60  "
FireWrap® Grip Kit Blue,09/30/2021,Sales Receipt,6200,,"FIREWRAP® GRIP KIT
Color: Blue",1,24.95  ,24.95  ,"22,614.55  "
FireWrap® Grip Kit Blue,09/30/2021,Sales Receipt,6207,,"FIREWRAP® GRIP KIT
Color: Blue",1,24.95  ,24.95  ,"22,639.50  "
FireWrap® Grip Kit Blue,10/04/2021,Sales Receipt,6227,,"FIREWRAP® GRIP KIT
Color: Blue",2,24.95  ,49.90  ,"22,689.40  "
FireWrap® Grip Kit Blue,10/06/2021,Sales Receipt,6249,,"FIREWRAP® GRIP KIT
Color: Blue",1,24.95  ,24.95  ,"22,714.35  "
FireWrap® Grip Kit Blue,10/08/2021,Sales Receipt,6262,,"FIREWRAP® GRIP KIT
Color: Blue",6,24.95  ,149.70  ,"22,864.05  "
FireWrap® Grip Kit Blue,10/10/2021,Sales Receipt,6272,,"FIREWRAP® GRIP KIT
Color: Blue",1,24.95  ,24.95  ,"22,889.00  "
FireWrap® Grip Kit Blue,10/10/2021,Sales Receipt,6273,,"FIREWRAP® GRIP KIT
Color: Blue",2,24.95  ,49.90  ,"22,938.90  "
FireWrap® Grip Kit Blue,10/13/2021,Sales Receipt,6291,,"FIREWRAP® GRIP KIT
Color: Blue",3,24.95  ,74.85  ,"23,013.75  "
FireWrap® Grip Kit Blue,10/15/2021,Sales Receipt,6304,,"FIREWRAP® GRIP KIT
Color: Blue",1,24.95  ,24.95  ,"23,038.70  "
FireWrap® Grip Kit Blue,10/16/2021,Sales Receipt,6317,,"FIREWRAP® GRIP KIT
Color: Blue",2,24.95  ,49.90  ,"23,088.60  "
FireWrap® Grip Kit Blue,10/16/2021,Sales Receipt,6312,,"FIREWRAP® GRIP KIT
Color: Blue",1,24.95  ,24.95  ,"23,113.55  "
FireWrap® Grip Kit Blue,10/25/2021,Sales Receipt,6364,,"FIREWRAP® GRIP KIT
Color: Blue",1,24.95  ,24.95  ,"23,138.50  "
FireWrap® Grip Kit Blue,10/27/2021,Sales Receipt,6380,,"FIREWRAP® GRIP KIT
Color: Blue",1,24.95  ,24.95  ,"23,163.45  "
FireWrap® Grip Kit Blue,10/29/2021,Sales Receipt,6390,,"FIREWRAP® GRIP KIT
Color: Blue",1,24.95  ,24.95  ,"23,188.40  "
FireWrap® Grip Kit Blue,11/01/2021,Sales Receipt,6420,,"FIREWRAP® GRIP KIT
Color: Blue",1,24.95  ,24.95  ,"23,213.35  "
FireWrap® Grip Kit Blue,11/02/2021,Sales Receipt,6421,,"FIREWRAP® GRIP KIT
Color: Blue",4,24.95  ,99.80  ,"23,313.15  "
FireWrap® Grip Kit Blue,11/03/2021,Sales Receipt,6424,,"FIREWRAP® GRIP KIT
Color: Blue",1,24.95  ,24.95  ,"23,338.10  "
FireWrap® Grip Kit Blue,11/08/2021,Sales Receipt,6448,,"FIREWRAP® GRIP KIT
Color: Blue",1,24.95  ,24.95  ,"23,363.05  "
FireWrap® Grip Kit Blue,11/09/2021,Sales Receipt,6456,,"FIREWRAP® GRIP KIT
Color: Blue",1,24.95  ,24.95  ,"23,388.00  "
FireWrap® Grip Kit Blue,11/11/2021,Sales Receipt,6480,,"FIREWRAP® GRIP KIT
Color: Blue",1,24.95  ,24.95  ,"23,412.95  "
FireWrap® Grip Kit Blue,11/14/2021,Sales Receipt,6509,,"FIREWRAP® GRIP KIT
Color: Blue",1,24.95  ,24.95  ,"23,437.90  "
FireWrap® Grip Kit Blue,11/14/2021,Sales Receipt,6507,,"FIREWRAP® GRIP KIT
Color: Blue",1,24.95  ,24.95  ,"23,462.85  "
FireWrap® Grip Kit Blue,11/15/2021,Sales Receipt,6515,,"FIREWRAP® GRIP KIT
Color: Blue",2,24.95  ,49.90  ,"23,512.75  "
FireWrap® Grip Kit Blue,11/15/2021,Sales Receipt,6518,,"FIREWRAP® GRIP KIT
Color: Blue",1,24.95  ,24.95  ,"23,537.70  "
FireWrap® Grip Kit Blue,11/16/2021,Sales Receipt,6526,,"FIREWRAP® GRIP KIT
Color: Blue",1,24.95  ,24.95  ,"23,562.65  "
FireWrap® Grip Kit Blue,11/23/2021,Sales Receipt,6568,,"FIREWRAP® GRIP KIT
Color: Blue",1,19.99  ,19.99  ,"23,582.64  "
FireWrap® Grip Kit Blue,11/26/2021,Sales Receipt,6596,,"FIREWRAP® GRIP KIT
Color: Blue",1,19.99  ,19.99  ,"23,602.63  "
FireWrap® Grip Kit Blue,11/27/2021,Sales Receipt,6606,,"FIREWRAP® GRIP KIT
Color: Blue",1,19.99  ,19.99  ,"23,622.62  "
FireWrap® Grip Kit Blue,11/29/2021,Sales Receipt,6620,,"FIREWRAP® GRIP KIT
Color: Blue",1,19.99  ,19.99  ,"23,642.61  "
FireWrap® Grip Kit Blue,12/01/2021,Sales Receipt,6638,,"FIREWRAP® GRIP KIT
Color: Blue",1,19.99  ,19.99  ,"23,662.60  "
FireWrap® Grip Kit Blue,12/01/2021,Sales Receipt,6640,,"FIREWRAP® GRIP KIT
Color: Blue",3,19.99  ,59.97  ,"23,722.57  "
FireWrap® Grip Kit Blue,12/01/2021,Sales Receipt,6639,,"FIREWRAP® GRIP KIT
Color: Blue",20,19.99  ,399.80  ,"24,122.37  "
FireWrap® Grip Kit Blue,12/01/2021,Sales Receipt,6641,,"FIREWRAP® GRIP KIT
Color: Blue",1,19.99  ,19.99  ,"24,142.36  "
FireWrap® Grip Kit Blue,12/03/2021,Sales Receipt,6658,,"FIREWRAP® GRIP KIT
Color: Blue",1,19.99  ,19.99  ,"24,162.35  "
FireWrap® Grip Kit Blue,12/03/2021,Sales Receipt,6656,,"FIREWRAP® GRIP KIT
Color: Blue",1,19.99  ,19.99  ,"24,182.34  "
FireWrap® Grip Kit Blue,12/08/2021,Sales Receipt,6702,,"FIREWRAP® GRIP KIT
Color: Blue",1,24.95  ,24.95  ,"24,207.29  "
FireWrap® Grip Kit Blue,12/10/2021,Sales Receipt,6713,,"FIREWRAP® GRIP KIT
Color: Blue",1,24.95  ,24.95  ,"24,232.24  "
FireWrap® Grip Kit Blue,12/13/2021,Sales Receipt,6732,,"FIREWRAP® GRIP KIT
Color: Blue",1,24.95  ,24.95  ,"24,257.19  "
FireWrap® Grip Kit Blue,12/13/2021,Sales Receipt,6738,,"FIREWRAP® GRIP KIT
Color: Blue",1,24.95  ,24.95  ,"24,282.14  "
FireWrap® Grip Kit Blue,12/16/2021,Sales Receipt,6753,,"FIREWRAP® GRIP KIT
Color: Blue",8,24.95  ,199.60  ,"24,481.74  "
FireWrap® Grip Kit Blue,12/18/2021,Sales Receipt,6772,,"FIREWRAP® GRIP KIT
Color: Blue",1,24.95  ,24.95  ,"24,506.69  "
FireWrap® Grip Kit Blue,12/25/2021,Sales Receipt,6825,,"FIREWRAP® GRIP KIT
Color: Blue",1,24.95  ,24.95  ,"24,531.64  "
FireWrap® Grip Kit Blue,12/30/2021,Sales Receipt,6863,,"FIREWRAP® GRIP KIT
Color: Blue",4,24.95  ,99.80  ,"24,631.44  "
FireWrap® Grip Kit Blue,12/30/2021,Sales Receipt,6861,,"FIREWRAP® GRIP KIT
Color: Blue",1,24.95  ,24.95  ,"24,656.39  "
FireWrap® Grip Kit Blue,01/03/2022,Sales Receipt,6902,,"FIREWRAP® GRIP KIT
Color: Blue",4,24.95  ,99.80  ,"24,756.19  "
FireWrap® Grip Kit Blue,01/10/2022,Sales Receipt,6971,,"FIREWRAP® GRIP KIT
Color: Blue",1,24.95  ,24.95  ,"24,781.14  "
FireWrap® Grip Kit Blue,01/11/2022,Sales Receipt,6982,,"FIREWRAP® GRIP KIT
Color: Blue",5,24.95  ,124.75  ,"24,905.89  "
FireWrap® Grip Kit Blue,01/11/2022,Sales Receipt,6981,,"FIREWRAP® GRIP KIT
Color: Blue",4,24.95  ,99.80  ,"25,005.69  "
FireWrap® Grip Kit Blue,01/13/2022,Sales Receipt,6996,,"FIREWRAP® GRIP KIT
Color: Blue",1,24.95  ,24.95  ,"25,030.64  "
FireWrap® Grip Kit Blue,01/14/2022,Sales Receipt,7006,,"FIREWRAP® GRIP KIT
Color: Blue",2,24.95  ,49.90  ,"25,080.54  "
FireWrap® Grip Kit Blue,01/21/2022,Sales Receipt,7058,,"FIREWRAP® GRIP KIT
Color: Blue",1,24.95  ,24.95  ,"25,105.49  "
FireWrap® Grip Kit Blue,01/21/2022,Sales Receipt,7060,,"FIREWRAP® GRIP KIT
Color: Blue",3,24.95  ,74.85  ,"25,180.34  "
FireWrap® Grip Kit Blue,01/24/2022,Sales Receipt,7076,,"FIREWRAP® GRIP KIT
Color: Blue",2,24.95  ,49.90  ,"25,230.24  "
FireWrap® Grip Kit Blue,01/24/2022,Sales Receipt,7082,,"FIREWRAP® GRIP KIT
Color: Blue",1,24.95  ,24.95  ,"25,255.19  "
FireWrap® Grip Kit Blue,01/28/2022,Sales Receipt,7135,,"FIREWRAP® GRIP KIT
Color: Blue",5,24.95  ,124.75  ,"25,379.94  "
FireWrap® Grip Kit Blue,01/29/2022,Sales Receipt,7151,,"FIREWRAP® GRIP KIT
Color: Blue",2,24.95  ,49.90  ,"25,429.84  "
FireWrap® Grip Kit Blue,02/01/2022,Sales Receipt,7174,,"FIREWRAP® GRIP KIT
Color: Blue",2,24.95  ,49.90  ,"25,479.74  "
FireWrap® Grip Kit Blue,02/03/2022,Sales Receipt,7186,,"FIREWRAP® GRIP KIT
Color: Blue",1,27.95  ,27.95  ,"25,507.69  "
FireWrap® Grip Kit Blue,02/04/2022,Sales Receipt,7193,,"FIREWRAP® GRIP KIT
Color: Blue",1,27.95  ,27.95  ,"25,535.64  "
FireWrap® Grip Kit Blue,02/07/2022,Sales Receipt,7222,,"FIREWRAP® GRIP KIT
Color: Blue",1,27.95  ,27.95  ,"25,563.59  "
FireWrap® Grip Kit Blue,02/07/2022,Sales Receipt,7217,,"FIREWRAP® GRIP KIT
Color: Blue",7,27.95  ,195.65  ,"25,759.24  "
FireWrap® Grip Kit Blue,02/09/2022,Sales Receipt,7247,,"FIREWRAP® GRIP KIT
Color: Blue",5,27.95  ,139.75  ,"25,898.99  "
FireWrap® Grip Kit Blue,02/16/2022,Sales Receipt,7299,,"FIREWRAP® GRIP KIT
Color: Blue",1,27.95  ,27.95  ,"25,926.94  "
FireWrap® Grip Kit Blue,02/18/2022,Sales Receipt,7312,,"FIREWRAP® GRIP KIT
Color: Blue",1,27.95  ,27.95  ,"25,954.89  "
FireWrap® Grip Kit Blue,02/18/2022,Sales Receipt,7316,,"FIREWRAP® GRIP KIT
Color: Blue",1,27.95  ,27.95  ,"25,982.84  "
FireWrap® Grip Kit Blue,02/23/2022,Sales Receipt,7371,,"FIREWRAP® GRIP KIT
Color: Blue",1,27.95  ,27.95  ,"26,010.79  "
FireWrap® Grip Kit Blue,02/27/2022,Sales Receipt,7412,,"FIREWRAP® GRIP KIT
Color: Blue",1,27.95  ,27.95  ,"26,038.74  "
FireWrap® Grip Kit Blue,02/27/2022,Sales Receipt,7411,,"FIREWRAP® GRIP KIT
Color: Blue",3,27.95  ,83.85  ,"26,122.59  "
FireWrap® Grip Kit Blue,02/28/2022,Sales Receipt,7430,,"FIREWRAP® GRIP KIT
Color: Blue",2,27.95  ,55.90  ,"26,178.49  "
FireWrap® Grip Kit Blue,03/03/2022,Sales Receipt,7460,,"FIREWRAP® GRIP KIT
Color: Blue",1,27.95  ,27.95  ,"26,206.44  "
FireWrap® Grip Kit Blue,03/05/2022,Sales Receipt,7473,,"FIREWRAP® GRIP KIT
Color: Blue",8,27.95  ,223.60  ,"26,430.04  "
FireWrap® Grip Kit Blue,03/13/2022,Sales Receipt,7529,,"FIREWRAP® GRIP KIT
Color: Blue",1,27.95  ,27.95  ,"26,457.99  "
FireWrap® Grip Kit Blue,03/14/2022,Sales Receipt,7536,,"FIREWRAP® GRIP KIT
Color: Blue",1,27.95  ,27.95  ,"26,485.94  "
FireWrap® Grip Kit Blue,03/17/2022,Sales Receipt,7553,,"FIREWRAP® GRIP KIT
Color: Blue",2,27.95  ,55.90  ,"26,541.84  "
FireWrap® Grip Kit Blue,03/19/2022,Sales Receipt,7566,,"FIREWRAP® GRIP KIT
Color: Blue",1,27.95  ,27.95  ,"26,569.79  "
FireWrap® Grip Kit Blue,03/20/2022,Sales Receipt,7575,,"FIREWRAP® GRIP KIT
Color: Blue",1,27.95  ,27.95  ,"26,597.74  "
FireWrap® Grip Kit Blue,03/22/2022,Sales Receipt,7598,,"FIREWRAP® GRIP KIT
Color: Blue",4,27.95  ,111.80  ,"26,709.54  "
FireWrap® Grip Kit Blue,03/28/2022,Sales Receipt,7639,,"FIREWRAP® GRIP KIT
Color: Blue",1,27.95  ,27.95  ,"26,737.49  "
FireWrap® Grip Kit Blue,03/29/2022,Sales Receipt,7651,,"FIREWRAP® GRIP KIT
Color: Blue",1,27.95  ,27.95  ,"26,765.44  "
FireWrap® Grip Kit Blue,03/30/2022,Sales Receipt,7657,,"FIREWRAP® GRIP KIT
Color: Blue",1,27.95  ,27.95  ,"26,793.39  "
FireWrap® Grip Kit Blue,04/11/2022,Sales Receipt,7735,,"FIREWRAP® GRIP KIT
Color: Blue",2,27.95  ,55.90  ,"26,849.29  "
FireWrap® Grip Kit Blue,04/16/2022,Sales Receipt,7766,,"FIREWRAP® GRIP KIT
Color: Blue",1,27.95  ,27.95  ,"26,877.24  "
FireWrap® Grip Kit Blue,04/18/2022,Sales Receipt,7771,,"FIREWRAP® GRIP KIT
Color: Blue",1,27.95  ,27.95  ,"26,905.19  "
FireWrap® Grip Kit Blue,04/22/2022,Sales Receipt,7797,,"FIREWRAP® GRIP KIT
Color: Blue",1,27.95  ,27.95  ,"26,933.14  "
FireWrap® Grip Kit Blue,04/25/2022,Sales Receipt,7813,,"FIREWRAP® GRIP KIT
Color: Blue",1,27.95  ,27.95  ,"26,961.09  "
FireWrap® Grip Kit Blue,04/27/2022,Sales Receipt,7825,,"FIREWRAP® GRIP KIT
Color: Blue",2,27.95  ,55.90  ,"27,016.99  "
FireWrap® Grip Kit Blue,04/29/2022,Sales Receipt,7842,,"FIREWRAP® GRIP KIT
Color: Blue",2,22.95  ,45.90  ,"27,062.89  "
FireWrap® Grip Kit Blue,04/29/2022,Sales Receipt,7841,,"FIREWRAP® GRIP KIT
Color: Blue",1,22.95  ,22.95  ,"27,085.84  "
FireWrap® Grip Kit Blue,05/02/2022,Sales Receipt,7877,,"FIREWRAP® GRIP KIT
Color: Blue",1,22.95  ,22.95  ,"27,108.79  "
FireWrap® Grip Kit Blue,05/03/2022,Sales Receipt,7892,,"FIREWRAP® GRIP KIT
Color: Blue",2,22.95  ,45.90  ,"27,154.69  "
FireWrap® Grip Kit Blue,05/03/2022,Sales Receipt,7884,,"FIREWRAP® GRIP KIT
Color: Blue",1,22.95  ,22.95  ,"27,177.64  "
FireWrap® Grip Kit Blue,05/03/2022,Sales Receipt,7889,,"FIREWRAP® GRIP KIT
Color: Blue",1,22.95  ,22.95  ,"27,200.59  "
FireWrap® Grip Kit Blue,05/03/2022,Sales Receipt,7888,,"FIREWRAP® GRIP KIT
Color: Blue",2,22.95  ,45.90  ,"27,246.49  "
FireWrap® Grip Kit Blue,05/04/2022,Sales Receipt,7902,,"FIREWRAP® GRIP KIT
Color: Blue",16,22.95  ,367.20  ,"27,613.69  "
FireWrap® Grip Kit Blue,05/04/2022,Sales Receipt,7899,,"FIREWRAP® GRIP KIT
Color: Blue",2,22.95  ,45.90  ,"27,659.59  "
FireWrap® Grip Kit Blue,05/06/2022,Sales Receipt,7912,,"FIREWRAP® GRIP KIT
Color: Blue",2,22.95  ,45.90  ,"27,705.49  "
FireWrap® Grip Kit Blue,05/07/2022,Sales Receipt,7918,,"FIREWRAP® GRIP KIT
Color: Blue",1,27.95  ,27.95  ,"27,733.44  "
FireWrap® Grip Kit Blue,05/16/2022,Sales Receipt,7959,,"FIREWRAP® GRIP KIT
Color: Blue",1,27.95  ,27.95  ,"27,761.39  "
FireWrap® Grip Kit Blue,05/17/2022,Sales Receipt,7965,,"FIREWRAP® GRIP KIT
Color: Blue",1,27.95  ,27.95  ,"27,789.34  "
FireWrap® Grip Kit Blue,05/24/2022,Sales Receipt,7996,,"FIREWRAP® GRIP KIT
Color: Blue",4,27.95  ,111.80  ,"27,901.14  "
FireWrap® Grip Kit Blue,05/25/2022,Sales Receipt,7999,,"FIREWRAP® GRIP KIT
Color: Blue",1,27.95  ,27.95  ,"27,929.09  "
FireWrap® Grip Kit Blue,06/01/2022,Sales Receipt,8032,,"FIREWRAP® GRIP KIT
Color: Blue",1,27.95  ,27.95  ,"27,957.04  "
FireWrap® Grip Kit Blue,06/02/2022,Sales Receipt,8042,,"FIREWRAP® GRIP KIT
Color: Blue",4,27.95  ,111.80  ,"28,068.84  "
FireWrap® Grip Kit Blue,06/05/2022,Sales Receipt,8055,,"FIREWRAP® GRIP KIT
Color: Blue",1,27.95  ,27.95  ,"28,096.79  "
FireWrap® Grip Kit Blue,06/08/2022,Sales Receipt,8077,,"FIREWRAP® GRIP KIT
Color: Blue",2,27.95  ,55.90  ,"28,152.69  "
FireWrap® Grip Kit Blue,06/10/2022,Sales Receipt,8095,,"FIREWRAP® GRIP KIT
Color: Blue",1,27.95  ,27.95  ,"28,180.64  "
FireWrap® Grip Kit Blue,06/25/2022,Sales Receipt,8176,,"FIREWRAP® GRIP KIT
Color: Blue",1,27.95  ,27.95  ,"28,208.59  "
FireWrap® Grip Kit Blue,06/26/2022,Sales Receipt,8178,,"FIREWRAP® GRIP KIT
Color: Blue",1,27.95  ,27.95  ,"28,236.54  "
FireWrap® Grip Kit Blue,07/01/2022,Sales Receipt,8221,,"FIREWRAP® GRIP KIT
Color: Blue",1,27.95  ,27.95  ,"28,264.49  "
FireWrap® Grip Kit Blue,07/03/2022,Sales Receipt,8235,,"FIREWRAP® GRIP KIT
Color: Blue",2,27.95  ,55.90  ,"28,320.39  "
FireWrap® Grip Kit Blue,07/08/2022,Sales Receipt,8268,,"FIREWRAP® GRIP KIT
Color: Blue",1,27.95  ,27.95  ,"28,348.34  "
FireWrap® Grip Kit Blue,07/13/2022,Sales Receipt,8291,,"FIREWRAP® GRIP KIT
Color: Blue",1,27.95  ,27.95  ,"28,376.29  "
FireWrap® Grip Kit Blue,07/14/2022,Sales Receipt,8300,,"FIREWRAP® GRIP KIT
Color: Blue",1,27.95  ,27.95  ,"28,404.24  "
FireWrap® Grip Kit Blue,07/14/2022,Sales Receipt,8297,,"FIREWRAP® GRIP KIT
Color: Blue",2,27.95  ,55.90  ,"28,460.14  "
FireWrap® Grip Kit Blue,07/15/2022,Sales Receipt,8309,,"FIREWRAP® GRIP KIT
Color: Blue",1,27.95  ,27.95  ,"28,488.09  "
FireWrap® Grip Kit Blue,07/16/2022,Sales Receipt,8313,,"FIREWRAP® GRIP KIT
Color: Blue",1,27.95  ,27.95  ,"28,516.04  "
FireWrap® Grip Kit Blue,07/19/2022,Sales Receipt,8323,,"FIREWRAP® GRIP KIT
Color: Blue",4,27.95  ,111.80  ,"28,627.84  "
FireWrap® Grip Kit Blue,07/22/2022,Sales Receipt,8339,,"FIREWRAP® GRIP KIT
Color: Blue",2,27.95  ,55.90  ,"28,683.74  "
FireWrap® Grip Kit Blue,07/23/2022,Sales Receipt,8347,,"FIREWRAP® GRIP KIT
Color: Blue",1,27.95  ,27.95  ,"28,711.69  "
FireWrap® Grip Kit Blue,07/25/2022,Sales Receipt,8358,,"FIREWRAP® GRIP KIT
Color: Blue",1,27.95  ,27.95  ,"28,739.64  "
FireWrap® Grip Kit Blue,07/26/2022,Sales Receipt,8369,,"FIREWRAP® GRIP KIT
Color: Blue",1,27.95  ,27.95  ,"28,767.59  "
FireWrap® Grip Kit Blue,08/04/2022,Sales Receipt,8429,,"FIREWRAP® GRIP KIT
Color: Blue",1,27.95  ,27.95  ,"28,795.54  "
FireWrap® Grip Kit Blue,08/14/2022,Sales Receipt,8485,,"FIREWRAP® GRIP KIT
Color: Blue",1,27.95  ,27.95  ,"28,823.49  "
FireWrap® Grip Kit Blue,08/17/2022,Sales Receipt,8499,,"FIREWRAP® GRIP KIT
Color: Blue",5,27.95  ,139.75  ,"28,963.24  "
FireWrap® Grip Kit Blue,08/21/2022,Sales Receipt,8531,,"FIREWRAP® GRIP KIT
Color: Blue",1,27.95  ,27.95  ,"28,991.19  "
FireWrap® Grip Kit Blue,08/25/2022,Sales Receipt,8552,,"FIREWRAP® GRIP KIT
Color: Blue",4,27.95  ,111.80  ,"29,102.99  "
FireWrap® Grip Kit Blue,08/27/2022,Sales Receipt,8565,,"FIREWRAP® GRIP KIT
Color: Blue",1,27.95  ,27.95  ,"29,130.94  "
FireWrap® Grip Kit Blue,08/30/2022,Sales Receipt,8589,,"FIREWRAP® GRIP KIT
Color: Blue",4,27.95  ,111.80  ,"29,242.74  "
FireWrap® Grip Kit Blue,08/30/2022,Sales Receipt,8588,,"FIREWRAP® GRIP KIT
Color: Blue",1,27.95  ,27.95  ,"29,270.69  "
FireWrap® Grip Kit Blue,09/13/2022,Sales Receipt,8680,,"FIREWRAP® GRIP KIT
Color: Blue",1,27.95  ,27.95  ,"29,298.64  "
FireWrap® Grip Kit Blue,09/16/2022,Sales Receipt,8695,,"FIREWRAP® GRIP KIT
Color: Blue",1,27.95  ,27.95  ,"29,326.59  "
FireWrap® Grip Kit Blue,09/20/2022,Sales Receipt,8720,,"FIREWRAP® GRIP KIT
Color: Blue",1,27.95  ,27.95  ,"29,354.54  "
FireWrap® Grip Kit Blue,09/29/2022,Sales Receipt,8799,,"FIREWRAP® GRIP KIT
Color: Blue",5,27.95  ,139.75  ,"29,494.29  "
FireWrap® Grip Kit Blue,09/29/2022,Sales Receipt,8807,,"FIREWRAP® GRIP KIT
Color: Blue",1,27.95  ,27.95  ,"29,522.24  "
FireWrap® Grip Kit Blue,10/01/2022,Sales Receipt,8818,,"FIREWRAP® GRIP KIT
Color: Blue",3,27.95  ,83.85  ,"29,606.09  "
FireWrap® Grip Kit Blue,10/01/2022,Sales Receipt,8817,,"FIREWRAP® GRIP KIT
Color: Blue",1,27.95  ,27.95  ,"29,634.04  "
FireWrap® Grip Kit Blue,10/02/2022,Sales Receipt,8825,,"FIREWRAP® GRIP KIT
Color: Blue",1,27.95  ,27.95  ,"29,661.99  "
FireWrap® Grip Kit Blue,10/06/2022,Sales Receipt,8850,,"FIREWRAP® GRIP KIT
Color: Blue",1,27.95  ,27.95  ,"29,689.94  "
FireWrap® Grip Kit Blue,10/07/2022,Sales Receipt,8854,,"FIREWRAP® GRIP KIT
Color: Blue",1,27.95  ,27.95  ,"29,717.89  "
FireWrap® Grip Kit Blue,10/11/2022,Sales Receipt,8884,,"FIREWRAP® GRIP KIT
Color: Blue",2,27.95  ,55.90  ,"29,773.79  "
FireWrap® Grip Kit Blue,10/14/2022,Sales Receipt,8910,,"FIREWRAP® GRIP KIT
Color: Blue",7,27.95  ,195.65  ,"29,969.44  "
FireWrap® Grip Kit Blue,10/15/2022,Sales Receipt,8913,,"FIREWRAP® GRIP KIT
Color: Blue",1,27.95  ,27.95  ,"29,997.39  "
FireWrap® Grip Kit Blue,10/19/2022,Sales Receipt,8934,,"FIREWRAP® GRIP KIT
Color: Blue",1,27.95  ,27.95  ,"30,025.34  "
FireWrap® Grip Kit Blue,10/19/2022,Sales Receipt,8938,,"FIREWRAP® GRIP KIT
Color: Blue",1,27.95  ,27.95  ,"30,053.29  "
FireWrap® Grip Kit Blue,10/20/2022,Sales Receipt,8946,,"FIREWRAP® GRIP KIT
Color: Blue",2,27.95  ,55.90  ,"30,109.19  "
FireWrap® Grip Kit Blue,10/21/2022,Sales Receipt,8959,,"FIREWRAP® GRIP KIT
Color: Blue",1,27.95  ,27.95  ,"30,137.14  "
FireWrap® Grip Kit Blue,11/03/2022,Sales Receipt,9024,,"FIREWRAP® GRIP KIT
Color: Blue",5,27.95  ,139.75  ,"30,276.89  "
FireWrap® Grip Kit Blue,11/05/2022,Sales Receipt,M-111-3066546-1589856,,FireWrap® Grip Kit - Blue,2,28.95  ,57.90  ,"30,334.79  "
FireWrap® Grip Kit Blue,11/08/2022,Sales Receipt,9047,,"FIREWRAP® GRIP KIT
Color: Blue",1,27.95  ,27.95  ,"30,362.74  "
FireWrap® Grip Kit Blue,11/09/2022,Sales Receipt,9054,,"FIREWRAP® GRIP KIT
Color: Blue",1,27.95  ,27.95  ,"30,390.69  "
FireWrap® Grip Kit Blue,11/14/2022,Sales Receipt,9080,,"FIREWRAP® GRIP KIT
Color: Blue",2,27.95  ,55.90  ,"30,446.59  "
FireWrap® Grip Kit Blue,11/14/2022,Sales Receipt,M-112-4240856-6866630,,FireWrap® Grip Kit - Blue,5,28.95  ,144.75  ,"30,591.34  "
FireWrap® Grip Kit Blue,11/15/2022,Sales Receipt,9091,,"FIREWRAP® GRIP KIT
Color: Blue",1,27.95  ,27.95  ,"30,619.29  "
FireWrap® Grip Kit Blue,11/16/2022,Sales Receipt,9100,,"FIREWRAP® GRIP KIT
Color: Blue",1,27.95  ,27.95  ,"30,647.24  "
FireWrap® Grip Kit Blue,11/17/2022,Sales Receipt,9108,,"FIREWRAP® GRIP KIT
Color: Blue",1,27.95  ,27.95  ,"30,675.19  "
FireWrap® Grip Kit Blue,11/19/2022,Sales Receipt,M-112-3516771-9665832,,FireWrap® Grip Kit - Blue,1,28.95  ,28.95  ,"30,704.14  "
FireWrap® Grip Kit Blue,11/21/2022,Sales Receipt,M-112-5095260-4700214,,FireWrap® Grip Kit - Blue,1,28.95  ,28.95  ,"30,733.09  "
FireWrap® Grip Kit Blue,11/23/2022,Sales Receipt,M-114-0915317-9793852,,FireWrap® Grip Kit - Blue,1,28.95  ,28.95  ,"30,762.04  "
FireWrap® Grip Kit Blue,11/24/2022,Sales Receipt,9154,,"FIREWRAP® GRIP KIT
Color: Blue",1,27.95  ,27.95  ,"30,789.99  "
FireWrap® Grip Kit Blue,11/26/2022,Sales Receipt,M-114-5495121-1574656,,FireWrap® Grip Kit - Blue,1,28.95  ,28.95  ,"30,818.94  "
FireWrap® Grip Kit Blue,11/28/2022,Sales Receipt,9200,,"FIREWRAP® GRIP KIT
Color: Blue",6,27.95  ,167.70  ,"30,986.64  "
FireWrap® Grip Kit Blue,11/28/2022,Sales Receipt,9201,,"FIREWRAP® GRIP KIT
Color: Blue",1,27.95  ,27.95  ,"31,014.59  "
FireWrap® Grip Kit Blue,11/28/2022,Sales Receipt,9197,,"FIREWRAP® GRIP KIT
Color: Blue",5,27.95  ,139.75  ,"31,154.34  "
FireWrap® Grip Kit Blue,11/29/2022,Sales Receipt,9214,,"FIREWRAP® GRIP KIT
Color: Blue",10,27.95  ,279.50  ,"31,433.84  "
FireWrap® Grip Kit Blue,11/29/2022,Sales Receipt,M-112-3092822-8317857,,FireWrap® Grip Kit - Blue,1,28.95  ,28.95  ,"31,462.79  "
FireWrap® Grip Kit Blue,12/03/2022,Sales Receipt,M-113-4589797-2093803,,FireWrap® Grip Kit - Blue,1,28.95  ,28.95  ,"31,491.74  "
FireWrap® Grip Kit Blue,12/04/2022,Sales Receipt,M-112-6890437-2428258,,FireWrap® Grip Kit - Blue,1,28.95  ,28.95  ,"31,520.69  "
FireWrap® Grip Kit Blue,12/07/2022,Sales Receipt,9266,,"FIREWRAP® GRIP KIT
Color: Blue",1,27.95  ,27.95  ,"31,548.64  "
FireWrap® Grip Kit Blue,12/08/2022,Sales Receipt,9281,,"FIREWRAP® GRIP KIT
Color: Blue",1,27.95  ,27.95  ,"31,576.59  "
FireWrap® Grip Kit Blue,12/08/2022,Sales Receipt,9277,,"FIREWRAP® GRIP KIT
Color: Blue",1,27.95  ,27.95  ,"31,604.54  "
FireWrap® Grip Kit Blue,12/09/2022,Sales Receipt,M-114-4445822-7277829,,FireWrap® Grip Kit - Blue,1,28.95  ,28.95  ,"31,633.49  "
FireWrap® Grip Kit Blue,12/09/2022,Sales Receipt,M-113-2852491-0225865,,FireWrap® Grip Kit - Blue,2,28.95  ,57.90  ,"31,691.39  "
FireWrap® Grip Kit Blue,12/10/2022,Sales Receipt,M-114-2223874-3173806,,FireWrap® Grip Kit - Blue,1,28.95  ,28.95  ,"31,720.34  "
FireWrap® Grip Kit Blue,12/13/2022,Sales Receipt,M-113-7447283-7259462,,FireWrap® Grip Kit - Blue,1,28.95  ,28.95  ,"31,749.29  "
FireWrap® Grip Kit Blue,12/14/2022,Sales Receipt,9324,,"FIREWRAP® GRIP KIT
Color: Blue",1,27.95  ,27.95  ,"31,777.24  "
FireWrap® Grip Kit Blue,12/15/2022,Sales Receipt,9329,,"FIREWRAP® GRIP KIT
Color: Blue",1,27.95  ,27.95  ,"31,805.19  "
FireWrap® Grip Kit Blue,12/15/2022,Sales Receipt,9334,,"FIREWRAP® GRIP KIT
Color: Blue",1,27.95  ,27.95  ,"31,833.14  "
FireWrap® Grip Kit Blue,12/15/2022,Sales Receipt,M-111-4799516-8151416,,FireWrap® Grip Kit - Blue,10,28.95  ,289.50  ,"32,122.64  "
FireWrap® Grip Kit Blue,12/16/2022,Sales Receipt,9338,,"FIREWRAP® GRIP KIT
Color: Blue",2,27.95  ,55.90  ,"32,178.54  "
FireWrap® Grip Kit Blue,12/18/2022,Sales Receipt,M-113-0999546-2170647,,FireWrap® Grip Kit - Blue,1,28.95  ,28.95  ,"32,207.49  "
FireWrap® Grip Kit Blue,12/19/2022,Sales Receipt,9367,,"FIREWRAP® GRIP KIT
Color: Blue",25,27.95  ,698.75  ,"32,906.24  "
FireWrap® Grip Kit Blue,12/19/2022,Sales Receipt,9360,,"FIREWRAP® GRIP KIT
Color: Blue",1,27.95  ,27.95  ,"32,934.19  "
FireWrap® Grip Kit Blue,12/20/2022,Sales Receipt,M-111-6271125-5521826,,FireWrap® Grip Kit - Blue,1,28.95  ,28.95  ,"32,963.14  "
FireWrap® Grip Kit Blue,12/22/2022,Sales Receipt,9378,,"FIREWRAP® GRIP KIT
Color: Blue",1,27.95  ,27.95  ,"32,991.09  "
FireWrap® Grip Kit Blue,12/26/2022,Sales Receipt,M-112-1025370-1010614,,FireWrap® Grip Kit - Blue,1,28.95  ,28.95  ,"33,020.04  "
FireWrap® Grip Kit Blue,12/27/2022,Sales Receipt,M-112-5851199-1589055,,FireWrap® Grip Kit - Blue,1,28.95  ,28.95  ,"33,048.99  "
FireWrap® Grip Kit Blue,12/29/2022,Sales Receipt,M-113-5991599-0143433,,FireWrap® Grip Kit - Blue,1,28.95  ,28.95  ,"33,077.94  "
FireWrap® Grip Kit Blue,12/30/2022,Sales Receipt,9432,,"FIREWRAP® GRIP KIT
Color: Blue",1,27.95  ,27.95  ,"33,105.89  "
FireWrap® Grip Kit Blue,12/30/2022,Sales Receipt,M-111-6150005-1813862,,FireWrap® Grip Kit - Blue,1,28.95  ,28.95  ,"33,134.84  "
FireWrap® Grip Kit Blue,12/31/2022,Sales Receipt,M-112-5015319-3954634,,FireWrap® Grip Kit - Blue,2,28.95  ,57.90  ,"33,192.74  "
FireWrap® Grip Kit Blue,01/01/2023,Sales Receipt,9441,,"FIREWRAP® GRIP KIT
Color: Blue",2,27.95  ,55.90  ,"33,248.64  "
FireWrap® Grip Kit Blue,01/01/2023,Sales Receipt,9439,,"FIREWRAP® GRIP KIT
Color: Blue",1,27.95  ,27.95  ,"33,276.59  "
FireWrap® Grip Kit Blue,01/05/2023,Sales Receipt,M-112-8291743-7834628,,FireWrap® Grip Kit - Blue,1,28.95  ,28.95  ,"33,305.54  "
FireWrap® Grip Kit Blue,01/05/2023,Sales Receipt,M-112-8791795-0684238,,FireWrap® Grip Kit - Blue,1,28.95  ,28.95  ,"33,334.49  "
Total for FireWrap® Grip Kit Blue,,,,,,1261,,"$	33,334.49  ",
FireWrap® Grip Kit GLOW - Aqua,,,,,,,,,
FireWrap® Grip Kit GLOW - Aqua,03/23/2018,Sales Receipt,#1391,,FireWrap  Grip Kit - Pre-Order,1,37.95  ,37.95  ,37.95  
FireWrap® Grip Kit GLOW - Aqua,03/24/2018,Sales Receipt,#1406,,FireWrap  Grip Kit - Pre-Order,1,37.95  ,37.95  ,75.90  
FireWrap® Grip Kit GLOW - Aqua,03/25/2018,Sales Receipt,#1408,,FireWrap  Grip Kit - Pre-Order,1,37.95  ,37.95  ,113.85  
FireWrap® Grip Kit GLOW - Aqua,03/26/2018,Sales Receipt,#1414,,FireWrap  Grip Kit - Pre-Order,1,37.95  ,37.95  ,151.80  
FireWrap® Grip Kit GLOW - Aqua,03/29/2018,Invoice,1097,,,1,24.95  ,24.95  ,176.75  
FireWrap® Grip Kit GLOW - Aqua,04/01/2018,Sales Receipt,#1422,,FireWrap  Grip Kit - Pre-Order,1,37.95  ,37.95  ,214.70  
FireWrap® Grip Kit GLOW - Aqua,04/01/2018,Sales Receipt,#1423,,FireWrap  Grip Kit - Pre-Order,1,37.95  ,37.95  ,252.65  
FireWrap® Grip Kit GLOW - Aqua,04/08/2018,Sales Receipt,#1432,,FireWrap  Grip Kit - Pre-Order,1,37.95  ,37.95  ,290.60  
FireWrap® Grip Kit GLOW - Aqua,04/09/2018,Sales Receipt,#1434,,FireWrap  Grip Kit - Pre-Order,1,37.95  ,37.95  ,328.55  
FireWrap® Grip Kit GLOW - Aqua,04/10/2018,Sales Receipt,#1437,,FireWrap  Grip Kit - Pre-Order,1,37.95  ,37.95  ,366.50  
FireWrap® Grip Kit GLOW - Aqua,04/12/2018,Sales Receipt,#1440,,FireWrap  Grip Kit - Pre-Order,2,37.95  ,75.90  ,442.40  
FireWrap® Grip Kit GLOW - Aqua,04/14/2018,Sales Receipt,#1444,,FireWrap  Grip Kit - Pre-Order,1,37.95  ,37.95  ,480.35  
FireWrap® Grip Kit GLOW - Aqua,04/16/2018,Sales Receipt,#1452,,FireWrap  Grip Kit - Pre-Order,2,37.95  ,75.90  ,556.25  
FireWrap® Grip Kit GLOW - Aqua,04/16/2018,Sales Receipt,#1451,,FireWrap  Grip Kit - Pre-Order,1,37.95  ,37.95  ,594.20  
FireWrap® Grip Kit GLOW - Aqua,04/17/2018,Sales Receipt,#1453,,FireWrap  Grip Kit - Pre-Order,1,37.95  ,37.95  ,632.15  
FireWrap® Grip Kit GLOW - Aqua,04/25/2018,Sales Receipt,#1463,,FireWrap  Grip Kit - Pre-Order,1,37.95  ,37.95  ,670.10  
FireWrap® Grip Kit GLOW - Aqua,04/26/2018,Sales Receipt,#1499,,FireWrap  Grip Kit - Pre-Order,1,37.95  ,37.95  ,708.05  
FireWrap® Grip Kit GLOW - Aqua,04/26/2018,Sales Receipt,#1473,,FireWrap  Grip Kit - Pre-Order,1,37.95  ,37.95  ,746.00  
FireWrap® Grip Kit GLOW - Aqua,04/26/2018,Sales Receipt,#1497,,FireWrap  Grip Kit - Pre-Order,1,37.95  ,37.95  ,783.95  
FireWrap® Grip Kit GLOW - Aqua,04/26/2018,Sales Receipt,#1495,,FireWrap  Grip Kit - Pre-Order,3,37.95  ,113.85  ,897.80  
FireWrap® Grip Kit GLOW - Aqua,04/27/2018,Sales Receipt,#1533,,FireWrap  Grip Kit - Pre-Order,1,37.95  ,37.95  ,935.75  
FireWrap® Grip Kit GLOW - Aqua,04/27/2018,Sales Receipt,#1538,,FireWrap  Grip Kit - Pre-Order,1,37.95  ,37.95  ,973.70  
FireWrap® Grip Kit GLOW - Aqua,04/27/2018,Sales Receipt,#1534,,FireWrap  Grip Kit - Pre-Order,5,37.95  ,189.75  ,"1,163.45  "
FireWrap® Grip Kit GLOW - Aqua,04/27/2018,Sales Receipt,#1519,,FireWrap  Grip Kit - Pre-Order,1,37.95  ,37.95  ,"1,201.40  "
FireWrap® Grip Kit GLOW - Aqua,04/27/2018,Sales Receipt,#1536,,FireWrap  Grip Kit - Pre-Order,5,37.95  ,189.75  ,"1,391.15  "
FireWrap® Grip Kit GLOW - Aqua,04/27/2018,Sales Receipt,#1544,,FireWrap  Grip Kit - Pre-Order,1,37.95  ,37.95  ,"1,429.10  "
FireWrap® Grip Kit GLOW - Aqua,04/27/2018,Sales Receipt,#1546,,FireWrap  Grip Kit - Pre-Order,1,37.95  ,37.95  ,"1,467.05  "
FireWrap® Grip Kit GLOW - Aqua,04/27/2018,Invoice,1108,,,0,,0.00  ,"1,467.05  "
FireWrap® Grip Kit GLOW - Aqua,04/27/2018,Sales Receipt,#1529,,FireWrap  Grip Kit - Pre-Order,1,37.95  ,37.95  ,"1,505.00  "
FireWrap® Grip Kit GLOW - Aqua,04/27/2018,Sales Receipt,#1535,,FireWrap  Grip Kit - Pre-Order,5,37.95  ,189.75  ,"1,694.75  "
FireWrap® Grip Kit GLOW - Aqua,04/28/2018,Sales Receipt,#1563,,FireWrap  Grip Kit - Pre-Order,1,37.95  ,37.95  ,"1,732.70  "
FireWrap® Grip Kit GLOW - Aqua,04/28/2018,Sales Receipt,#1559,,FireWrap  Grip Kit - Pre-Order,1,37.95  ,37.95  ,"1,770.65  "
FireWrap® Grip Kit GLOW - Aqua,04/28/2018,Sales Receipt,#1569,,FireWrap  Grip Kit - Pre-Order,1,37.95  ,37.95  ,"1,808.60  "
FireWrap® Grip Kit GLOW - Aqua,04/28/2018,Sales Receipt,#1570,,FireWrap  Grip Kit - Pre-Order,1,37.95  ,37.95  ,"1,846.55  "
FireWrap® Grip Kit GLOW - Aqua,04/29/2018,Sales Receipt,#1576,,FireWrap  Grip Kit - Pre-Order,1,37.95  ,37.95  ,"1,884.50  "
FireWrap® Grip Kit GLOW - Aqua,04/29/2018,Refund,#1535 (Refund 1),,FireWrap  Grip Kit - Pre-Order,-5,37.95  ,-189.75  ,"1,694.75  "
FireWrap® Grip Kit GLOW - Aqua,04/30/2018,Sales Receipt,#1584,,FireWrap  Grip Kit - Pre-Order,1,37.95  ,37.95  ,"1,732.70  "
FireWrap® Grip Kit GLOW - Aqua,04/30/2018,Invoice,1113,,,3,32.00  ,96.00  ,"1,828.70  "
FireWrap® Grip Kit GLOW - Aqua,04/30/2018,Sales Receipt,#1578,,FireWrap  Grip Kit - Pre-Order,3,37.95  ,113.85  ,"1,942.55  "
FireWrap® Grip Kit GLOW - Aqua,04/30/2018,Invoice,1112,,,2,32.00  ,64.00  ,"2,006.55  "
FireWrap® Grip Kit GLOW - Aqua,05/06/2018,Sales Receipt,#1602,,FireWrap  Grip Kit,1,47.95  ,47.95  ,"2,054.50  "
FireWrap® Grip Kit GLOW - Aqua,05/08/2018,Sales Receipt,#1607,,FireWrap  Grip Kit,1,47.95  ,47.95  ,"2,102.45  "
FireWrap® Grip Kit GLOW - Aqua,05/12/2018,Invoice,1115,,,16,36.00  ,576.00  ,"2,678.45  "
FireWrap® Grip Kit GLOW - Aqua,05/20/2018,Sales Receipt,#1632,,FireWrap  Grip Kit,1,47.95  ,47.95  ,"2,726.40  "
FireWrap® Grip Kit GLOW - Aqua,05/22/2018,Sales Receipt,#1639,,FireWrap  Grip Kit,1,47.95  ,47.95  ,"2,774.35  "
FireWrap® Grip Kit GLOW - Aqua,05/23/2018,Sales Receipt,#1641,,FireWrap  Grip Kit,1,47.95  ,47.95  ,"2,822.30  "
FireWrap® Grip Kit GLOW - Aqua,05/29/2018,Sales Receipt,#1653,,FireWrap  Grip Kit,1,47.95  ,47.95  ,"2,870.25  "
FireWrap® Grip Kit GLOW - Aqua,06/05/2018,Sales Receipt,#1664,,FireWrap  Grip Kit,1,47.95  ,47.95  ,"2,918.20  "
FireWrap® Grip Kit GLOW - Aqua,06/09/2018,Sales Receipt,#1671,,FireWrap  Grip Kit,1,47.95  ,47.95  ,"2,966.15  "
FireWrap® Grip Kit GLOW - Aqua,06/13/2018,Sales Receipt,#1674,,FireWrap  Grip Kit,3,47.95  ,143.85  ,"3,110.00  "
FireWrap® Grip Kit GLOW - Aqua,06/21/2018,Sales Receipt,#1686,,FireWrap  Grip Kit,1,47.95  ,47.95  ,"3,157.95  "
FireWrap® Grip Kit GLOW - Aqua,06/21/2018,Sales Receipt,#1687,,FireWrap  Grip Kit,1,47.95  ,47.95  ,"3,205.90  "
FireWrap® Grip Kit GLOW - Aqua,06/22/2018,Invoice,1133,,,8,36.00  ,288.00  ,"3,493.90  "
FireWrap® Grip Kit GLOW - Aqua,06/22/2018,Sales Receipt,#1689,,FireWrap  Grip Kit,1,47.95  ,47.95  ,"3,541.85  "
FireWrap® Grip Kit GLOW - Aqua,06/28/2018,Sales Receipt,#1693,,FireWrap  Grip Kit,1,47.95  ,47.95  ,"3,589.80  "
FireWrap® Grip Kit GLOW - Aqua,06/28/2018,Invoice,1136,,FireWrap Grip Kit Installed,1,47.95  ,47.95  ,"3,637.75  "
FireWrap® Grip Kit GLOW - Aqua,07/03/2018,Sales Receipt,#1700,,FireWrap  Grip Kit,1,47.95  ,47.95  ,"3,685.70  "
FireWrap® Grip Kit GLOW - Aqua,07/13/2018,Sales Receipt,#1715,,FireWrap  Grip Kit,1,47.95  ,47.95  ,"3,733.65  "
FireWrap® Grip Kit GLOW - Aqua,07/15/2018,Sales Receipt,#1720,,FireWrap  Grip Kit,2,47.95  ,95.90  ,"3,829.55  "
FireWrap® Grip Kit GLOW - Aqua,07/18/2018,Sales Receipt,#1725,,FireWrap  Grip Kit,1,47.95  ,47.95  ,"3,877.50  "
FireWrap® Grip Kit GLOW - Aqua,07/25/2018,Sales Receipt,#1738,,FireWrap  Grip Kit,1,47.95  ,47.95  ,"3,925.45  "
FireWrap® Grip Kit GLOW - Aqua,07/28/2018,Sales Receipt,#1740,,FireWrap  Grip Kit,1,47.95  ,47.95  ,"3,973.40  "
FireWrap® Grip Kit GLOW - Aqua,08/01/2018,Sales Receipt,#1747,,FireWrap  Grip Kit,4,47.95  ,191.80  ,"4,165.20  "
FireWrap® Grip Kit GLOW - Aqua,08/04/2018,Sales Receipt,#1754,,FireWrap  Grip Kit,1,47.95  ,47.95  ,"4,213.15  "
FireWrap® Grip Kit GLOW - Aqua,08/04/2018,Sales Receipt,#1752,,FireWrap  Grip Kit,2,47.95  ,95.90  ,"4,309.05  "
FireWrap® Grip Kit GLOW - Aqua,08/10/2018,Sales Receipt,#1767,,FireWrap  Grip Kit,1,47.95  ,47.95  ,"4,357.00  "
FireWrap® Grip Kit GLOW - Aqua,08/10/2018,Sales Receipt,#1768,,FireWrap  Grip Kit,3,47.95  ,143.85  ,"4,500.85  "
FireWrap® Grip Kit GLOW - Aqua,08/12/2018,Invoice,1157,,,1,34.95  ,34.95  ,"4,535.80  "
FireWrap® Grip Kit GLOW - Aqua,08/15/2018,Sales Receipt,#1776,,FireWrap  Grip Kit,1,47.95  ,47.95  ,"4,583.75  "
FireWrap® Grip Kit GLOW - Aqua,08/17/2018,Sales Receipt,#1778,,FireWrap  Grip Kit,2,47.95  ,95.90  ,"4,679.65  "
FireWrap® Grip Kit GLOW - Aqua,08/24/2018,Invoice,1166,,,2,41.00  ,82.00  ,"4,761.65  "
FireWrap® Grip Kit GLOW - Aqua,08/24/2018,Sales Receipt,#1789,,FireWrap  Grip Kit,1,47.95  ,47.95  ,"4,809.60  "
FireWrap® Grip Kit GLOW - Aqua,08/24/2018,Sales Receipt,#1787,,FireWrap  Grip Kit,2,47.95  ,95.90  ,"4,905.50  "
FireWrap® Grip Kit GLOW - Aqua,08/28/2018,Sales Receipt,#1798,,FireWrap  Grip Kit,1,47.95  ,47.95  ,"4,953.45  "
FireWrap® Grip Kit GLOW - Aqua,08/29/2018,Sales Receipt,#1799,,FireWrap  Grip Kit,1,47.95  ,47.95  ,"5,001.40  "
FireWrap® Grip Kit GLOW - Aqua,08/31/2018,Sales Receipt,#1805,,FireWrap  Grip Kit,1,47.95  ,47.95  ,"5,049.35  "
FireWrap® Grip Kit GLOW - Aqua,09/01/2018,Invoice,1142,,"P.O. Number: 18-0728-1
36” Fire Maul, add end cap, add glow handle
wrap, steel collar",1,25.00  ,25.00  ,"5,074.35  "
FireWrap® Grip Kit GLOW - Aqua,09/04/2018,Sales Receipt,#1811,,FireWrap  Grip Kit,1,47.95  ,47.95  ,"5,122.30  "
FireWrap® Grip Kit GLOW - Aqua,09/06/2018,Sales Receipt,#1815,,FireWrap  Grip Kit,1,47.95  ,47.95  ,"5,170.25  "
FireWrap® Grip Kit GLOW - Aqua,09/10/2018,Sales Receipt,#1822,,FireWrap  Grip Kit,1,47.95  ,47.95  ,"5,218.20  "
FireWrap® Grip Kit GLOW - Aqua,09/11/2018,Sales Receipt,#1824,,FireWrap  Grip Kit,1,47.95  ,47.95  ,"5,266.15  "
FireWrap® Grip Kit GLOW - Aqua,09/13/2018,Sales Receipt,#1833,,FireWrap  Grip Kit,2,47.95  ,95.90  ,"5,362.05  "
FireWrap® Grip Kit GLOW - Aqua,09/13/2018,Sales Receipt,#1834,,FireWrap  Grip Kit,1,47.95  ,47.95  ,"5,410.00  "
FireWrap® Grip Kit GLOW - Aqua,09/14/2018,Sales Receipt,#1838,,FireWrap  Grip Kit,1,47.95  ,47.95  ,"5,457.95  "
FireWrap® Grip Kit GLOW - Aqua,09/19/2018,Sales Receipt,#1851,,FireWrap  Grip Kit,1,47.95  ,47.95  ,"5,505.90  "
FireWrap® Grip Kit GLOW - Aqua,09/20/2018,Sales Receipt,#1855,,FireWrap  Grip Kit,1,47.95  ,47.95  ,"5,553.85  "
FireWrap® Grip Kit GLOW - Aqua,09/21/2018,Sales Receipt,#1857,,FireWrap  Grip Kit,2,47.95  ,95.90  ,"5,649.75  "
FireWrap® Grip Kit GLOW - Aqua,10/01/2018,Sales Receipt,#1880,,FireWrap  Grip Kit,1,47.95  ,47.95  ,"5,697.70  "
FireWrap® Grip Kit GLOW - Aqua,10/02/2018,Invoice,1176,,,1,41.00  ,41.00  ,"5,738.70  "
FireWrap® Grip Kit GLOW - Aqua,10/10/2018,Sales Receipt,#1896,,FireWrap  Grip Kit,2,47.95  ,95.90  ,"5,834.60  "
FireWrap® Grip Kit GLOW - Aqua,10/16/2018,Sales Receipt,#1904,,FireWrap  Grip Kit,1,47.95  ,47.95  ,"5,882.55  "
FireWrap® Grip Kit GLOW - Aqua,10/18/2018,Sales Receipt,#1927,,FireWrap  Grip Kit,4,47.95  ,191.80  ,"6,074.35  "
FireWrap® Grip Kit GLOW - Aqua,10/19/2018,Sales Receipt,#1941,,FireWrap  Grip Kit,1,47.95  ,47.95  ,"6,122.30  "
FireWrap® Grip Kit GLOW - Aqua,10/19/2018,Sales Receipt,#1945,,FireWrap  Grip Kit,2,47.95  ,95.90  ,"6,218.20  "
FireWrap® Grip Kit GLOW - Aqua,10/23/2018,Sales Receipt,#1958,,FireWrap  Grip Kit,1,47.95  ,47.95  ,"6,266.15  "
FireWrap® Grip Kit GLOW - Aqua,10/23/2018,Sales Receipt,#1955,,FireWrap  Grip Kit,1,47.95  ,47.95  ,"6,314.10  "
FireWrap® Grip Kit GLOW - Aqua,10/26/2018,Sales Receipt,#1962,,FireWrap  Grip Kit,1,47.95  ,47.95  ,"6,362.05  "
FireWrap® Grip Kit GLOW - Aqua,10/26/2018,Sales Receipt,#1965,,FireWrap  Grip Kit,2,47.95  ,95.90  ,"6,457.95  "
FireWrap® Grip Kit GLOW - Aqua,10/29/2018,Sales Receipt,#1968,,FireWrap  Grip Kit,1,47.95  ,47.95  ,"6,505.90  "
FireWrap® Grip Kit GLOW - Aqua,10/29/2018,Sales Receipt,#1970,,FireWrap  Grip Kit,1,47.95  ,47.95  ,"6,553.85  "
FireWrap® Grip Kit GLOW - Aqua,11/07/2018,Sales Receipt,#1988,,FireWrap  Grip Kit,1,47.95  ,47.95  ,"6,601.80  "
FireWrap® Grip Kit GLOW - Aqua,11/23/2018,Sales Receipt,#2022,,FireWrap  Grip Kit,1,47.95  ,47.95  ,"6,649.75  "
FireWrap® Grip Kit GLOW - Aqua,11/28/2018,Sales Receipt,#2040,,FireWrap  Grip Kit,1,47.95  ,47.95  ,"6,697.70  "
FireWrap® Grip Kit GLOW - Aqua,11/28/2018,Sales Receipt,#2038,,FireWrap  Grip Kit,1,47.95  ,47.95  ,"6,745.65  "
FireWrap® Grip Kit GLOW - Aqua,12/10/2018,Sales Receipt,#2075,,FireWrap  Grip Kit,1,47.95  ,47.95  ,"6,793.60  "
FireWrap® Grip Kit GLOW - Aqua,12/11/2018,Sales Receipt,#2080,,FireWrap  Grip Kit,1,47.95  ,47.95  ,"6,841.55  "
FireWrap® Grip Kit GLOW - Aqua,12/12/2018,Sales Receipt,#2081,,FireWrap Grip Kit,1,47.95  ,47.95  ,"6,889.50  "
FireWrap® Grip Kit GLOW - Aqua,12/13/2018,Sales Receipt,#2088,,FireWrap  Grip Kit,1,47.95  ,47.95  ,"6,937.45  "
FireWrap® Grip Kit GLOW - Aqua,12/18/2018,Invoice,1230,,,1,41.00  ,41.00  ,"6,978.45  "
FireWrap® Grip Kit GLOW - Aqua,12/30/2018,Invoice,1234,,,1,41.00  ,41.00  ,"7,019.45  "
FireWrap® Grip Kit GLOW - Aqua,12/31/2018,Sales Receipt,#2152,,FireWrap  Grip Kit,1,47.95  ,47.95  ,"7,067.40  "
FireWrap® Grip Kit GLOW - Aqua,01/07/2019,Sales Receipt,#2175,,FireWrap  Grip Kit,1,47.95  ,47.95  ,"7,115.35  "
FireWrap® Grip Kit GLOW - Aqua,01/08/2019,Sales Receipt,#2180,,FireWrap  Grip Kit,1,47.95  ,47.95  ,"7,163.30  "
FireWrap® Grip Kit GLOW - Aqua,01/14/2019,Sales Receipt,#2196,,FireWrap  Grip Kit,1,47.95  ,47.95  ,"7,211.25  "
FireWrap® Grip Kit GLOW - Aqua,01/17/2019,Sales Receipt,#2210,,FireWrap Grip Kit,1,47.95  ,47.95  ,"7,259.20  "
FireWrap® Grip Kit GLOW - Aqua,01/18/2019,Sales Receipt,#2216,,FireWrap  Grip Kit,1,47.95  ,47.95  ,"7,307.15  "
FireWrap® Grip Kit GLOW - Aqua,01/20/2019,Sales Receipt,#2223,,FireWrap  Grip Kit,1,47.95  ,47.95  ,"7,355.10  "
FireWrap® Grip Kit GLOW - Aqua,01/25/2019,Sales Receipt,#2237,,FireWrap  Grip Kit,1,47.95  ,47.95  ,"7,403.05  "
FireWrap® Grip Kit GLOW - Aqua,01/26/2019,Sales Receipt,#2241,,FireWrap  Grip Kit,1,47.95  ,47.95  ,"7,451.00  "
FireWrap® Grip Kit GLOW - Aqua,01/27/2019,Sales Receipt,#2243,,FireWrap  Grip Kit,2,47.95  ,95.90  ,"7,546.90  "
FireWrap® Grip Kit GLOW - Aqua,02/06/2019,Invoice,1268,,FireWrap Grip-Kit für Halligan-Tool - Aqua (Nachtleuchtend),150,34.00  ,"5,100.00  ","12,646.90  "
FireWrap® Grip Kit GLOW - Aqua,02/10/2019,Sales Receipt,#2282,,FireWrap  Grip Kit,1,47.95  ,47.95  ,"12,694.85  "
FireWrap® Grip Kit GLOW - Aqua,02/13/2019,Invoice,1275,,,1,41.00  ,41.00  ,"12,735.85  "
FireWrap® Grip Kit GLOW - Aqua,02/15/2019,Sales Receipt,#2297,,FireWrap  Grip Kit,1,47.95  ,47.95  ,"12,783.80  "
FireWrap® Grip Kit GLOW - Aqua,02/18/2019,Sales Receipt,#2307,,FireWrap  Grip Kit,1,47.95  ,47.95  ,"12,831.75  "
FireWrap® Grip Kit GLOW - Aqua,02/22/2019,Sales Receipt,#2327,,FireWrap  Grip Kit,1,47.95  ,47.95  ,"12,879.70  "
FireWrap® Grip Kit GLOW - Aqua,02/23/2019,Sales Receipt,#2331,,FireWrap Grip Kit,1,47.95  ,47.95  ,"12,927.65  "
FireWrap® Grip Kit GLOW - Aqua,02/23/2019,Sales Receipt,#2329,,FireWrap Grip Kit,1,47.95  ,47.95  ,"12,975.60  "
FireWrap® Grip Kit GLOW - Aqua,02/24/2019,Sales Receipt,#2335,,FireWrap  Grip Kit,1,47.95  ,47.95  ,"13,023.55  "
FireWrap® Grip Kit GLOW - Aqua,02/25/2019,Sales Receipt,#2338,,FireWrap  Grip Kit,1,47.95  ,47.95  ,"13,071.50  "
FireWrap® Grip Kit GLOW - Aqua,02/27/2019,Sales Receipt,#2346,,FireWrap Grip Kit,1,47.95  ,47.95  ,"13,119.45  "
FireWrap® Grip Kit GLOW - Aqua,03/01/2019,Sales Receipt,#2356,,FireWrap Grip Kit,1,47.95  ,47.95  ,"13,167.40  "
FireWrap® Grip Kit GLOW - Aqua,03/05/2019,Invoice,1266,,"P.O. Number: 19-0227-3
 Joseph Tabor
10179 Joyners Bridge Rd
Carrsville, VA 23315",1,41.00  ,41.00  ,"13,208.40  "
FireWrap® Grip Kit GLOW - Aqua,03/14/2019,Invoice,1300,,,1,41.00  ,41.00  ,"13,249.40  "
FireWrap® Grip Kit GLOW - Aqua,03/21/2019,Invoice,1308,,,2,41.00  ,82.00  ,"13,331.40  "
FireWrap® Grip Kit GLOW - Aqua,03/21/2019,Invoice,1314,,,1,47.95  ,47.95  ,"13,379.35  "
FireWrap® Grip Kit GLOW - Aqua,03/23/2019,Sales Receipt,#2438,,FireWrap® Grip Kit,2,47.95  ,95.90  ,"13,475.25  "
FireWrap® Grip Kit GLOW - Aqua,03/25/2019,Sales Receipt,#2442,,FireWrap® Grip Kit,1,47.95  ,47.95  ,"13,523.20  "
FireWrap® Grip Kit GLOW - Aqua,03/28/2019,Sales Receipt,#2453,,FireWrap Grip Kit,1,47.95  ,47.95  ,"13,571.15  "
FireWrap® Grip Kit GLOW - Aqua,03/31/2019,Sales Receipt,#2462,,FireWrap Grip Kit,1,47.95  ,47.95  ,"13,619.10  "
FireWrap® Grip Kit GLOW - Aqua,03/31/2019,Sales Receipt,#2460,,FireWrap Grip Kit,1,47.95  ,47.95  ,"13,667.05  "
FireWrap® Grip Kit GLOW - Aqua,04/01/2019,Sales Receipt,#2468,,FireWrap® Grip Kit,1,47.95  ,47.95  ,"13,715.00  "
FireWrap® Grip Kit GLOW - Aqua,04/02/2019,Sales Receipt,#2478,,FireWrap® Grip Kit,1,47.95  ,47.95  ,"13,762.95  "
FireWrap® Grip Kit GLOW - Aqua,04/04/2019,Sales Receipt,#2486,,FireWrap® Grip Kit,2,47.95  ,95.90  ,"13,858.85  "
FireWrap® Grip Kit GLOW - Aqua,04/07/2019,Sales Receipt,#2498,,FireWrap® Grip Kit,1,47.95  ,47.95  ,"13,906.80  "
FireWrap® Grip Kit GLOW - Aqua,04/07/2019,Sales Receipt,#2497,,FireWrap® Grip Kit,1,47.95  ,47.95  ,"13,954.75  "
FireWrap® Grip Kit GLOW - Aqua,04/11/2019,Sales Receipt,#2526,,FireWrap® Grip Kit,1,47.95  ,47.95  ,"14,002.70  "
FireWrap® Grip Kit GLOW - Aqua,04/14/2019,Sales Receipt,#2587,,FireWrap® Grip Kit,1,47.95  ,47.95  ,"14,050.65  "
FireWrap® Grip Kit GLOW - Aqua,04/18/2019,Sales Receipt,#2598,,FireWrap® Grip Kit,1,47.95  ,47.95  ,"14,098.60  "
FireWrap® Grip Kit GLOW - Aqua,04/18/2019,Sales Receipt,#2597,,FireWrap® Grip Kit,1,47.95  ,47.95  ,"14,146.55  "
FireWrap® Grip Kit GLOW - Aqua,04/18/2019,Invoice,1324,,,1,41.00  ,41.00  ,"14,187.55  "
FireWrap® Grip Kit GLOW - Aqua,04/22/2019,Sales Receipt,#2603,,FireWrap® Grip Kit,2,47.95  ,95.90  ,"14,283.45  "
FireWrap® Grip Kit GLOW - Aqua,05/02/2019,Invoice,1335,,,1,41.00  ,41.00  ,"14,324.45  "
FireWrap® Grip Kit GLOW - Aqua,05/30/2019,Invoice,1328,,,1,41.00  ,41.00  ,"14,365.45  "
FireWrap® Grip Kit GLOW - Aqua,06/11/2019,Invoice,1365,,,2,41.00  ,82.00  ,"14,447.45  "
FireWrap® Grip Kit GLOW - Aqua,06/13/2019,Sales Receipt,#2685,,FireWrap® Grip Kit,6,47.95  ,287.70  ,"14,735.15  "
FireWrap® Grip Kit GLOW - Aqua,06/18/2019,Sales Receipt,#2699,,FireWrap Grip Kit,1,47.95  ,47.95  ,"14,783.10  "
FireWrap® Grip Kit GLOW - Aqua,06/20/2019,Sales Receipt,#2705,,FireWrap® Grip Kit,1,47.95  ,47.95  ,"14,831.05  "
FireWrap® Grip Kit GLOW - Aqua,06/20/2019,Sales Receipt,#2706,,FireWrap® Grip Kit,2,47.95  ,95.90  ,"14,926.95  "
FireWrap® Grip Kit GLOW - Aqua,06/28/2019,Invoice,1372,,"Adam G Cole
300 SW Wilson Ln
Boardman OR 97818-8029",1,41.00  ,41.00  ,"14,967.95  "
FireWrap® Grip Kit GLOW - Aqua,07/02/2019,Sales Receipt,#2746,,FireWrap Grip Kit,1,47.95  ,47.95  ,"15,015.90  "
FireWrap® Grip Kit GLOW - Aqua,07/02/2019,Invoice,1361,,"P.O. Number: 19-0601-12 
Donald Washburn
108 Litchfield Lane
Knott Island, NC 27950",1,41.00  ,41.00  ,"15,056.90  "
FireWrap® Grip Kit GLOW - Aqua,07/21/2019,Sales Receipt,112-1357370-4305811,,FireWrap Grip Kit,1,47.95  ,47.95  ,"15,104.85  "
FireWrap® Grip Kit GLOW - Aqua,08/12/2019,Sales Receipt,111-8864888-5522668,,FireWrap Grip Kit (New),1,47.95  ,47.95  ,"15,152.80  "
FireWrap® Grip Kit GLOW - Aqua,12/01/2019,Sales Receipt,111-8038010-9999434,,FireWrap Grip Kit - Glow Aqua (New),1,47.95  ,47.95  ,"15,200.75  "
FireWrap® Grip Kit GLOW - Aqua,12/04/2019,Sales Receipt,111-4818393-8849022,,FireWrap Grip Kit - Glow Aqua (New),1,47.95  ,47.95  ,"15,248.70  "
FireWrap® Grip Kit GLOW - Aqua,12/15/2019,Sales Receipt,113-7164398-6917840,,FireWrap Grip Kit - Glow Aqua (New),1,47.95  ,47.95  ,"15,296.65  "
FireWrap® Grip Kit GLOW - Aqua,12/24/2019,Sales Receipt,111-7893877-3017009,,FireWrap Grip Kit - Glow Aqua (New),1,47.95  ,47.95  ,"15,344.60  "
FireWrap® Grip Kit GLOW - Aqua,12/27/2019,Sales Receipt,112-4989813-8870668,,FireWrap Grip Kit - Glow Aqua,1,47.95  ,47.95  ,"15,392.55  "
FireWrap® Grip Kit GLOW - Aqua,12/28/2019,Sales Receipt,113-4842574-1688251,,FireWrap Grip Kit - Glow Aqua (New),4,47.95  ,191.80  ,"15,584.35  "
FireWrap® Grip Kit GLOW - Aqua,01/07/2020,Sales Receipt,112-3543136-7862604,,FireWrap Grip Kit - Glow Aqua (New),1,37.95  ,37.95  ,"15,622.30  "
FireWrap® Grip Kit GLOW - Aqua,01/24/2020,Sales Receipt,111-2086599-3613812,,FireWrap Grip Kit - Glow Aqua (New),1,37.95  ,37.95  ,"15,660.25  "
FireWrap® Grip Kit GLOW - Aqua,01/28/2020,Sales Receipt,112-7090976-6283466,,FireWrap Grip Kit - Glow Aqua (New),1,37.95  ,37.95  ,"15,698.20  "
FireWrap® Grip Kit GLOW - Aqua,01/30/2020,Sales Receipt,112-4540811-4565848,,FireWrap Grip Kit - Glow Aqua (New),1,37.95  ,37.95  ,"15,736.15  "
FireWrap® Grip Kit GLOW - Aqua,02/06/2020,Sales Receipt,111-6790186-4137807,,FireWrap Grip Kit - Glow Aqua (New),1,37.95  ,37.95  ,"15,774.10  "
FireWrap® Grip Kit GLOW - Aqua,03/11/2020,Sales Receipt,111-2340397-1577013,,FireWrap Grip Kit - Glow Aqua (New),1,37.95  ,37.95  ,"15,812.05  "
FireWrap® Grip Kit GLOW - Aqua,04/09/2020,Sales Receipt,113-8617610-9314618,,FireWrap Grip Kit - Glow Aqua (New),1,37.95  ,37.95  ,"15,850.00  "
FireWrap® Grip Kit GLOW - Aqua,04/09/2020,Sales Receipt,3622,,FireWrap® Grip Kit - GLOW - Aqua,1,37.95  ,37.95  ,"15,887.95  "
FireWrap® Grip Kit GLOW - Aqua,04/20/2020,Sales Receipt,111-9962285-2797860,,FireWrap Grip Kit - Glow Aqua (New),4,37.95  ,151.80  ,"16,039.75  "
FireWrap® Grip Kit GLOW - Aqua,04/22/2020,Sales Receipt,3677,,FireWrap® Grip Kit - GLOW - Aqua,1,37.95  ,37.95  ,"16,077.70  "
FireWrap® Grip Kit GLOW - Aqua,04/25/2020,Sales Receipt,111-4994309-2461039,,FireWrap Grip Kit - Glow Aqua (New),1,37.95  ,37.95  ,"16,115.65  "
FireWrap® Grip Kit GLOW - Aqua,04/27/2020,Sales Receipt,113-6017635-9331453,,FireWrap Grip Kit - Glow Aqua (New),1,37.95  ,37.95  ,"16,153.60  "
FireWrap® Grip Kit GLOW - Aqua,04/27/2020,Sales Receipt,113-1481661-7914615,,FireWrap Grip Kit - Glow Aqua (New),1,37.95  ,37.95  ,"16,191.55  "
FireWrap® Grip Kit GLOW - Aqua,04/29/2020,Sales Receipt,3704,,FireWrap® Grip Kit - GLOW - Aqua,1,37.95  ,37.95  ,"16,229.50  "
FireWrap® Grip Kit GLOW - Aqua,05/03/2020,Sales Receipt,3722,,FireWrap® Grip Kit - GLOW - Aqua,1,37.95  ,37.95  ,"16,267.45  "
FireWrap® Grip Kit GLOW - Aqua,05/05/2020,Sales Receipt,3726,,FireWrap® Grip Kit - GLOW - Aqua,1,37.95  ,37.95  ,"16,305.40  "
FireWrap® Grip Kit GLOW - Aqua,05/12/2020,Sales Receipt,3756,,FireWrap® Grip Kit - GLOW - Aqua,1,37.95  ,37.95  ,"16,343.35  "
FireWrap® Grip Kit GLOW - Aqua,05/18/2020,Sales Receipt,3778,,FireWrap® Grip Kit - GLOW - Aqua,1,37.95  ,37.95  ,"16,381.30  "
FireWrap® Grip Kit GLOW - Aqua,05/20/2020,Sales Receipt,3784,,FireWrap® Grip Kit - GLOW - Aqua,1,37.95  ,37.95  ,"16,419.25  "
FireWrap® Grip Kit GLOW - Aqua,06/03/2020,Sales Receipt,3822,,FireWrap® Grip Kit - GLOW - Aqua,1,37.95  ,37.95  ,"16,457.20  "
FireWrap® Grip Kit GLOW - Aqua,06/05/2020,Sales Receipt,3827,,FireWrap® Grip Kit - GLOW - Aqua,1,37.95  ,37.95  ,"16,495.15  "
FireWrap® Grip Kit GLOW - Aqua,06/07/2020,Sales Receipt,3832,,FireWrap® Grip Kit - GLOW - Aqua,1,37.95  ,37.95  ,"16,533.10  "
FireWrap® Grip Kit GLOW - Aqua,06/11/2020,Sales Receipt,3847,,FireWrap® Grip Kit - GLOW - Aqua,1,37.95  ,37.95  ,"16,571.05  "
FireWrap® Grip Kit GLOW - Aqua,06/23/2020,Sales Receipt,3943,,FireWrap® Grip Kit - GLOW - Aqua,4,37.95  ,151.80  ,"16,722.85  "
FireWrap® Grip Kit GLOW - Aqua,06/29/2020,Sales Receipt,3975,,FireWrap® Grip Kit - GLOW - Aqua,1,37.95  ,37.95  ,"16,760.80  "
FireWrap® Grip Kit GLOW - Aqua,07/06/2020,Sales Receipt,3995,,FireWrap® Grip Kit - GLOW - Aqua,1,37.95  ,37.95  ,"16,798.75  "
FireWrap® Grip Kit GLOW - Aqua,07/10/2020,Sales Receipt,4008,,FireWrap® Grip Kit - GLOW - Aqua,1,37.95  ,37.95  ,"16,836.70  "
FireWrap® Grip Kit GLOW - Aqua,07/15/2020,Sales Receipt,4023,,FireWrap® Grip Kit - GLOW - Aqua,1,37.95  ,37.95  ,"16,874.65  "
FireWrap® Grip Kit GLOW - Aqua,07/17/2020,Sales Receipt,4028,,FireWrap® Grip Kit - GLOW - Aqua,2,37.95  ,75.90  ,"16,950.55  "
FireWrap® Grip Kit GLOW - Aqua,07/30/2020,Sales Receipt,4065,,FireWrap® Grip Kit - GLOW - Aqua,1,37.95  ,37.95  ,"16,988.50  "
FireWrap® Grip Kit GLOW - Aqua,08/20/2020,Sales Receipt,4130,,FireWrap® Grip Kit - GLOW - Aqua,1,37.95  ,37.95  ,"17,026.45  "
FireWrap® Grip Kit GLOW - Aqua,08/20/2020,Invoice,M-082020-003,,FireWrap Grip Kit - GLOW AQUA,1,28.50  ,28.50  ,"17,054.95  "
FireWrap® Grip Kit GLOW - Aqua,08/21/2020,Sales Receipt,4138,,FireWrap® Grip Kit - GLOW - Aqua,1,37.95  ,37.95  ,"17,092.90  "
FireWrap® Grip Kit GLOW - Aqua,08/25/2020,Sales Receipt,4154,,FireWrap® Grip Kit - GLOW - Aqua,10,37.95  ,379.50  ,"17,472.40  "
FireWrap® Grip Kit GLOW - Aqua,08/29/2020,Sales Receipt,4164,,FireWrap® Grip Kit - GLOW - Aqua,1,37.95  ,37.95  ,"17,510.35  "
FireWrap® Grip Kit GLOW - Aqua,08/30/2020,Sales Receipt,4167,,FireWrap® Grip Kit - GLOW - Aqua,1,37.95  ,37.95  ,"17,548.30  "
FireWrap® Grip Kit GLOW - Aqua,09/18/2020,Sales Receipt,4235,,FireWrap® Grip Kit - GLOW - Aqua,1,37.95  ,37.95  ,"17,586.25  "
FireWrap® Grip Kit GLOW - Aqua,09/23/2020,Sales Receipt,4264,,FireWrap® Grip Kit - GLOW - Aqua,4,37.95  ,151.80  ,"17,738.05  "
FireWrap® Grip Kit GLOW - Aqua,09/26/2020,Sales Receipt,4273,,FireWrap® Grip Kit - GLOW - Aqua,1,37.95  ,37.95  ,"17,776.00  "
FireWrap® Grip Kit GLOW - Aqua,10/16/2020,Sales Receipt,4357,,FireWrap® Grip Kit - GLOW - Aqua,1,37.95  ,37.95  ,"17,813.95  "
FireWrap® Grip Kit GLOW - Aqua,10/19/2020,Sales Receipt,4371,,FireWrap® Grip Kit - GLOW - Aqua,1,37.95  ,37.95  ,"17,851.90  "
FireWrap® Grip Kit GLOW - Aqua,10/19/2020,Sales Receipt,4370,,FireWrap® Grip Kit - GLOW - Aqua,1,37.95  ,37.95  ,"17,889.85  "
FireWrap® Grip Kit GLOW - Aqua,10/25/2020,Sales Receipt,4409,,FireWrap® Grip Kit - GLOW - Aqua,1,37.95  ,37.95  ,"17,927.80  "
FireWrap® Grip Kit GLOW - Aqua,10/27/2020,Sales Receipt,4418,,FireWrap® Grip Kit - GLOW - Aqua,5,37.95  ,189.75  ,"18,117.55  "
FireWrap® Grip Kit GLOW - Aqua,11/20/2020,Sales Receipt,4535,,FireWrap® Grip Kit - GLOW - Aqua,2,37.95  ,75.90  ,"18,193.45  "
FireWrap® Grip Kit GLOW - Aqua,11/22/2020,Sales Receipt,4543,,FireWrap® Grip Kit - GLOW - Aqua,1,37.95  ,37.95  ,"18,231.40  "
FireWrap® Grip Kit GLOW - Aqua,11/27/2020,Sales Receipt,4572,,FireWrap® Grip Kit - GLOW - Aqua,1,37.95  ,37.95  ,"18,269.35  "
FireWrap® Grip Kit GLOW - Aqua,11/29/2020,Sales Receipt,4593,,FireWrap® Grip Kit - GLOW - Aqua,1,37.95  ,37.95  ,"18,307.30  "
FireWrap® Grip Kit GLOW - Aqua,12/01/2020,Sales Receipt,4615,,FireWrap® Grip Kit - GLOW - Aqua,1,37.95  ,37.95  ,"18,345.25  "
FireWrap® Grip Kit GLOW - Aqua,12/02/2020,Sales Receipt,4617,,FireWrap® Grip Kit - GLOW - Aqua,2,37.95  ,75.90  ,"18,421.15  "
FireWrap® Grip Kit GLOW - Aqua,12/09/2020,Sales Receipt,4655,,FireWrap® Grip Kit - GLOW - Aqua,1,37.95  ,37.95  ,"18,459.10  "
FireWrap® Grip Kit GLOW - Aqua,12/14/2020,Sales Receipt,4679,,FireWrap® Grip Kit - GLOW - Aqua,1,37.95  ,37.95  ,"18,497.05  "
FireWrap® Grip Kit GLOW - Aqua,12/18/2020,Invoice,M-121820-006,,FireWrap® Grip Kit GLOW - Aqua,5,28.50  ,142.50  ,"18,639.55  "
FireWrap® Grip Kit GLOW - Aqua,12/19/2020,Sales Receipt,4701,,FireWrap® Grip Kit - GLOW - Aqua,1,37.95  ,37.95  ,"18,677.50  "
FireWrap® Grip Kit GLOW - Aqua,12/23/2020,Sales Receipt,4726,,FireWrap® Grip Kit - GLOW - Aqua,1,37.95  ,37.95  ,"18,715.45  "
FireWrap® Grip Kit GLOW - Aqua,01/01/2021,Sales Receipt,4777,,FireWrap® Grip Kit - GLOW - Aqua,1,37.95  ,37.95  ,"18,753.40  "
FireWrap® Grip Kit GLOW - Aqua,01/08/2021,Sales Receipt,4811,,FireWrap® Grip Kit - GLOW - Aqua,1,37.95  ,37.95  ,"18,791.35  "
FireWrap® Grip Kit GLOW - Aqua,01/11/2021,Sales Receipt,4823,,FireWrap® Grip Kit - GLOW - Aqua,1,37.95  ,37.95  ,"18,829.30  "
FireWrap® Grip Kit GLOW - Aqua,01/15/2021,Sales Receipt,4847,,FireWrap® Grip Kit - GLOW - Aqua,1,37.95  ,37.95  ,"18,867.25  "
FireWrap® Grip Kit GLOW - Aqua,01/19/2021,Invoice,M-011921-005,,FireWrap® Grip Kit GLOW - Aqua,1,28.50  ,28.50  ,"18,895.75  "
FireWrap® Grip Kit GLOW - Aqua,01/19/2021,Invoice,M-011921-006,,FireWrap® Grip Kit GLOW - Aqua,1,28.50  ,28.50  ,"18,924.25  "
FireWrap® Grip Kit GLOW - Aqua,01/21/2021,Sales Receipt,4877,,FireWrap® Grip Kit - GLOW - Aqua,1,37.95  ,37.95  ,"18,962.20  "
FireWrap® Grip Kit GLOW - Aqua,01/26/2021,Invoice,M-012621-002,,FireWrap® Grip Kit GLOW - Aqua,2,28.50  ,57.00  ,"19,019.20  "
FireWrap® Grip Kit GLOW - Aqua,01/29/2021,Sales Receipt,4899,,FireWrap® Grip Kit - GLOW - Aqua,1,37.95  ,37.95  ,"19,057.15  "
FireWrap® Grip Kit GLOW - Aqua,02/07/2021,Sales Receipt,4932,,FireWrap® Grip Kit - GLOW - Aqua,1,37.95  ,37.95  ,"19,095.10  "
FireWrap® Grip Kit GLOW - Aqua,02/13/2021,Sales Receipt,4960,,"FIREWRAP® GRIP KIT
Color: GLOW Green (+$12.95)",1,37.95  ,37.95  ,"19,133.05  "
FireWrap® Grip Kit GLOW - Aqua,02/16/2021,Invoice,M-021621-020,,FireWrap® Grip Kit GLOW - Aqua,1,28.50  ,28.50  ,"19,161.55  "
FireWrap® Grip Kit GLOW - Aqua,02/18/2021,Invoice,M-021821-002,,FireWrap® Grip Kit GLOW - Aqua,1,28.50  ,28.50  ,"19,190.05  "
FireWrap® Grip Kit GLOW - Aqua,02/23/2021,Sales Receipt,5012,,"FIREWRAP® GRIP KIT
Color: GLOW Aqua (+$12.95)",1,37.95  ,37.95  ,"19,228.00  "
FireWrap® Grip Kit GLOW - Aqua,02/24/2021,Sales Receipt,5020,,"FIREWRAP® GRIP KIT
Color: GLOW Aqua (+$12.95)",2,37.95  ,75.90  ,"19,303.90  "
FireWrap® Grip Kit GLOW - Aqua,02/24/2021,Invoice,M-022421-009,,FireWrap® Grip Kit GLOW - Aqua,3,28.50  ,85.50  ,"19,389.40  "
FireWrap® Grip Kit GLOW - Aqua,02/24/2021,Invoice,M-022421-005,,FireWrap® Grip Kit GLOW - Aqua,1,28.50  ,28.50  ,"19,417.90  "
FireWrap® Grip Kit GLOW - Aqua,03/01/2021,Sales Receipt,5036,,"FIREWRAP® GRIP KIT - Yes, I understand.
Color: GLOW Aqua (+$12.95)",1,37.95  ,37.95  ,"19,455.85  "
FireWrap® Grip Kit GLOW - Aqua,03/08/2021,Sales Receipt,5060,,"FIREWRAP® GRIP KIT - Yes, I understand.
Color: GLOW Aqua (+$12.95)",1,37.95  ,37.95  ,"19,493.80  "
FireWrap® Grip Kit GLOW - Aqua,03/12/2021,Invoice,M-031221-008,,FireWrap® Grip Kit GLOW - Aqua,4,37.95  ,151.80  ,"19,645.60  "
FireWrap® Grip Kit GLOW - Aqua,03/17/2021,Sales Receipt,5127,,"FIREWRAP® GRIP KIT - Yes, I understand.
Color: GLOW Aqua (+$12.95)",1,37.95  ,37.95  ,"19,683.55  "
FireWrap® Grip Kit GLOW - Aqua,03/21/2021,Sales Receipt,5154,,"FIREWRAP® GRIP KIT - Yes, I understand.
Color: GLOW Aqua (+$12.95)",1,37.95  ,37.95  ,"19,721.50  "
FireWrap® Grip Kit GLOW - Aqua,03/25/2021,Sales Receipt,5176,,"FIREWRAP® GRIP KIT - Yes, I understand.
Color: GLOW Aqua (+$12.95)",1,37.95  ,37.95  ,"19,759.45  "
FireWrap® Grip Kit GLOW - Aqua,03/27/2021,Invoice,M-032721-001,,FireWrap® Grip Kit GLOW - Aqua,1,28.50  ,28.50  ,"19,787.95  "
FireWrap® Grip Kit GLOW - Aqua,03/27/2021,Sales Receipt,5186,,"FIREWRAP® GRIP KIT - Yes, I understand.
Color: GLOW Aqua (+$12.95)",1,37.95  ,37.95  ,"19,825.90  "
FireWrap® Grip Kit GLOW - Aqua,03/27/2021,Invoice,M-032721-006,,FireWrap® Grip Kit GLOW - Aqua,1,28.50  ,28.50  ,"19,854.40  "
FireWrap® Grip Kit GLOW - Aqua,03/27/2021,Invoice,M-032721-001,,FireWrap® Grip Kit GLOW - Aqua,1,28.50  ,28.50  ,"19,882.90  "
FireWrap® Grip Kit GLOW - Aqua,04/07/2021,Sales Receipt,5257,,"FIREWRAP® GRIP KIT - Yes, I understand.
Color: GLOW Aqua (+$12.95)",1,37.95  ,37.95  ,"19,920.85  "
FireWrap® Grip Kit GLOW - Aqua,04/10/2021,Sales Receipt,5281,,"FIREWRAP® GRIP KIT - Yes, I understand.
Color: GLOW Aqua (+$12.95)",1,37.95  ,37.95  ,"19,958.80  "
FireWrap® Grip Kit GLOW - Aqua,04/13/2021,Invoice,M-041321-005,,FireWrap® Grip Kit GLOW - Aqua,1,28.50  ,28.50  ,"19,987.30  "
FireWrap® Grip Kit GLOW - Aqua,04/13/2021,Invoice,M-041321-006,,FireWrap® Grip Kit GLOW - Aqua,1,28.50  ,28.50  ,"20,015.80  "
FireWrap® Grip Kit GLOW - Aqua,04/17/2021,Sales Receipt,5312,,"FIREWRAP® GRIP KIT - Yes, I understand.
Color: GLOW Aqua (+$12.95)",1,37.95  ,37.95  ,"20,053.75  "
FireWrap® Grip Kit GLOW - Aqua,04/19/2021,Sales Receipt,5333,,"FIREWRAP® GRIP KIT
Color: GLOW Aqua (+$12.95)",1,37.95  ,37.95  ,"20,091.70  "
FireWrap® Grip Kit GLOW - Aqua,04/20/2021,Sales Receipt,5337,,"FIREWRAP® GRIP KIT
Color: GLOW Aqua (+$12.95)",1,37.95  ,37.95  ,"20,129.65  "
FireWrap® Grip Kit GLOW - Aqua,04/24/2021,Sales Receipt,5374,,"FIREWRAP® GRIP KIT
Color: GLOW Aqua (+$12.95)",1,37.95  ,37.95  ,"20,167.60  "
FireWrap® Grip Kit GLOW - Aqua,04/25/2021,Sales Receipt,5386,,"FIREWRAP® GRIP KIT
Color: GLOW Aqua (+$12.95)",2,37.95  ,75.90  ,"20,243.50  "
FireWrap® Grip Kit GLOW - Aqua,04/25/2021,Sales Receipt,5383,,"FIREWRAP® GRIP KIT
Color: GLOW Aqua (+$12.95)",1,37.95  ,37.95  ,"20,281.45  "
FireWrap® Grip Kit GLOW - Aqua,04/26/2021,Sales Receipt,5396,,"FIREWRAP® GRIP KIT
Color: GLOW Aqua (+$12.95)",1,37.95  ,37.95  ,"20,319.40  "
FireWrap® Grip Kit GLOW - Aqua,04/27/2021,Sales Receipt,5400,,"FIREWRAP® GRIP KIT
Color: GLOW Aqua (+$12.95)",3,37.95  ,113.85  ,"20,433.25  "
FireWrap® Grip Kit GLOW - Aqua,04/28/2021,Sales Receipt,5407,,"FIREWRAP® GRIP KIT
Color: GLOW Aqua (+$12.95)",1,37.95  ,37.95  ,"20,471.20  "
FireWrap® Grip Kit GLOW - Aqua,04/29/2021,Sales Receipt,5416,,"FIREWRAP® GRIP KIT
Color: GLOW Aqua (+$12.95)",1,37.95  ,37.95  ,"20,509.15  "
FireWrap® Grip Kit GLOW - Aqua,05/03/2021,Sales Receipt,5445,,"FIREWRAP® GRIP KIT
Color: GLOW Aqua (+$12.95)",1,37.95  ,37.95  ,"20,547.10  "
FireWrap® Grip Kit GLOW - Aqua,05/08/2021,Sales Receipt,5466,,"FIREWRAP® GRIP KIT
Color: GLOW Aqua (+$12.95)",1,37.95  ,37.95  ,"20,585.05  "
FireWrap® Grip Kit GLOW - Aqua,05/11/2021,Sales Receipt,5481,,"FIREWRAP® GRIP KIT
Color: GLOW Aqua (+$12.95)",2,37.95  ,75.90  ,"20,660.95  "
FireWrap® Grip Kit GLOW - Aqua,05/15/2021,Sales Receipt,5517,,"FIREWRAP® GRIP KIT
Color: GLOW Aqua (+$12.95)",1,37.95  ,37.95  ,"20,698.90  "
FireWrap® Grip Kit GLOW - Aqua,05/15/2021,Sales Receipt,5511,,"FIREWRAP® GRIP KIT
Color: GLOW Aqua (+$12.95)",1,37.95  ,37.95  ,"20,736.85  "
FireWrap® Grip Kit GLOW - Aqua,05/20/2021,Sales Receipt,5543,,"FIREWRAP® GRIP KIT
Color: GLOW Aqua (+$12.95)",1,37.95  ,37.95  ,"20,774.80  "
FireWrap® Grip Kit GLOW - Aqua,05/21/2021,Sales Receipt,5555,,"FIREWRAP® GRIP KIT
Color: GLOW Aqua (+$12.95)",1,37.95  ,37.95  ,"20,812.75  "
FireWrap® Grip Kit GLOW - Aqua,05/21/2021,Sales Receipt,5551,,"FIREWRAP® GRIP KIT
Color: GLOW Aqua (+$12.95)",1,37.95  ,37.95  ,"20,850.70  "
FireWrap® Grip Kit GLOW - Aqua,06/01/2021,Invoice,M-060121-002,,FireWrap® Grip Kit GLOW - Aqua,6,28.50  ,171.00  ,"21,021.70  "
FireWrap® Grip Kit GLOW - Aqua,06/09/2021,Invoice,M-060921-003,,FireWrap® Grip Kit GLOW - Aqua,1,28.50  ,28.50  ,"21,050.20  "
FireWrap® Grip Kit GLOW - Aqua,06/15/2021,Sales Receipt,5673,,"FIREWRAP® GRIP KIT
Color: GLOW Aqua (+$12.95)",1,37.95  ,37.95  ,"21,088.15  "
FireWrap® Grip Kit GLOW - Aqua,06/18/2021,Invoice,M-061821-002,,FireWrap® Grip Kit GLOW - Aqua,1,28.50  ,28.50  ,"21,116.65  "
FireWrap® Grip Kit GLOW - Aqua,06/24/2021,Sales Receipt,5703,,"FIREWRAP® GRIP KIT
Color: GLOW Aqua (+$12.95)",1,37.95  ,37.95  ,"21,154.60  "
FireWrap® Grip Kit GLOW - Aqua,06/24/2021,Sales Receipt,5705,,"FIREWRAP® GRIP KIT
Color: GLOW Aqua (+$12.95)",1,37.95  ,37.95  ,"21,192.55  "
FireWrap® Grip Kit GLOW - Aqua,07/12/2021,Sales Receipt,5772,,"FIREWRAP® GRIP KIT
Color: GLOW Aqua (+$12.95)",1,37.95  ,37.95  ,"21,230.50  "
FireWrap® Grip Kit GLOW - Aqua,08/05/2021,Sales Receipt,5862,,"FIREWRAP® GRIP KIT
Color: GLOW Aqua (+$12.95)",1,37.95  ,37.95  ,"21,268.45  "
FireWrap® Grip Kit GLOW - Aqua,08/05/2021,Sales Receipt,5860,,"FIREWRAP® GRIP KIT
Color: GLOW Aqua (+$12.95)",1,37.95  ,37.95  ,"21,306.40  "
FireWrap® Grip Kit GLOW - Aqua,08/13/2021,Sales Receipt,5910,,"FIREWRAP® GRIP KIT
Color: GLOW Aqua (+$12.95)",1,37.95  ,37.95  ,"21,344.35  "
FireWrap® Grip Kit GLOW - Aqua,09/01/2021,Sales Receipt,6030,,"FIREWRAP® GRIP KIT
Color: GLOW Aqua (+$12.95)",4,37.95  ,151.80  ,"21,496.15  "
FireWrap® Grip Kit GLOW - Aqua,09/01/2021,Sales Receipt,6026,,"FIREWRAP® GRIP KIT
Color: GLOW Aqua (+$12.95)",1,37.95  ,37.95  ,"21,534.10  "
FireWrap® Grip Kit GLOW - Aqua,09/07/2021,Sales Receipt,6052,,"FIREWRAP® GRIP KIT
Color: GLOW Aqua (+$12.95)",1,37.95  ,37.95  ,"21,572.05  "
FireWrap® Grip Kit GLOW - Aqua,09/12/2021,Sales Receipt,6072,,"FIREWRAP® GRIP KIT
Color: GLOW Aqua (+$12.95)",1,37.95  ,37.95  ,"21,610.00  "
FireWrap® Grip Kit GLOW - Aqua,09/14/2021,Sales Receipt,6079,,"FIREWRAP® GRIP KIT
Color: GLOW Aqua (+$12.95)",1,37.95  ,37.95  ,"21,647.95  "
FireWrap® Grip Kit GLOW - Aqua,09/16/2021,Sales Receipt,6089,,"FIREWRAP® GRIP KIT
Color: GLOW Aqua (+$12.95)",1,37.95  ,37.95  ,"21,685.90  "
FireWrap® Grip Kit GLOW - Aqua,09/19/2021,Sales Receipt,6112,,"FIREWRAP® GRIP KIT
Color: GLOW Aqua (+$12.95)",1,37.95  ,37.95  ,"21,723.85  "
FireWrap® Grip Kit GLOW - Aqua,09/29/2021,Sales Receipt,6194,,"FIREWRAP® GRIP KIT
Color: GLOW Aqua (+$12.95)",1,37.95  ,37.95  ,"21,761.80  "
FireWrap® Grip Kit GLOW - Aqua,09/30/2021,Sales Receipt,6198,,"FIREWRAP® GRIP KIT
Color: GLOW Aqua (+$12.95)",1,37.95  ,37.95  ,"21,799.75  "
FireWrap® Grip Kit GLOW - Aqua,10/04/2021,Sales Receipt,6235,,"FIREWRAP® GRIP KIT
Color: GLOW Aqua (+$12.95)",1,37.95  ,37.95  ,"21,837.70  "
FireWrap® Grip Kit GLOW - Aqua,10/04/2021,Sales Receipt,6229,,"FIREWRAP® GRIP KIT
Color: GLOW Aqua (+$12.95)",1,37.95  ,37.95  ,"21,875.65  "
FireWrap® Grip Kit GLOW - Aqua,10/06/2021,Sales Receipt,6251,,"FIREWRAP® GRIP KIT
Color: GLOW Aqua (+$12.95)",1,37.95  ,37.95  ,"21,913.60  "
FireWrap® Grip Kit GLOW - Aqua,10/09/2021,Sales Receipt,6270,,"FIREWRAP® GRIP KIT
Color: GLOW Aqua (+$12.95)",1,37.95  ,37.95  ,"21,951.55  "
FireWrap® Grip Kit GLOW - Aqua,10/17/2021,Sales Receipt,6318,,"FIREWRAP® GRIP KIT
Color: GLOW Aqua (+$12.95)",1,37.95  ,37.95  ,"21,989.50  "
FireWrap® Grip Kit GLOW - Aqua,10/21/2021,Sales Receipt,6345,,"FIREWRAP® GRIP KIT
Color: GLOW Aqua (+$12.95)",1,37.95  ,37.95  ,"22,027.45  "
FireWrap® Grip Kit GLOW - Aqua,10/29/2021,Sales Receipt,6387,,"FIREWRAP® GRIP KIT
Color: GLOW Aqua (+$12.95)",1,37.95  ,37.95  ,"22,065.40  "
FireWrap® Grip Kit GLOW - Aqua,10/31/2021,Sales Receipt,6405,,"FIREWRAP® GRIP KIT
Color: GLOW Aqua (+$12.95)",1,37.95  ,37.95  ,"22,103.35  "
FireWrap® Grip Kit GLOW - Aqua,11/15/2021,Sales Receipt,6517,,"FIREWRAP® GRIP KIT
Color: GLOW Aqua (+$12.95)",1,37.95  ,37.95  ,"22,141.30  "
FireWrap® Grip Kit GLOW - Aqua,11/15/2021,Sales Receipt,6519,,"FIREWRAP® GRIP KIT
Color: GLOW Aqua (+$12.95)",1,37.95  ,37.95  ,"22,179.25  "
FireWrap® Grip Kit GLOW - Aqua,11/18/2021,Sales Receipt,6531,,"FIREWRAP® GRIP KIT
Color: GLOW Aqua (+$12.95)",1,37.95  ,37.95  ,"22,217.20  "
FireWrap® Grip Kit GLOW - Aqua,11/19/2021,Sales Receipt,6542,,"FIREWRAP® GRIP KIT
Color: GLOW Aqua (+$12.95)",1,37.95  ,37.95  ,"22,255.15  "
FireWrap® Grip Kit GLOW - Aqua,11/20/2021,Sales Receipt,6544,,"FIREWRAP® GRIP KIT
Color: GLOW Aqua (+$12.95)",1,37.95  ,37.95  ,"22,293.10  "
FireWrap® Grip Kit GLOW - Aqua,11/24/2021,Sales Receipt,6569,,"FIREWRAP® GRIP KIT
Color: GLOW Aqua (+$12.95)",2,32.99  ,65.98  ,"22,359.08  "
FireWrap® Grip Kit GLOW - Aqua,11/25/2021,Sales Receipt,6583,,"FIREWRAP® GRIP KIT
Color: GLOW Aqua (+$12.95)",1,32.99  ,32.99  ,"22,392.07  "
FireWrap® Grip Kit GLOW - Aqua,11/25/2021,Sales Receipt,6584,,"FIREWRAP® GRIP KIT
Color: GLOW Aqua (+$12.95)",1,32.99  ,32.99  ,"22,425.06  "
FireWrap® Grip Kit GLOW - Aqua,11/30/2021,Sales Receipt,6635,,"FIREWRAP® GRIP KIT
Color: GLOW Aqua (+$12.95)",1,32.99  ,32.99  ,"22,458.05  "
FireWrap® Grip Kit GLOW - Aqua,12/08/2021,Sales Receipt,6704,,"FIREWRAP® GRIP KIT
Color: GLOW Aqua (+$12.95)",1,37.95  ,37.95  ,"22,496.00  "
FireWrap® Grip Kit GLOW - Aqua,12/11/2021,Sales Receipt,6722,,"FIREWRAP® GRIP KIT
Color: GLOW Aqua (+$12.95)",1,37.95  ,37.95  ,"22,533.95  "
FireWrap® Grip Kit GLOW - Aqua,12/14/2021,Sales Receipt,6742,,"FIREWRAP® GRIP KIT
Color: GLOW Aqua (+$12.95)",1,37.95  ,37.95  ,"22,571.90  "
FireWrap® Grip Kit GLOW - Aqua,12/18/2021,Sales Receipt,6776,,"FIREWRAP® GRIP KIT
Color: GLOW Aqua (+$12.95)",1,37.95  ,37.95  ,"22,609.85  "
FireWrap® Grip Kit GLOW - Aqua,01/09/2022,Sales Receipt,6961,,"FIREWRAP® GRIP KIT
Color: GLOW Aqua (+$12.95)",1,37.95  ,37.95  ,"22,647.80  "
FireWrap® Grip Kit GLOW - Aqua,01/12/2022,Sales Receipt,6987,,"FIREWRAP® GRIP KIT
Color: GLOW Aqua (+$12.95)",1,37.95  ,37.95  ,"22,685.75  "
FireWrap® Grip Kit GLOW - Aqua,01/13/2022,Sales Receipt,7002,,"FIREWRAP® GRIP KIT
Color: GLOW Aqua (+$12.95)",1,37.95  ,37.95  ,"22,723.70  "
FireWrap® Grip Kit GLOW - Aqua,01/14/2022,Sales Receipt,7008,,"FIREWRAP® GRIP KIT
Color: GLOW Aqua (+$12.95)",1,37.95  ,37.95  ,"22,761.65  "
FireWrap® Grip Kit GLOW - Aqua,01/17/2022,Sales Receipt,7021,,"FIREWRAP® GRIP KIT
Color: GLOW Aqua (+$12.95)",1,37.95  ,37.95  ,"22,799.60  "
FireWrap® Grip Kit GLOW - Aqua,01/25/2022,Sales Receipt,7096,,"FIREWRAP® GRIP KIT
Color: GLOW Aqua (+$12.95)",1,37.95  ,37.95  ,"22,837.55  "
FireWrap® Grip Kit GLOW - Aqua,01/26/2022,Sales Receipt,7098,,"FIREWRAP® GRIP KIT
Color: GLOW Aqua (+$12.95)",2,37.95  ,75.90  ,"22,913.45  "
FireWrap® Grip Kit GLOW - Aqua,02/01/2022,Sales Receipt,7176,,"FIREWRAP® GRIP KIT
Color: GLOW Aqua (+$12.95)",1,37.95  ,37.95  ,"22,951.40  "
FireWrap® Grip Kit GLOW - Aqua,02/02/2022,Sales Receipt,7181,,"FIREWRAP® GRIP KIT
Color: GLOW Aqua (+$12.95)",2,37.95  ,75.90  ,"23,027.30  "
FireWrap® Grip Kit GLOW - Aqua,02/05/2022,Sales Receipt,7202,,"FIREWRAP® GRIP KIT
Color: GLOW Aqua (+$12.95)",1,40.95  ,40.95  ,"23,068.25  "
FireWrap® Grip Kit GLOW - Aqua,02/09/2022,Sales Receipt,7250,,"FIREWRAP® GRIP KIT
Color: GLOW Aqua (+$12.95)",1,40.95  ,40.95  ,"23,109.20  "
FireWrap® Grip Kit GLOW - Aqua,02/10/2022,Sales Receipt,7256,,"FIREWRAP® GRIP KIT
Color: GLOW Aqua (+$12.95)",1,40.95  ,40.95  ,"23,150.15  "
FireWrap® Grip Kit GLOW - Aqua,02/13/2022,Sales Receipt,7283,,"FIREWRAP® GRIP KIT
Color: GLOW Aqua (+$12.95)",1,40.95  ,40.95  ,"23,191.10  "
FireWrap® Grip Kit GLOW - Aqua,02/16/2022,Sales Receipt,7300,,"FIREWRAP® GRIP KIT
Color: GLOW Aqua (+$12.95)",1,40.95  ,40.95  ,"23,232.05  "
FireWrap® Grip Kit GLOW - Aqua,02/16/2022,Sales Receipt,7301,,"FIREWRAP® GRIP KIT
Color: GLOW Aqua (+$12.95)",1,40.95  ,40.95  ,"23,273.00  "
FireWrap® Grip Kit GLOW - Aqua,02/20/2022,Sales Receipt,7335,,"FIREWRAP® GRIP KIT
Color: GLOW Aqua (+$12.95)",1,40.95  ,40.95  ,"23,313.95  "
FireWrap® Grip Kit GLOW - Aqua,02/21/2022,Sales Receipt,7341,,"FIREWRAP® GRIP KIT
Color: GLOW Aqua (+$12.95)",1,40.95  ,40.95  ,"23,354.90  "
FireWrap® Grip Kit GLOW - Aqua,02/25/2022,Sales Receipt,7390,,"FIREWRAP® GRIP KIT
Color: GLOW Aqua (+$12.95)",1,40.95  ,40.95  ,"23,395.85  "
FireWrap® Grip Kit GLOW - Aqua,02/27/2022,Sales Receipt,7413,,"FIREWRAP® GRIP KIT
Color: GLOW Aqua (+$12.95)",1,40.95  ,40.95  ,"23,436.80  "
FireWrap® Grip Kit GLOW - Aqua,03/01/2022,Sales Receipt,7437,,"FIREWRAP® GRIP KIT
Color: GLOW Aqua (+$12.95)",1,40.95  ,40.95  ,"23,477.75  "
FireWrap® Grip Kit GLOW - Aqua,03/02/2022,Sales Receipt,7452,,"FIREWRAP® GRIP KIT
Color: GLOW Aqua (+$12.95)",1,40.95  ,40.95  ,"23,518.70  "
FireWrap® Grip Kit GLOW - Aqua,03/02/2022,Sales Receipt,7449,,"FIREWRAP® GRIP KIT
Color: GLOW Aqua (+$12.95)",1,40.95  ,40.95  ,"23,559.65  "
FireWrap® Grip Kit GLOW - Aqua,03/02/2022,Sales Receipt,7444,,"FIREWRAP® GRIP KIT
Color: GLOW Aqua (+$12.95)",1,40.95  ,40.95  ,"23,600.60  "
FireWrap® Grip Kit GLOW - Aqua,03/07/2022,Sales Receipt,7496,,"FIREWRAP® GRIP KIT
Color: GLOW Aqua (+$12.95)",1,40.95  ,40.95  ,"23,641.55  "
FireWrap® Grip Kit GLOW - Aqua,03/14/2022,Sales Receipt,7544,,"FIREWRAP® GRIP KIT
Color: GLOW Aqua (+$12.95)",1,40.95  ,40.95  ,"23,682.50  "
FireWrap® Grip Kit GLOW - Aqua,04/14/2022,Sales Receipt,7756,,"FIREWRAP® GRIP KIT
Color: GLOW Aqua (+$12.95)",1,40.95  ,40.95  ,"23,723.45  "
FireWrap® Grip Kit GLOW - Aqua,04/29/2022,Sales Receipt,7843,,"FIREWRAP® GRIP KIT
Color: GLOW Aqua (+$12.95)",2,35.99  ,71.98  ,"23,795.43  "
FireWrap® Grip Kit GLOW - Aqua,05/03/2022,Sales Receipt,7886,,"FIREWRAP® GRIP KIT
Color: GLOW Aqua (+$12.95)",2,35.99  ,71.98  ,"23,867.41  "
FireWrap® Grip Kit GLOW - Aqua,05/05/2022,Sales Receipt,7907,,"FIREWRAP® GRIP KIT
Color: GLOW Aqua (+$12.95)",1,35.99  ,35.99  ,"23,903.40  "
FireWrap® Grip Kit GLOW - Aqua,05/06/2022,Sales Receipt,7912,,"FIREWRAP® GRIP KIT
Color: GLOW Aqua (+$12.95)",1,35.99  ,35.99  ,"23,939.39  "
FireWrap® Grip Kit GLOW - Aqua,05/14/2022,Sales Receipt,7954,,"FIREWRAP® GRIP KIT
Color: GLOW Aqua (+$12.95)",1,40.95  ,40.95  ,"23,980.34  "
FireWrap® Grip Kit GLOW - Aqua,05/17/2022,Sales Receipt,7965,,"FIREWRAP® GRIP KIT
Color: GLOW Aqua (+$12.95)",1,40.95  ,40.95  ,"24,021.29  "
FireWrap® Grip Kit GLOW - Aqua,05/25/2022,Sales Receipt,8000,,"FIREWRAP® GRIP KIT
Color: GLOW Aqua (+$12.95)",1,40.95  ,40.95  ,"24,062.24  "
FireWrap® Grip Kit GLOW - Aqua,05/30/2022,Sales Receipt,8022,,"FIREWRAP® GRIP KIT
Color: GLOW Aqua (+$12.95)",1,40.95  ,40.95  ,"24,103.19  "
FireWrap® Grip Kit GLOW - Aqua,06/06/2022,Sales Receipt,8056,,"FIREWRAP® GRIP KIT
Color: GLOW Aqua (+$13)",1,40.95  ,40.95  ,"24,144.14  "
FireWrap® Grip Kit GLOW - Aqua,06/09/2022,Sales Receipt,8088,,"FIREWRAP® GRIP KIT
Color: GLOW Aqua (+$13)",1,40.95  ,40.95  ,"24,185.09  "
FireWrap® Grip Kit GLOW - Aqua,06/13/2022,Sales Receipt,8120,,"FIREWRAP® GRIP KIT
Color: GLOW Aqua (+$13)",1,40.95  ,40.95  ,"24,226.04  "
FireWrap® Grip Kit GLOW - Aqua,06/16/2022,Sales Receipt,8138,,"FIREWRAP® GRIP KIT
Color: GLOW Aqua (+$13)",1,40.95  ,40.95  ,"24,266.99  "
FireWrap® Grip Kit GLOW - Aqua,06/27/2022,Sales Receipt,8182,,"FIREWRAP® GRIP KIT
Color: GLOW Aqua (+$13)",1,40.95  ,40.95  ,"24,307.94  "
FireWrap® Grip Kit GLOW - Aqua,06/30/2022,Sales Receipt,8208,,"FIREWRAP® GRIP KIT
Color: GLOW Aqua (+$13)",1,40.95  ,40.95  ,"24,348.89  "
FireWrap® Grip Kit GLOW - Aqua,07/08/2022,Sales Receipt,8268,,"FIREWRAP® GRIP KIT
Color: GLOW Aqua (+$13)",1,40.95  ,40.95  ,"24,389.84  "
FireWrap® Grip Kit GLOW - Aqua,07/15/2022,Sales Receipt,8306,,"FIREWRAP® GRIP KIT
Color: GLOW Aqua (+$13)",2,40.95  ,81.90  ,"24,471.74  "
FireWrap® Grip Kit GLOW - Aqua,07/24/2022,Sales Receipt,8354,,"FIREWRAP® GRIP KIT
Color: GLOW Aqua (+$13)",1,40.95  ,40.95  ,"24,512.69  "
FireWrap® Grip Kit GLOW - Aqua,07/28/2022,Sales Receipt,8385,,"FIREWRAP® GRIP KIT
Color: GLOW Aqua (+$13)",1,40.95  ,40.95  ,"24,553.64  "
FireWrap® Grip Kit GLOW - Aqua,07/30/2022,Sales Receipt,8393,,"FIREWRAP® GRIP KIT
Color: GLOW Aqua (+$13)",1,40.95  ,40.95  ,"24,594.59  "
FireWrap® Grip Kit GLOW - Aqua,08/07/2022,Sales Receipt,8438,,"FIREWRAP® GRIP KIT
Color: GLOW Aqua (+$13)",1,40.95  ,40.95  ,"24,635.54  "
FireWrap® Grip Kit GLOW - Aqua,08/15/2022,Sales Receipt,8491,,"FIREWRAP® GRIP KIT
Color: GLOW Aqua (+$13)",1,40.95  ,40.95  ,"24,676.49  "
FireWrap® Grip Kit GLOW - Aqua,08/21/2022,Sales Receipt,8531,,"FIREWRAP® GRIP KIT
Color: GLOW Aqua (+$13)",1,40.95  ,40.95  ,"24,717.44  "
FireWrap® Grip Kit GLOW - Aqua,08/26/2022,Sales Receipt,8563,,"FIREWRAP® GRIP KIT
Color: GLOW Aqua (+$13)",1,40.95  ,40.95  ,"24,758.39  "
FireWrap® Grip Kit GLOW - Aqua,08/28/2022,Sales Receipt,8577,,"FIREWRAP® GRIP KIT
Color: GLOW Aqua (+$13)",1,40.95  ,40.95  ,"24,799.34  "
FireWrap® Grip Kit GLOW - Aqua,09/07/2022,Sales Receipt,8645,,"FIREWRAP® GRIP KIT
Color: GLOW Aqua (+$13)",1,40.95  ,40.95  ,"24,840.29  "
FireWrap® Grip Kit GLOW - Aqua,09/14/2022,Sales Receipt,8684,,"FIREWRAP® GRIP KIT
Color: GLOW Aqua (+$13)",1,40.95  ,40.95  ,"24,881.24  "
FireWrap® Grip Kit GLOW - Aqua,09/19/2022,Sales Receipt,8719,,"FIREWRAP® GRIP KIT
Color: GLOW Aqua (+$13)",2,40.95  ,81.90  ,"24,963.14  "
FireWrap® Grip Kit GLOW - Aqua,09/19/2022,Sales Receipt,8709,,"FIREWRAP® GRIP KIT
Color: GLOW Aqua (+$13)",1,40.95  ,40.95  ,"25,004.09  "
FireWrap® Grip Kit GLOW - Aqua,09/22/2022,Sales Receipt,8735,,"FIREWRAP® GRIP KIT
Color: GLOW Aqua (+$13)",1,40.95  ,40.95  ,"25,045.04  "
FireWrap® Grip Kit GLOW - Aqua,09/22/2022,Sales Receipt,8740,,"FIREWRAP® GRIP KIT
Color: GLOW Aqua (+$13)",1,40.95  ,40.95  ,"25,085.99  "
FireWrap® Grip Kit GLOW - Aqua,09/27/2022,Sales Receipt,8760,,"FIREWRAP® GRIP KIT
Color: GLOW Aqua (+$13)",1,40.95  ,40.95  ,"25,126.94  "
FireWrap® Grip Kit GLOW - Aqua,09/29/2022,Sales Receipt,8803,,"FIREWRAP® GRIP KIT
Color: GLOW Aqua (+$13)",1,40.95  ,40.95  ,"25,167.89  "
FireWrap® Grip Kit GLOW - Aqua,09/29/2022,Sales Receipt,8799,,"FIREWRAP® GRIP KIT
Color: GLOW Aqua (+$13)",5,40.95  ,204.75  ,"25,372.64  "
FireWrap® Grip Kit GLOW - Aqua,10/10/2022,Sales Receipt,8880,,"FIREWRAP® GRIP KIT
Color: GLOW Aqua (+$13)",1,40.95  ,40.95  ,"25,413.59  "
FireWrap® Grip Kit GLOW - Aqua,10/11/2022,Sales Receipt,8889,,"FIREWRAP® GRIP KIT
Color: GLOW Aqua (+$13)",3,40.95  ,122.85  ,"25,536.44  "
FireWrap® Grip Kit GLOW - Aqua,10/11/2022,Sales Receipt,8891,,"FIREWRAP® GRIP KIT
Color: GLOW Aqua (+$13)",1,40.95  ,40.95  ,"25,577.39  "
FireWrap® Grip Kit GLOW - Aqua,10/19/2022,Sales Receipt,8943,,"FIREWRAP® GRIP KIT
Color: GLOW Aqua (+$13)",1,40.95  ,40.95  ,"25,618.34  "
FireWrap® Grip Kit GLOW - Aqua,10/20/2022,Sales Receipt,8945,,"FIREWRAP® GRIP KIT
Color: GLOW Aqua (+$13)",1,40.95  ,40.95  ,"25,659.29  "
FireWrap® Grip Kit GLOW - Aqua,10/23/2022,Sales Receipt,8968,,"FIREWRAP® GRIP KIT
Color: GLOW Aqua (+$13)",1,40.95  ,40.95  ,"25,700.24  "
FireWrap® Grip Kit GLOW - Aqua,10/24/2022,Sales Receipt,8970,,"FIREWRAP® GRIP KIT
Color: GLOW Aqua (+$13)",1,40.95  ,40.95  ,"25,741.19  "
FireWrap® Grip Kit GLOW - Aqua,10/26/2022,Sales Receipt,8981,,"FIREWRAP® GRIP KIT
Color: GLOW Aqua (+$13)",2,40.95  ,81.90  ,"25,823.09  "
FireWrap® Grip Kit GLOW - Aqua,10/27/2022,Sales Receipt,8989,,"FIREWRAP® GRIP KIT
Color: GLOW Aqua (+$13)",1,40.95  ,40.95  ,"25,864.04  "
FireWrap® Grip Kit GLOW - Aqua,11/05/2022,Sales Receipt,M-114-2041777-2165829,,FireWrap® Grip Kit - Glow Aqua,1,41.95  ,41.95  ,"25,905.99  "
FireWrap® Grip Kit GLOW - Aqua,11/06/2022,Sales Receipt,9032,,"FIREWRAP® GRIP KIT
Color: GLOW Aqua (+$13)",1,40.95  ,40.95  ,"25,946.94  "
FireWrap® Grip Kit GLOW - Aqua,11/06/2022,Sales Receipt,9031,,"FIREWRAP® GRIP KIT
Color: GLOW Aqua (+$13)",2,40.95  ,81.90  ,"26,028.84  "
FireWrap® Grip Kit GLOW - Aqua,11/09/2022,Sales Receipt,9055,,"FIREWRAP® GRIP KIT
Color: GLOW Aqua (+$13)",4,40.95  ,163.80  ,"26,192.64  "
FireWrap® Grip Kit GLOW - Aqua,11/18/2022,Sales Receipt,M-112-1950699-1808228,,FireWrap® Grip Kit - Glow Aqua,1,41.95  ,41.95  ,"26,234.59  "
FireWrap® Grip Kit GLOW - Aqua,11/18/2022,Sales Receipt,9117,,"FIREWRAP® GRIP KIT
Color: GLOW Aqua (+$13)",10,40.95  ,409.50  ,"26,644.09  "
FireWrap® Grip Kit GLOW - Aqua,11/22/2022,Sales Receipt,9136,,"FIREWRAP® GRIP KIT
Color: GLOW Aqua (+$13)",1,40.95  ,40.95  ,"26,685.04  "
FireWrap® Grip Kit GLOW - Aqua,11/27/2022,Sales Receipt,9187,,"FIREWRAP® GRIP KIT
Color: GLOW Aqua (+$13)",2,40.95  ,81.90  ,"26,766.94  "
FireWrap® Grip Kit GLOW - Aqua,12/06/2022,Sales Receipt,M-114-4941536-6550617,,FireWrap® Grip Kit - Glow Aqua,1,41.95  ,41.95  ,"26,808.89  "
FireWrap® Grip Kit GLOW - Aqua,12/11/2022,Sales Receipt,9302,,"FIREWRAP® GRIP KIT
Color: GLOW Aqua (+$13)",1,40.95  ,40.95  ,"26,849.84  "
FireWrap® Grip Kit GLOW - Aqua,12/14/2022,Sales Receipt,M-113-0989543-0946656,,FireWrap® Grip Kit - Glow Aqua,1,41.95  ,41.95  ,"26,891.79  "
FireWrap® Grip Kit GLOW - Aqua,12/16/2022,Sales Receipt,M-111-7214147-3365866,,FireWrap® Grip Kit - Glow Aqua,1,41.95  ,41.95  ,"26,933.74  "
FireWrap® Grip Kit GLOW - Aqua,12/17/2022,Sales Receipt,9351,,"FIREWRAP® GRIP KIT
Color: GLOW Aqua (+$13)",1,40.95  ,40.95  ,"26,974.69  "
FireWrap® Grip Kit GLOW - Aqua,12/18/2022,Sales Receipt,M-113-6770809-1272259,,FireWrap® Grip Kit - Glow Aqua,1,41.95  ,41.95  ,"27,016.64  "
FireWrap® Grip Kit GLOW - Aqua,12/19/2022,Sales Receipt,M-114-4570455-8648243,,FireWrap® Grip Kit - Glow Aqua,1,41.95  ,41.95  ,"27,058.59  "
FireWrap® Grip Kit GLOW - Aqua,12/30/2022,Sales Receipt,M-113-2162709-3189857,,FireWrap® Grip Kit - Glow Aqua,1,41.95  ,41.95  ,"27,100.54  "
FireWrap® Grip Kit GLOW - Aqua,01/01/2023,Sales Receipt,M-114-8957068-8646648,,FireWrap® Grip Kit - Glow Aqua,1,41.95  ,41.95  ,"27,142.49  "
FireWrap® Grip Kit GLOW - Aqua,01/05/2023,Sales Receipt,M-111-8822639-0987432,,FireWrap® Grip Kit - Glow Aqua,2,41.95  ,83.90  ,"27,226.39  "
FireWrap® Grip Kit GLOW - Aqua,01/05/2023,Sales Receipt,M-114-3205973-1455452,,FireWrap® Grip Kit - Glow Aqua,1,41.95  ,41.95  ,"27,268.34  "
FireWrap® Grip Kit GLOW - Aqua,01/07/2023,Sales Receipt,9471,,"FIREWRAP® GRIP KIT
Color: GLOW Aqua (+$13)",1,40.95  ,40.95  ,"27,309.29  "
Total for FireWrap® Grip Kit GLOW - Aqua,,,,,,699,,"$	27,309.29  ",
FireWrap® Grip Kit GLOW - Green ( 927 ),,,,,,,,,
FireWrap® Grip Kit GLOW - Green ( 927 ),02/10/2019,Sales Receipt,#2282,,FireWrap™ Grip Kit,3,47.95  ,143.85  ,143.85  
FireWrap® Grip Kit GLOW - Green ( 927 ),03/01/2019,Sales Receipt,#2357,,FireWrap Grip Kit,1,47.95  ,47.95  ,191.80  
FireWrap® Grip Kit GLOW - Green ( 927 ),03/03/2019,Sales Receipt,#2362,,FireWrap Grip Kit,1,47.95  ,47.95  ,239.75  
FireWrap® Grip Kit GLOW - Green ( 927 ),03/04/2019,Sales Receipt,#2365,,FireWrap Grip Kit,1,47.95  ,47.95  ,287.70  
FireWrap® Grip Kit GLOW - Green ( 927 ),03/10/2019,Sales Receipt,#2397,,FireWrap Grip Kit,1,47.95  ,47.95  ,335.65  
FireWrap® Grip Kit GLOW - Green ( 927 ),03/16/2019,Sales Receipt,#2416,,FireWrap Grip Kit,1,47.95  ,47.95  ,383.60  
FireWrap® Grip Kit GLOW - Green ( 927 ),03/22/2019,Sales Receipt,#2434,,FireWrap Grip Kit,1,47.95  ,47.95  ,431.55  
FireWrap® Grip Kit GLOW - Green ( 927 ),04/06/2019,Sales Receipt,#2495,,FireWrap Grip Kit,1,47.95  ,47.95  ,479.50  
FireWrap® Grip Kit GLOW - Green ( 927 ),07/11/2019,Sales Receipt,#2772,,FireWrap® Grip Kit,1,47.95  ,47.95  ,527.45  
FireWrap® Grip Kit GLOW - Green ( 927 ),07/12/2019,Sales Receipt,#2775,,FireWrap® Grip Kit,2,47.95  ,95.90  ,623.35  
FireWrap® Grip Kit GLOW - Green ( 927 ),07/15/2019,Sales Receipt,#2786,,FireWrap® Grip Kit,1,47.95  ,47.95  ,671.30  
FireWrap® Grip Kit GLOW - Green ( 927 ),07/16/2019,Sales Receipt,#2789,,FireWrap® Grip Kit,1,47.95  ,47.95  ,719.25  
FireWrap® Grip Kit GLOW - Green ( 927 ),07/20/2019,Sales Receipt,#2797,,FireWrap® Grip Kit,1,47.95  ,47.95  ,767.20  
FireWrap® Grip Kit GLOW - Green ( 927 ),07/20/2019,Sales Receipt,#2800,,FireWrap® Grip Kit,1,47.95  ,47.95  ,815.15  
FireWrap® Grip Kit GLOW - Green ( 927 ),07/25/2019,Invoice,M-072519-001,,FireWrap Grip Kit - Glow - Green,1,36.00  ,36.00  ,851.15  
FireWrap® Grip Kit GLOW - Green ( 927 ),08/09/2019,Sales Receipt,#2829,,FireWrap® Grip Kit,4,47.95  ,191.80  ,"1,042.95  "
FireWrap® Grip Kit GLOW - Green ( 927 ),08/19/2019,Invoice,M-081919-001,,FireWrap Grip Kit - Glow - Green,2,36.00  ,72.00  ,"1,114.95  "
FireWrap® Grip Kit GLOW - Green ( 927 ),08/21/2019,Sales Receipt,#2842,,FireWrap® Grip Kit,1,47.95  ,47.95  ,"1,162.90  "
FireWrap® Grip Kit GLOW - Green ( 927 ),08/29/2019,Sales Receipt,#2854,,FireWrap® Grip Kit,1,47.95  ,47.95  ,"1,210.85  "
FireWrap® Grip Kit GLOW - Green ( 927 ),09/05/2019,Invoice,M-090519-001,,FireWrap Grip Kit - Glow - Green,8,36.00  ,288.00  ,"1,498.85  "
FireWrap® Grip Kit GLOW - Green ( 927 ),09/10/2019,Sales Receipt,#2875,,FireWrap® Grip Kit,3,47.95  ,143.85  ,"1,642.70  "
FireWrap® Grip Kit GLOW - Green ( 927 ),09/10/2019,Invoice,M-082819-002,,FireWrap Grip Kit - Glow - Green,2,36.00  ,72.00  ,"1,714.70  "
FireWrap® Grip Kit GLOW - Green ( 927 ),09/24/2019,Invoice,M-091319-001,,FireWrap Grip Kit - Glow - Green,3,36.00  ,108.00  ,"1,822.70  "
FireWrap® Grip Kit GLOW - Green ( 927 ),10/04/2019,Sales Receipt,#2917,,FireWrap® Grip Kit,1,47.95  ,47.95  ,"1,870.65  "
FireWrap® Grip Kit GLOW - Green ( 927 ),10/04/2019,Sales Receipt,#2918,,FireWrap® Grip Kit,3,47.95  ,143.85  ,"2,014.50  "
FireWrap® Grip Kit GLOW - Green ( 927 ),10/05/2019,Sales Receipt,#2919,,FireWrap® Grip Kit,1,47.95  ,47.95  ,"2,062.45  "
FireWrap® Grip Kit GLOW - Green ( 927 ),10/10/2019,Sales Receipt,#2939,,SHOW Special FireWrap® Grip Kit,1,37.95  ,37.95  ,"2,100.40  "
FireWrap® Grip Kit GLOW - Green ( 927 ),10/10/2019,Sales Receipt,#2933,,FireWrap® Grip Kit,1,47.95  ,47.95  ,"2,148.35  "
FireWrap® Grip Kit GLOW - Green ( 927 ),10/11/2019,Sales Receipt,#2953,,SHOW Special FireWrap® Grip Kit,1,37.95  ,37.95  ,"2,186.30  "
FireWrap® Grip Kit GLOW - Green ( 927 ),10/11/2019,Sales Receipt,#2948,,SHOW Special FireWrap® Grip Kit,1,37.95  ,37.95  ,"2,224.25  "
FireWrap® Grip Kit GLOW - Green ( 927 ),10/11/2019,Sales Receipt,#2942,,SHOW Special FireWrap® Grip Kit,1,37.95  ,37.95  ,"2,262.20  "
FireWrap® Grip Kit GLOW - Green ( 927 ),10/12/2019,Sales Receipt,#2961,,FireWrap® Grip Kit,2,47.95  ,95.90  ,"2,358.10  "
FireWrap® Grip Kit GLOW - Green ( 927 ),10/12/2019,Sales Receipt,#2965,,SHOW Special FireWrap® Grip Kit,1,37.95  ,37.95  ,"2,396.05  "
FireWrap® Grip Kit GLOW - Green ( 927 ),10/25/2019,Invoice,M-102519-002,,FireWrap Grip Kit - Glow - Green,2,36.00  ,72.00  ,"2,468.05  "
FireWrap® Grip Kit GLOW - Green ( 927 ),10/30/2019,Sales Receipt,#2995,,FireWrap® Grip Kit,1,47.95  ,47.95  ,"2,516.00  "
FireWrap® Grip Kit GLOW - Green ( 927 ),11/04/2019,Sales Receipt,#3005,,FireWrap® Grip Kit,1,47.95  ,47.95  ,"2,563.95  "
FireWrap® Grip Kit GLOW - Green ( 927 ),11/11/2019,Invoice,M-111119-001,,FireWrap Grip Kit - Glow - Green,4,36.00  ,144.00  ,"2,707.95  "
FireWrap® Grip Kit GLOW - Green ( 927 ),11/13/2019,Sales Receipt,#3023,,FireWrap® Grip Kit,1,47.95  ,47.95  ,"2,755.90  "
FireWrap® Grip Kit GLOW - Green ( 927 ),11/22/2019,Sales Receipt,#3043,,FireWrap® Grip Kit,1,47.95  ,47.95  ,"2,803.85  "
FireWrap® Grip Kit GLOW - Green ( 927 ),11/24/2019,Sales Receipt,#3048,,FireWrap® Grip Kit,1,47.95  ,47.95  ,"2,851.80  "
FireWrap® Grip Kit GLOW - Green ( 927 ),11/24/2019,Sales Receipt,#3050,,FireWrap® Grip Kit,1,47.95  ,47.95  ,"2,899.75  "
FireWrap® Grip Kit GLOW - Green ( 927 ),12/03/2019,Sales Receipt,#3093,,FireWrap® Grip Kit,1,47.95  ,47.95  ,"2,947.70  "
FireWrap® Grip Kit GLOW - Green ( 927 ),12/06/2019,Invoice,M-120219-001,,FireWrap Grip Kit - Glow - Green,1,36.00  ,36.00  ,"2,983.70  "
FireWrap® Grip Kit GLOW - Green ( 927 ),12/06/2019,Invoice,M-112519-003,,FireWrap Grip Kit - Glow - Green,1,36.00  ,36.00  ,"3,019.70  "
FireWrap® Grip Kit GLOW - Green ( 927 ),12/18/2019,Sales Receipt,#3119,,FireWrap® Grip Kit,1,47.95  ,47.95  ,"3,067.65  "
FireWrap® Grip Kit GLOW - Green ( 927 ),12/27/2019,Sales Receipt,#3133,,FireWrap® Grip Kit,4,47.95  ,191.80  ,"3,259.45  "
FireWrap® Grip Kit GLOW - Green ( 927 ),12/30/2019,Sales Receipt,#3140,,FireWrap® Grip Kit,2,47.95  ,95.90  ,"3,355.35  "
FireWrap® Grip Kit GLOW - Green ( 927 ),01/02/2020,Sales Receipt,#3148,,FireWrap® Grip Kit,1,47.95  ,47.95  ,"3,403.30  "
FireWrap® Grip Kit GLOW - Green ( 927 ),01/03/2020,Sales Receipt,#3150,,FireWrap® Grip Kit,1,37.95  ,37.95  ,"3,441.25  "
FireWrap® Grip Kit GLOW - Green ( 927 ),01/05/2020,Sales Receipt,#3154,,FireWrap® Grip Kit,1,37.95  ,37.95  ,"3,479.20  "
FireWrap® Grip Kit GLOW - Green ( 927 ),01/08/2020,Invoice,M-010820-004,,FireWrap Grip Kit - Glow - Green,1,36.00  ,36.00  ,"3,515.20  "
FireWrap® Grip Kit GLOW - Green ( 927 ),01/10/2020,Invoice,M-011420-001,,FireWrap Grip Kit - Glow - Green,1,28.50  ,28.50  ,"3,543.70  "
FireWrap® Grip Kit GLOW - Green ( 927 ),01/12/2020,Sales Receipt,#3166,,FireWrap® Grip Kit,2,37.95  ,75.90  ,"3,619.60  "
FireWrap® Grip Kit GLOW - Green ( 927 ),01/13/2020,Invoice,D-011320-002,,FireWrap Grip Kit - Glow - Green,2,47.95  ,95.90  ,"3,715.50  "
FireWrap® Grip Kit GLOW - Green ( 927 ),01/13/2020,Sales Receipt,#3171,,FireWrap® Grip Kit,1,37.95  ,37.95  ,"3,753.45  "
FireWrap® Grip Kit GLOW - Green ( 927 ),01/24/2020,Sales Receipt,#3193,,FireWrap® Grip Kit,1,37.95  ,37.95  ,"3,791.40  "
FireWrap® Grip Kit GLOW - Green ( 927 ),01/25/2020,Sales Receipt,#3195,,FireWrap® Grip Kit,1,37.95  ,37.95  ,"3,829.35  "
FireWrap® Grip Kit GLOW - Green ( 927 ),02/03/2020,Sales Receipt,#3213,,FireWrap® Grip Kit,1,37.95  ,37.95  ,"3,867.30  "
FireWrap® Grip Kit GLOW - Green ( 927 ),02/10/2020,Sales Receipt,#3237,,FireWrap® Grip Kit,8,37.95  ,303.60  ,"4,170.90  "
FireWrap® Grip Kit GLOW - Green ( 927 ),02/10/2020,Sales Receipt,#3234,,FireWrap® Grip Kit,1,37.95  ,37.95  ,"4,208.85  "
FireWrap® Grip Kit GLOW - Green ( 927 ),02/15/2020,Sales Receipt,#3251,,FireWrap® Grip Kit,1,37.95  ,37.95  ,"4,246.80  "
FireWrap® Grip Kit GLOW - Green ( 927 ),02/19/2020,Sales Receipt,#3266,,FireWrap® Grip Kit,1,37.95  ,37.95  ,"4,284.75  "
FireWrap® Grip Kit GLOW - Green ( 927 ),02/20/2020,Sales Receipt,#3269,,FireWrap® Grip Kit,1,37.95  ,37.95  ,"4,322.70  "
FireWrap® Grip Kit GLOW - Green ( 927 ),02/22/2020,Invoice,M-022220-001,,FireWrap Grip Kit - Glow - Green,3,28.50  ,85.50  ,"4,408.20  "
FireWrap® Grip Kit GLOW - Green ( 927 ),02/23/2020,Sales Receipt,#3343,,FireWrap® Grip Kit,2,37.95  ,75.90  ,"4,484.10  "
FireWrap® Grip Kit GLOW - Green ( 927 ),02/23/2020,Sales Receipt,#3349,,FireWrap® Grip Kit,1,37.95  ,37.95  ,"4,522.05  "
FireWrap® Grip Kit GLOW - Green ( 927 ),02/25/2020,Sales Receipt,#3369,,FireWrap® Grip Kit,1,37.95  ,37.95  ,"4,560.00  "
FireWrap® Grip Kit GLOW - Green ( 927 ),02/27/2020,Sales Receipt,#3386,,FireWrap® Grip Kit,1,37.95  ,37.95  ,"4,597.95  "
FireWrap® Grip Kit GLOW - Green ( 927 ),02/27/2020,Sales Receipt,#3385,,FireWrap® Grip Kit,2,37.95  ,75.90  ,"4,673.85  "
FireWrap® Grip Kit GLOW - Green ( 927 ),03/02/2020,Invoice,M-030220-001,,FireWrap Grip Kit - Glow - Green,5,28.50  ,142.50  ,"4,816.35  "
FireWrap® Grip Kit GLOW - Green ( 927 ),03/03/2020,Invoice,M-030320-001,,FireWrap Grip Kit - Glow - Green,2,37.95  ,75.90  ,"4,892.25  "
FireWrap® Grip Kit GLOW - Green ( 927 ),03/04/2020,Sales Receipt,#3436,,FireWrap® Grip Kit,1,37.95  ,37.95  ,"4,930.20  "
FireWrap® Grip Kit GLOW - Green ( 927 ),03/05/2020,Sales Receipt,#3464,,FireWrap® Grip Kit,1,37.95  ,37.95  ,"4,968.15  "
FireWrap® Grip Kit GLOW - Green ( 927 ),03/10/2020,Sales Receipt,#3500,,FireWrap® Grip Kit,1,37.95  ,37.95  ,"5,006.10  "
FireWrap® Grip Kit GLOW - Green ( 927 ),03/12/2020,Sales Receipt,#3524,,FireWrap® Grip Kit,1,37.95  ,37.95  ,"5,044.05  "
FireWrap® Grip Kit GLOW - Green ( 927 ),03/21/2020,Invoice,M-032120-001,,FireWrap Grip Kit - Glow - Green,0,,0.00  ,"5,044.05  "
FireWrap® Grip Kit GLOW - Green ( 927 ),03/23/2020,Invoice,M-032320-003,,FireWrap Grip Kit - Glow - Green,2,37.95  ,75.90  ,"5,119.95  "
FireWrap® Grip Kit GLOW - Green ( 927 ),03/23/2020,Invoice,M-032320-001,,FireWrap Grip Kit - Glow - Green,3,28.50  ,85.50  ,"5,205.45  "
FireWrap® Grip Kit GLOW - Green ( 927 ),03/25/2020,Sales Receipt,#3574,,FireWrap® Grip Kit,1,37.95  ,37.95  ,"5,243.40  "
FireWrap® Grip Kit GLOW - Green ( 927 ),03/26/2020,Sales Receipt,#3583,,FireWrap® Grip Kit,1,37.95  ,37.95  ,"5,281.35  "
FireWrap® Grip Kit GLOW - Green ( 927 ),03/27/2020,Sales Receipt,#3586,,FireWrap® Grip Kit,1,37.95  ,37.95  ,"5,319.30  "
FireWrap® Grip Kit GLOW - Green ( 927 ),04/03/2020,Sales Receipt,#3608,,FireWrap® Grip Kit,1,37.95  ,37.95  ,"5,357.25  "
FireWrap® Grip Kit GLOW - Green ( 927 ),04/03/2020,Sales Receipt,3608,,FireWrap® Grip Kit - GLOW - Green,1,37.95  ,37.95  ,"5,395.20  "
FireWrap® Grip Kit GLOW - Green ( 927 ),04/08/2020,Sales Receipt,3617,,FireWrap® Grip Kit - GLOW - Green,1,37.95  ,37.95  ,"5,433.15  "
FireWrap® Grip Kit GLOW - Green ( 927 ),04/08/2020,Sales Receipt,#3617,,FireWrap® Grip Kit,1,37.95  ,37.95  ,"5,471.10  "
FireWrap® Grip Kit GLOW - Green ( 927 ),04/12/2020,Sales Receipt,#3628,,FireWrap® Grip Kit,1,37.95  ,37.95  ,"5,509.05  "
FireWrap® Grip Kit GLOW - Green ( 927 ),04/12/2020,Sales Receipt,3628,,FireWrap® Grip Kit - GLOW - Green,1,37.95  ,37.95  ,"5,547.00  "
FireWrap® Grip Kit GLOW - Green ( 927 ),04/18/2020,Sales Receipt,3654,,FireWrap® Grip Kit - GLOW - Green,1,37.95  ,37.95  ,"5,584.95  "
FireWrap® Grip Kit GLOW - Green ( 927 ),04/18/2020,Sales Receipt,#3654,,FireWrap® Grip Kit,1,37.95  ,37.95  ,"5,622.90  "
FireWrap® Grip Kit GLOW - Green ( 927 ),04/19/2020,Sales Receipt,3661,,FireWrap® Grip Kit - GLOW - Green,1,37.95  ,37.95  ,"5,660.85  "
FireWrap® Grip Kit GLOW - Green ( 927 ),04/20/2020,Sales Receipt,#3661,,FireWrap® Grip Kit,1,37.95  ,37.95  ,"5,698.80  "
FireWrap® Grip Kit GLOW - Green ( 927 ),04/22/2020,Sales Receipt,#3678,,FireWrap® Grip Kit,1,37.95  ,37.95  ,"5,736.75  "
FireWrap® Grip Kit GLOW - Green ( 927 ),04/22/2020,Sales Receipt,3678,,FireWrap® Grip Kit - GLOW - Green,1,37.95  ,37.95  ,"5,774.70  "
FireWrap® Grip Kit GLOW - Green ( 927 ),04/27/2020,Invoice,M-042720-002,,FireWrap Grip Kit - Glow - Green,1,28.50  ,28.50  ,"5,803.20  "
FireWrap® Grip Kit GLOW - Green ( 927 ),04/30/2020,Sales Receipt,3709,,FireWrap® Grip Kit - GLOW - Green,1,37.95  ,37.95  ,"5,841.15  "
FireWrap® Grip Kit GLOW - Green ( 927 ),04/30/2020,Sales Receipt,#3709,,FireWrap® Grip Kit,1,37.95  ,37.95  ,"5,879.10  "
FireWrap® Grip Kit GLOW - Green ( 927 ),05/02/2020,Sales Receipt,3719,,FireWrap® Grip Kit - GLOW - Green,1,37.95  ,37.95  ,"5,917.05  "
FireWrap® Grip Kit GLOW - Green ( 927 ),05/03/2020,Sales Receipt,#3719,,FireWrap® Grip Kit,1,37.95  ,37.95  ,"5,955.00  "
FireWrap® Grip Kit GLOW - Green ( 927 ),05/06/2020,Sales Receipt,3728,,FireWrap® Grip Kit - GLOW - Green,2,37.95  ,75.90  ,"6,030.90  "
FireWrap® Grip Kit GLOW - Green ( 927 ),05/07/2020,Sales Receipt,3732,,FireWrap® Grip Kit - GLOW - Green,1,37.95  ,37.95  ,"6,068.85  "
FireWrap® Grip Kit GLOW - Green ( 927 ),05/08/2020,Sales Receipt,3742,,FireWrap® Grip Kit - GLOW - Green,1,37.95  ,37.95  ,"6,106.80  "
FireWrap® Grip Kit GLOW - Green ( 927 ),05/13/2020,Sales Receipt,3757,,FireWrap® Grip Kit - GLOW - Green,1,37.95  ,37.95  ,"6,144.75  "
FireWrap® Grip Kit GLOW - Green ( 927 ),05/15/2020,Sales Receipt,3767,,FireWrap® Grip Kit - GLOW - Green,1,37.95  ,37.95  ,"6,182.70  "
FireWrap® Grip Kit GLOW - Green ( 927 ),05/22/2020,Invoice,M-052220-001,,Grip Kit - GLOW - Green,1,28.50  ,28.50  ,"6,211.20  "
FireWrap® Grip Kit GLOW - Green ( 927 ),06/01/2020,Sales Receipt,3819,,FireWrap® Grip Kit - GLOW - Green,1,37.95  ,37.95  ,"6,249.15  "
FireWrap® Grip Kit GLOW - Green ( 927 ),06/03/2020,Invoice,M-060320-006,,Grip Kit - GLOW - Green,1,28.50  ,28.50  ,"6,277.65  "
FireWrap® Grip Kit GLOW - Green ( 927 ),06/06/2020,Sales Receipt,3831,,FireWrap® Grip Kit - GLOW - Green,1,37.95  ,37.95  ,"6,315.60  "
FireWrap® Grip Kit GLOW - Green ( 927 ),06/11/2020,Sales Receipt,3850,,FireWrap® Grip Kit - GLOW - Green,1,37.95  ,37.95  ,"6,353.55  "
FireWrap® Grip Kit GLOW - Green ( 927 ),06/15/2020,Sales Receipt,3867,,FireWrap® Grip Kit - GLOW - Green,1,37.95  ,37.95  ,"6,391.50  "
FireWrap® Grip Kit GLOW - Green ( 927 ),06/19/2020,Sales Receipt,3889,,FireWrap® Grip Kit - GLOW - Green,1,37.95  ,37.95  ,"6,429.45  "
FireWrap® Grip Kit GLOW - Green ( 927 ),06/23/2020,Sales Receipt,3943,,FireWrap® Grip Kit - GLOW - Green,2,37.95  ,75.90  ,"6,505.35  "
FireWrap® Grip Kit GLOW - Green ( 927 ),06/25/2020,Sales Receipt,3949,,FireWrap® Grip Kit - GLOW - Green,1,37.95  ,37.95  ,"6,543.30  "
FireWrap® Grip Kit GLOW - Green ( 927 ),06/30/2020,Invoice,M-063020-001,,Grip Kit - GLOW - Green,1,28.50  ,28.50  ,"6,571.80  "
FireWrap® Grip Kit GLOW - Green ( 927 ),07/05/2020,Sales Receipt,3993,,FireWrap® Grip Kit - GLOW - Green,2,37.95  ,75.90  ,"6,647.70  "
FireWrap® Grip Kit GLOW - Green ( 927 ),07/09/2020,Sales Receipt,4005,,FireWrap® Grip Kit - GLOW - Green,1,37.95  ,37.95  ,"6,685.65  "
FireWrap® Grip Kit GLOW - Green ( 927 ),07/12/2020,Sales Receipt,4014,,FireWrap® Grip Kit - GLOW - Green,1,37.95  ,37.95  ,"6,723.60  "
FireWrap® Grip Kit GLOW - Green ( 927 ),07/14/2020,Invoice,M-071320-002,,Grip Kit - GLOW - Green,1,28.50  ,28.50  ,"6,752.10  "
FireWrap® Grip Kit GLOW - Green ( 927 ),07/18/2020,Sales Receipt,4029,,FireWrap® Grip Kit - GLOW - Green,1,37.95  ,37.95  ,"6,790.05  "
FireWrap® Grip Kit GLOW - Green ( 927 ),07/23/2020,Invoice,M-072320-002,,Grip Kit - GLOW - Green,1,28.50  ,28.50  ,"6,818.55  "
FireWrap® Grip Kit GLOW - Green ( 927 ),07/25/2020,Sales Receipt,4054,,FireWrap® Grip Kit - GLOW - Green,1,37.95  ,37.95  ,"6,856.50  "
FireWrap® Grip Kit GLOW - Green ( 927 ),07/25/2020,Sales Receipt,4053,,FireWrap® Grip Kit - GLOW - Green,1,37.95  ,37.95  ,"6,894.45  "
FireWrap® Grip Kit GLOW - Green ( 927 ),08/01/2020,Sales Receipt,4073,,FireWrap® Grip Kit - GLOW - Green,1,37.95  ,37.95  ,"6,932.40  "
FireWrap® Grip Kit GLOW - Green ( 927 ),08/07/2020,Sales Receipt,4085,,FireWrap® Grip Kit - GLOW - Green,1,37.95  ,37.95  ,"6,970.35  "
FireWrap® Grip Kit GLOW - Green ( 927 ),08/11/2020,Invoice,M-081120-004,,Grip Kit - GLOW - Green,1,28.50  ,28.50  ,"6,998.85  "
FireWrap® Grip Kit GLOW - Green ( 927 ),08/11/2020,Invoice,M-081120-001,,Grip Kit - GLOW - Green,1,28.50  ,28.50  ,"7,027.35  "
FireWrap® Grip Kit GLOW - Green ( 927 ),08/11/2020,Sales Receipt,4098,,FireWrap® Grip Kit - GLOW - Green,2,37.95  ,75.90  ,"7,103.25  "
FireWrap® Grip Kit GLOW - Green ( 927 ),08/14/2020,Sales Receipt,4105,,FireWrap® Grip Kit - GLOW - Green,1,37.95  ,37.95  ,"7,141.20  "
FireWrap® Grip Kit GLOW - Green ( 927 ),08/31/2020,Invoice,M-083120-006,,Grip Kit - GLOW - Green,1,28.50  ,28.50  ,"7,169.70  "
FireWrap® Grip Kit GLOW - Green ( 927 ),09/04/2020,Invoice,M-090420-001,,Grip Kit - GLOW - Green,1,28.50  ,28.50  ,"7,198.20  "
FireWrap® Grip Kit GLOW - Green ( 927 ),09/07/2020,Sales Receipt,4198,,FireWrap® Grip Kit - GLOW - Green,1,37.95  ,37.95  ,"7,236.15  "
FireWrap® Grip Kit GLOW - Green ( 927 ),09/12/2020,Sales Receipt,4208,,FireWrap® Grip Kit - GLOW - Green,2,37.95  ,75.90  ,"7,312.05  "
FireWrap® Grip Kit GLOW - Green ( 927 ),09/13/2020,Sales Receipt,4211,,FireWrap® Grip Kit - GLOW - Green,1,37.95  ,37.95  ,"7,350.00  "
FireWrap® Grip Kit GLOW - Green ( 927 ),09/13/2020,Sales Receipt,4210,,FireWrap® Grip Kit - GLOW - Green,1,37.95  ,37.95  ,"7,387.95  "
FireWrap® Grip Kit GLOW - Green ( 927 ),09/16/2020,Sales Receipt,4219,,FireWrap® Grip Kit - GLOW - Green,1,37.95  ,37.95  ,"7,425.90  "
FireWrap® Grip Kit GLOW - Green ( 927 ),09/18/2020,Sales Receipt,4237,,FireWrap® Grip Kit - GLOW - Green,1,37.95  ,37.95  ,"7,463.85  "
FireWrap® Grip Kit GLOW - Green ( 927 ),09/21/2020,Sales Receipt,4253,,FireWrap® Grip Kit - GLOW - Green,2,37.95  ,75.90  ,"7,539.75  "
FireWrap® Grip Kit GLOW - Green ( 927 ),09/23/2020,Sales Receipt,4264,,FireWrap® Grip Kit - GLOW - Green,2,37.95  ,75.90  ,"7,615.65  "
FireWrap® Grip Kit GLOW - Green ( 927 ),09/25/2020,Invoice,M-092520-002,,Grip Kit - GLOW - Green,1,28.50  ,28.50  ,"7,644.15  "
FireWrap® Grip Kit GLOW - Green ( 927 ),09/30/2020,Invoice,M-093020-007,,Grip Kit - GLOW - Green,2,28.50  ,57.00  ,"7,701.15  "
FireWrap® Grip Kit GLOW - Green ( 927 ),10/03/2020,Sales Receipt,4294,,FireWrap® Grip Kit - GLOW - Green,1,37.95  ,37.95  ,"7,739.10  "
FireWrap® Grip Kit GLOW - Green ( 927 ),10/05/2020,Sales Receipt,4301,,FireWrap® Grip Kit - GLOW - Green,5,37.95  ,189.75  ,"7,928.85  "
FireWrap® Grip Kit GLOW - Green ( 927 ),10/06/2020,Sales Receipt,4308,,FireWrap® Grip Kit - GLOW - Green,2,37.95  ,75.90  ,"8,004.75  "
FireWrap® Grip Kit GLOW - Green ( 927 ),10/09/2020,Sales Receipt,4336,,FireWrap® Grip Kit - GLOW - Green,1,37.95  ,37.95  ,"8,042.70  "
FireWrap® Grip Kit GLOW - Green ( 927 ),10/13/2020,Sales Receipt,4345,,FireWrap® Grip Kit - GLOW - Green,1,37.95  ,37.95  ,"8,080.65  "
FireWrap® Grip Kit GLOW - Green ( 927 ),10/18/2020,Sales Receipt,4367,,FireWrap® Grip Kit - GLOW - Green,1,37.95  ,37.95  ,"8,118.60  "
FireWrap® Grip Kit GLOW - Green ( 927 ),10/19/2020,Sales Receipt,4370,,FireWrap® Grip Kit - GLOW - Green,1,37.95  ,37.95  ,"8,156.55  "
FireWrap® Grip Kit GLOW - Green ( 927 ),10/19/2020,Sales Receipt,4374,,FireWrap® Grip Kit - GLOW - Green,1,37.95  ,37.95  ,"8,194.50  "
FireWrap® Grip Kit GLOW - Green ( 927 ),10/21/2020,Invoice,M-101520-005,,Grip Kit - GLOW - Green,4,28.50  ,114.00  ,"8,308.50  "
FireWrap® Grip Kit GLOW - Green ( 927 ),10/24/2020,Sales Receipt,4404,,FireWrap® Grip Kit - GLOW - Green,1,37.95  ,37.95  ,"8,346.45  "
FireWrap® Grip Kit GLOW - Green ( 927 ),10/26/2020,Invoice,M-102620-001,,Grip Kit - GLOW - Green,1,28.50  ,28.50  ,"8,374.95  "
FireWrap® Grip Kit GLOW - Green ( 927 ),10/27/2020,Sales Receipt,4421,,FireWrap® Grip Kit - GLOW - Green,2,37.95  ,75.90  ,"8,450.85  "
FireWrap® Grip Kit GLOW - Green ( 927 ),10/29/2020,Sales Receipt,4429,,FireWrap® Grip Kit - GLOW - Green,2,37.95  ,75.90  ,"8,526.75  "
FireWrap® Grip Kit GLOW - Green ( 927 ),11/01/2020,Sales Receipt,4449,,FireWrap® Grip Kit - GLOW - Green,1,37.95  ,37.95  ,"8,564.70  "
FireWrap® Grip Kit GLOW - Green ( 927 ),11/03/2020,Sales Receipt,4459,,FireWrap® Grip Kit - GLOW - Green,1,37.95  ,37.95  ,"8,602.65  "
FireWrap® Grip Kit GLOW - Green ( 927 ),11/06/2020,Invoice,M-110620-006,,Grip Kit - GLOW - Green,4,28.50  ,114.00  ,"8,716.65  "
FireWrap® Grip Kit GLOW - Green ( 927 ),11/07/2020,Sales Receipt,4471,,FireWrap® Grip Kit - GLOW - Green,1,37.95  ,37.95  ,"8,754.60  "
FireWrap® Grip Kit GLOW - Green ( 927 ),11/12/2020,Sales Receipt,4502,,FireWrap® Grip Kit - GLOW - Green,1,37.95  ,37.95  ,"8,792.55  "
FireWrap® Grip Kit GLOW - Green ( 927 ),11/13/2020,Invoice,M-111320-006,,Grip Kit - GLOW - Green,1,28.50  ,28.50  ,"8,821.05  "
FireWrap® Grip Kit GLOW - Green ( 927 ),11/14/2020,Invoice,M-111420-001,,Grip Kit - GLOW - Green,1,28.50  ,28.50  ,"8,849.55  "
FireWrap® Grip Kit GLOW - Green ( 927 ),11/16/2020,Sales Receipt,4516,,FireWrap® Grip Kit - GLOW - Green,5,37.95  ,189.75  ,"9,039.30  "
FireWrap® Grip Kit GLOW - Green ( 927 ),11/19/2020,Sales Receipt,4527,,FireWrap® Grip Kit - GLOW - Green,1,37.95  ,37.95  ,"9,077.25  "
FireWrap® Grip Kit GLOW - Green ( 927 ),11/20/2020,Sales Receipt,4532,,FireWrap® Grip Kit - GLOW - Green,2,37.95  ,75.90  ,"9,153.15  "
FireWrap® Grip Kit GLOW - Green ( 927 ),11/21/2020,Sales Receipt,4538,,FireWrap® Grip Kit - GLOW - Green,1,37.95  ,37.95  ,"9,191.10  "
FireWrap® Grip Kit GLOW - Green ( 927 ),11/22/2020,Sales Receipt,4542,,FireWrap® Grip Kit - GLOW - Green,1,37.95  ,37.95  ,"9,229.05  "
FireWrap® Grip Kit GLOW - Green ( 927 ),11/24/2020,Sales Receipt,4545,,FireWrap® Grip Kit - GLOW - Green,3,37.95  ,113.85  ,"9,342.90  "
FireWrap® Grip Kit GLOW - Green ( 927 ),11/25/2020,Sales Receipt,4798,,FireWrap® Grip Kit - GLOW - Green - FireWrap® Grip Kit - GLOW - Green,1,37.95  ,37.95  ,"9,380.85  "
FireWrap® Grip Kit GLOW - Green ( 927 ),11/25/2020,Sales Receipt,4553,,FireWrap® Grip Kit - GLOW - Green,1,37.95  ,37.95  ,"9,418.80  "
FireWrap® Grip Kit GLOW - Green ( 927 ),11/25/2020,Sales Receipt,4558,,FireWrap® Grip Kit - GLOW - Green,1,37.95  ,37.95  ,"9,456.75  "
FireWrap® Grip Kit GLOW - Green ( 927 ),11/27/2020,Sales Receipt,4581,,FireWrap® Grip Kit - GLOW - Green,1,37.95  ,37.95  ,"9,494.70  "
FireWrap® Grip Kit GLOW - Green ( 927 ),11/30/2020,Sales Receipt,4609,,FireWrap® Grip Kit - GLOW - Green,1,37.95  ,37.95  ,"9,532.65  "
FireWrap® Grip Kit GLOW - Green ( 927 ),12/02/2020,Sales Receipt,4618,,FireWrap® Grip Kit - GLOW - Green,1,37.95  ,37.95  ,"9,570.60  "
FireWrap® Grip Kit GLOW - Green ( 927 ),12/02/2020,Sales Receipt,4619,,FireWrap® Grip Kit - GLOW - Green,1,37.95  ,37.95  ,"9,608.55  "
FireWrap® Grip Kit GLOW - Green ( 927 ),12/04/2020,Sales Receipt,4626,,FireWrap® Grip Kit - GLOW - Green,1,37.95  ,37.95  ,"9,646.50  "
FireWrap® Grip Kit GLOW - Green ( 927 ),12/06/2020,Sales Receipt,4633,,FireWrap® Grip Kit - GLOW - Green,1,37.95  ,37.95  ,"9,684.45  "
FireWrap® Grip Kit GLOW - Green ( 927 ),12/06/2020,Sales Receipt,4632,,FireWrap® Grip Kit - GLOW - Green,1,37.95  ,37.95  ,"9,722.40  "
FireWrap® Grip Kit GLOW - Green ( 927 ),12/08/2020,Invoice,M-120820-001,,Grip Kit - GLOW - Green,1,28.50  ,28.50  ,"9,750.90  "
FireWrap® Grip Kit GLOW - Green ( 927 ),12/09/2020,Sales Receipt,4651,,FireWrap® Grip Kit - GLOW - Green,1,37.95  ,37.95  ,"9,788.85  "
FireWrap® Grip Kit GLOW - Green ( 927 ),12/10/2020,Sales Receipt,4661,,FireWrap® Grip Kit - GLOW - Green,1,37.95  ,37.95  ,"9,826.80  "
FireWrap® Grip Kit GLOW - Green ( 927 ),12/11/2020,Sales Receipt,4665,,FireWrap® Grip Kit - GLOW - Green,1,37.95  ,37.95  ,"9,864.75  "
FireWrap® Grip Kit GLOW - Green ( 927 ),12/11/2020,Sales Receipt,4668,,FireWrap® Grip Kit - GLOW - Green,1,37.95  ,37.95  ,"9,902.70  "
FireWrap® Grip Kit GLOW - Green ( 927 ),12/16/2020,Sales Receipt,4690,,FireWrap® Grip Kit - GLOW - Green,1,37.95  ,37.95  ,"9,940.65  "
FireWrap® Grip Kit GLOW - Green ( 927 ),12/17/2020,Sales Receipt,4692,,FireWrap® Grip Kit - GLOW - Green,1,37.95  ,37.95  ,"9,978.60  "
FireWrap® Grip Kit GLOW - Green ( 927 ),12/18/2020,Sales Receipt,4695,,FireWrap® Grip Kit - GLOW - Green,3,37.95  ,113.85  ,"10,092.45  "
FireWrap® Grip Kit GLOW - Green ( 927 ),12/19/2020,Sales Receipt,4700,,FireWrap® Grip Kit - GLOW - Green,1,37.95  ,37.95  ,"10,130.40  "
FireWrap® Grip Kit GLOW - Green ( 927 ),12/21/2020,Sales Receipt,4717,,FireWrap® Grip Kit - GLOW - Green,1,37.95  ,37.95  ,"10,168.35  "
FireWrap® Grip Kit GLOW - Green ( 927 ),12/23/2020,Sales Receipt,4719,,FireWrap® Grip Kit - GLOW - Green,1,37.95  ,37.95  ,"10,206.30  "
FireWrap® Grip Kit GLOW - Green ( 927 ),12/23/2020,Sales Receipt,4725,,FireWrap® Grip Kit - GLOW - Green,1,37.95  ,37.95  ,"10,244.25  "
FireWrap® Grip Kit GLOW - Green ( 927 ),12/24/2020,Sales Receipt,4732,,FireWrap® Grip Kit - GLOW - Green,1,37.95  ,37.95  ,"10,282.20  "
FireWrap® Grip Kit GLOW - Green ( 927 ),12/28/2020,Sales Receipt,4752,,FireWrap® Grip Kit - GLOW - Green,2,37.95  ,75.90  ,"10,358.10  "
FireWrap® Grip Kit GLOW - Green ( 927 ),12/29/2020,Sales Receipt,4757,,FireWrap® Grip Kit - GLOW - Green,1,37.95  ,37.95  ,"10,396.05  "
FireWrap® Grip Kit GLOW - Green ( 927 ),12/30/2020,Sales Receipt,4760,,FireWrap® Grip Kit - GLOW - Green,1,37.95  ,37.95  ,"10,434.00  "
FireWrap® Grip Kit GLOW - Green ( 927 ),12/31/2020,Sales Receipt,4767,,FireWrap® Grip Kit - GLOW - Green,1,37.95  ,37.95  ,"10,471.95  "
FireWrap® Grip Kit GLOW - Green ( 927 ),01/08/2021,Sales Receipt,4812,,FireWrap® Grip Kit - GLOW - Green,1,37.95  ,37.95  ,"10,509.90  "
FireWrap® Grip Kit GLOW - Green ( 927 ),01/14/2021,Sales Receipt,4835,,FireWrap® Grip Kit - GLOW - Green,1,37.95  ,37.95  ,"10,547.85  "
FireWrap® Grip Kit GLOW - Green ( 927 ),01/15/2021,Sales Receipt,4845,,FireWrap® Grip Kit - GLOW - Green,1,37.95  ,37.95  ,"10,585.80  "
FireWrap® Grip Kit GLOW - Green ( 927 ),01/15/2021,Sales Receipt,4846,,FireWrap® Grip Kit - GLOW - Green,1,37.95  ,37.95  ,"10,623.75  "
FireWrap® Grip Kit GLOW - Green ( 927 ),01/18/2021,Sales Receipt,4866,,FireWrap® Grip Kit - GLOW - Green,2,37.95  ,75.90  ,"10,699.65  "
FireWrap® Grip Kit GLOW - Green ( 927 ),01/23/2021,Sales Receipt,4884,,FireWrap® Grip Kit - GLOW - Green,1,37.95  ,37.95  ,"10,737.60  "
FireWrap® Grip Kit GLOW - Green ( 927 ),01/26/2021,Sales Receipt,4894,,FireWrap® Grip Kit - GLOW - Green,6,37.95  ,227.70  ,"10,965.30  "
FireWrap® Grip Kit GLOW - Green ( 927 ),01/30/2021,Sales Receipt,4904,,FireWrap® Grip Kit - GLOW - Green,1,37.95  ,37.95  ,"11,003.25  "
FireWrap® Grip Kit GLOW - Green ( 927 ),02/02/2021,Sales Receipt,4917,,FireWrap® Grip Kit - GLOW - Green,1,37.95  ,37.95  ,"11,041.20  "
FireWrap® Grip Kit GLOW - Green ( 927 ),02/05/2021,Sales Receipt,4927,,FireWrap® Grip Kit - GLOW - Green,1,37.95  ,37.95  ,"11,079.15  "
FireWrap® Grip Kit GLOW - Green ( 927 ),02/08/2021,Sales Receipt,4937,,FireWrap® Grip Kit - GLOW - Green,1,37.95  ,37.95  ,"11,117.10  "
FireWrap® Grip Kit GLOW - Green ( 927 ),02/11/2021,Sales Receipt,4947,,FireWrap® Grip Kit - GLOW - Green,1,37.95  ,37.95  ,"11,155.05  "
FireWrap® Grip Kit GLOW - Green ( 927 ),02/13/2021,Sales Receipt,4961,,"FIREWRAP® GRIP KIT
Color: GLOW Green (+$12.95)",1,37.95  ,37.95  ,"11,193.00  "
FireWrap® Grip Kit GLOW - Green ( 927 ),02/23/2021,Sales Receipt,5012,,"FIREWRAP® GRIP KIT
Color: GLOW Green (+$12.95)",1,37.95  ,37.95  ,"11,230.95  "
FireWrap® Grip Kit GLOW - Green ( 927 ),02/24/2021,Sales Receipt,5022,,"FIREWRAP® GRIP KIT
Color: GLOW Green (+$12.95)",1,37.95  ,37.95  ,"11,268.90  "
FireWrap® Grip Kit GLOW - Green ( 927 ),02/24/2021,Sales Receipt,5019,,"FIREWRAP® GRIP KIT
Color: GLOW Green (+$12.95)",2,37.95  ,75.90  ,"11,344.80  "
FireWrap® Grip Kit GLOW - Green ( 927 ),02/28/2021,Sales Receipt,5034,,"FIREWRAP® GRIP KIT - Yes, I understand.
Color: GLOW Green (+$12.95)",1,37.95  ,37.95  ,"11,382.75  "
FireWrap® Grip Kit GLOW - Green ( 927 ),03/09/2021,Sales Receipt,5064,,"FIREWRAP® GRIP KIT - Yes, I understand.
Color: GLOW Green (+$12.95)",1,37.95  ,37.95  ,"11,420.70  "
FireWrap® Grip Kit GLOW - Green ( 927 ),03/11/2021,Sales Receipt,5079,,"FIREWRAP® GRIP KIT - Yes, I understand.
Color: GLOW Green (+$12.95)",1,37.95  ,37.95  ,"11,458.65  "
FireWrap® Grip Kit GLOW - Green ( 927 ),03/14/2021,Sales Receipt,5109,,"FIREWRAP® GRIP KIT - Yes, I understand.
Color: GLOW Green (+$12.95)",2,37.95  ,75.90  ,"11,534.55  "
FireWrap® Grip Kit GLOW - Green ( 927 ),03/15/2021,Sales Receipt,5119,,"FIREWRAP® GRIP KIT - Yes, I understand.
Color: GLOW Green (+$12.95)",1,37.95  ,37.95  ,"11,572.50  "
FireWrap® Grip Kit GLOW - Green ( 927 ),03/18/2021,Sales Receipt,5136,,"FIREWRAP® GRIP KIT - Yes, I understand.
Color: GLOW Green (+$12.95)",1,37.95  ,37.95  ,"11,610.45  "
FireWrap® Grip Kit GLOW - Green ( 927 ),03/22/2021,Sales Receipt,5164,,"FIREWRAP® GRIP KIT - Yes, I understand.
Color: GLOW Green (+$12.95)",1,37.95  ,37.95  ,"11,648.40  "
FireWrap® Grip Kit GLOW - Green ( 927 ),03/22/2021,Sales Receipt,5160,,"FIREWRAP® GRIP KIT - Yes, I understand.
Color: GLOW Green (+$12.95)",2,37.95  ,75.90  ,"11,724.30  "
FireWrap® Grip Kit GLOW - Green ( 927 ),04/01/2021,Sales Receipt,5223,,"FIREWRAP® GRIP KIT - Yes, I understand.
Color: GLOW Green (+$12.95)",1,37.95  ,37.95  ,"11,762.25  "
FireWrap® Grip Kit GLOW - Green ( 927 ),04/07/2021,Sales Receipt,5260,,"FIREWRAP® GRIP KIT - Yes, I understand.
Color: GLOW Green (+$12.95)",1,37.95  ,37.95  ,"11,800.20  "
FireWrap® Grip Kit GLOW - Green ( 927 ),04/09/2021,Sales Receipt,5275,,"FIREWRAP® GRIP KIT - Yes, I understand.
Color: GLOW Green (+$12.95)",2,37.95  ,75.90  ,"11,876.10  "
FireWrap® Grip Kit GLOW - Green ( 927 ),04/16/2021,Sales Receipt,5309,,"FIREWRAP® GRIP KIT
Color: GLOW Green (+$12.95)",1,37.95  ,37.95  ,"11,914.05  "
FireWrap® Grip Kit GLOW - Green ( 927 ),04/16/2021,Sales Receipt,5306,,"FIREWRAP® GRIP KIT - Yes, I understand.
Color: GLOW Green (+$12.95)",1,37.95  ,37.95  ,"11,952.00  "
FireWrap® Grip Kit GLOW - Green ( 927 ),04/17/2021,Sales Receipt,5314,,"FIREWRAP® GRIP KIT
Color: GLOW Green (+$12.95)",1,37.95  ,37.95  ,"11,989.95  "
FireWrap® Grip Kit GLOW - Green ( 927 ),04/18/2021,Sales Receipt,5326,,"FIREWRAP® GRIP KIT
Color: GLOW Green (+$12.95)",1,37.95  ,37.95  ,"12,027.90  "
FireWrap® Grip Kit GLOW - Green ( 927 ),04/19/2021,Sales Receipt,5332,,"FIREWRAP® GRIP KIT
Color: GLOW Green (+$12.95)",1,37.95  ,37.95  ,"12,065.85  "
FireWrap® Grip Kit GLOW - Green ( 927 ),04/20/2021,Sales Receipt,5336,,"FIREWRAP® GRIP KIT
Color: GLOW Green (+$12.95)",3,37.95  ,113.85  ,"12,179.70  "
FireWrap® Grip Kit GLOW - Green ( 927 ),04/23/2021,Sales Receipt,5358,,"FIREWRAP® GRIP KIT
Color: GLOW Green (+$12.95)",1,37.95  ,37.95  ,"12,217.65  "
FireWrap® Grip Kit GLOW - Green ( 927 ),04/28/2021,Sales Receipt,5403,,"FIREWRAP® GRIP KIT
Color: GLOW Green (+$12.95)",10,37.95  ,379.50  ,"12,597.15  "
FireWrap® Grip Kit GLOW - Green ( 927 ),04/29/2021,Sales Receipt,5416,,"FIREWRAP® GRIP KIT
Color: GLOW Green (+$12.95)",1,37.95  ,37.95  ,"12,635.10  "
FireWrap® Grip Kit GLOW - Green ( 927 ),04/30/2021,Sales Receipt,5420,,"FIREWRAP® GRIP KIT
Color: GLOW Green (+$12.95)",1,37.95  ,37.95  ,"12,673.05  "
FireWrap® Grip Kit GLOW - Green ( 927 ),05/11/2021,Sales Receipt,5488,,"FIREWRAP® GRIP KIT
Color: GLOW Green (+$12.95)",1,37.95  ,37.95  ,"12,711.00  "
FireWrap® Grip Kit GLOW - Green ( 927 ),05/11/2021,Sales Receipt,5487,,"FIREWRAP® GRIP KIT
Color: GLOW Green (+$12.95)",5,37.95  ,189.75  ,"12,900.75  "
FireWrap® Grip Kit GLOW - Green ( 927 ),05/11/2021,Sales Receipt,5481,,"FIREWRAP® GRIP KIT
Color: GLOW Green (+$12.95)",2,37.95  ,75.90  ,"12,976.65  "
FireWrap® Grip Kit GLOW - Green ( 927 ),05/13/2021,Sales Receipt,5500,,"FIREWRAP® GRIP KIT
Color: GLOW Green (+$12.95)",1,37.95  ,37.95  ,"13,014.60  "
FireWrap® Grip Kit GLOW - Green ( 927 ),05/23/2021,Sales Receipt,5561,,"FIREWRAP® GRIP KIT
Color: GLOW Green (+$12.95)",1,37.95  ,37.95  ,"13,052.55  "
FireWrap® Grip Kit GLOW - Green ( 927 ),05/24/2021,Sales Receipt,5572,,"FIREWRAP® GRIP KIT
Color: GLOW Green (+$12.95)",1,37.95  ,37.95  ,"13,090.50  "
FireWrap® Grip Kit GLOW - Green ( 927 ),05/25/2021,Sales Receipt,5578,,"FIREWRAP® GRIP KIT
Color: GLOW Green (+$12.95)",1,37.95  ,37.95  ,"13,128.45  "
FireWrap® Grip Kit GLOW - Green ( 927 ),05/30/2021,Sales Receipt,5598,,"FIREWRAP® GRIP KIT
Color: GLOW Green (+$12.95)",1,37.95  ,37.95  ,"13,166.40  "
FireWrap® Grip Kit GLOW - Green ( 927 ),06/01/2021,Sales Receipt,5608,,"FIREWRAP® GRIP KIT
Color: GLOW Green (+$12.95)",1,37.95  ,37.95  ,"13,204.35  "
FireWrap® Grip Kit GLOW - Green ( 927 ),06/02/2021,Sales Receipt,5616,,"FIREWRAP® GRIP KIT
Color: GLOW Green (+$12.95)",1,37.95  ,37.95  ,"13,242.30  "
FireWrap® Grip Kit GLOW - Green ( 927 ),06/04/2021,Sales Receipt,5623,,"FIREWRAP® GRIP KIT
Color: GLOW Green (+$12.95)",2,37.95  ,75.90  ,"13,318.20  "
FireWrap® Grip Kit GLOW - Green ( 927 ),06/05/2021,Sales Receipt,5625,,"FIREWRAP® GRIP KIT
Color: GLOW Green (+$12.95)",1,37.95  ,37.95  ,"13,356.15  "
FireWrap® Grip Kit GLOW - Green ( 927 ),06/05/2021,Sales Receipt,5629,,"FIREWRAP® GRIP KIT
Color: GLOW Green (+$12.95)",1,37.95  ,37.95  ,"13,394.10  "
FireWrap® Grip Kit GLOW - Green ( 927 ),06/07/2021,Sales Receipt,5636,,"FIREWRAP® GRIP KIT
Color: GLOW Green (+$12.95)",2,37.95  ,75.90  ,"13,470.00  "
FireWrap® Grip Kit GLOW - Green ( 927 ),06/07/2021,Sales Receipt,5637,,"FIREWRAP® GRIP KIT
Color: GLOW Green (+$12.95)",5,37.95  ,189.75  ,"13,659.75  "
FireWrap® Grip Kit GLOW - Green ( 927 ),06/08/2021,Sales Receipt,5643,,"FIREWRAP® GRIP KIT
Color: GLOW Green (+$12.95)",1,37.95  ,37.95  ,"13,697.70  "
FireWrap® Grip Kit GLOW - Green ( 927 ),06/12/2021,Sales Receipt,5659,,"FIREWRAP® GRIP KIT
Color: GLOW Green (+$12.95)",1,37.95  ,37.95  ,"13,735.65  "
FireWrap® Grip Kit GLOW - Green ( 927 ),06/14/2021,Sales Receipt,5661,,"FIREWRAP® GRIP KIT
Color: GLOW Green (+$12.95)",2,37.95  ,75.90  ,"13,811.55  "
FireWrap® Grip Kit GLOW - Green ( 927 ),06/30/2021,Sales Receipt,5727,,"FIREWRAP® GRIP KIT
Color: GLOW Green (+$12.95)",10,37.95  ,379.50  ,"14,191.05  "
FireWrap® Grip Kit GLOW - Green ( 927 ),07/01/2021,Sales Receipt,5731,,"FIREWRAP® GRIP KIT
Color: GLOW Green (+$12.95)",1,37.95  ,37.95  ,"14,229.00  "
FireWrap® Grip Kit GLOW - Green ( 927 ),07/05/2021,Sales Receipt,5748,,"FIREWRAP® GRIP KIT
Color: GLOW Green (+$12.95)",1,37.95  ,37.95  ,"14,266.95  "
FireWrap® Grip Kit GLOW - Green ( 927 ),07/12/2021,Sales Receipt,5772,,"FIREWRAP® GRIP KIT
Color: GLOW Green (+$12.95)",2,37.95  ,75.90  ,"14,342.85  "
FireWrap® Grip Kit GLOW - Green ( 927 ),07/18/2021,Sales Receipt,5794,,"FIREWRAP® GRIP KIT
Color: GLOW Green (+$12.95)",1,37.95  ,37.95  ,"14,380.80  "
FireWrap® Grip Kit GLOW - Green ( 927 ),07/22/2021,Sales Receipt,5811,,"FIREWRAP® GRIP KIT
Color: GLOW Green (+$12.95)",1,37.95  ,37.95  ,"14,418.75  "
FireWrap® Grip Kit GLOW - Green ( 927 ),07/23/2021,Sales Receipt,5815,,"FIREWRAP® GRIP KIT
Color: GLOW Green (+$12.95)",1,37.95  ,37.95  ,"14,456.70  "
FireWrap® Grip Kit GLOW - Green ( 927 ),07/24/2021,Sales Receipt,5817,,"FIREWRAP® GRIP KIT
Color: GLOW Green (+$12.95)",2,37.95  ,75.90  ,"14,532.60  "
FireWrap® Grip Kit GLOW - Green ( 927 ),07/25/2021,Sales Receipt,5822,,"FIREWRAP® GRIP KIT
Color: GLOW Green (+$12.95)",1,37.95  ,37.95  ,"14,570.55  "
FireWrap® Grip Kit GLOW - Green ( 927 ),07/25/2021,Sales Receipt,5818,,"FIREWRAP® GRIP KIT
Color: GLOW Green (+$12.95)",2,37.95  ,75.90  ,"14,646.45  "
FireWrap® Grip Kit GLOW - Green ( 927 ),08/14/2021,Sales Receipt,5917,,"FIREWRAP® GRIP KIT
Color: GLOW Green (+$12.95)",1,37.95  ,37.95  ,"14,684.40  "
FireWrap® Grip Kit GLOW - Green ( 927 ),08/17/2021,Sales Receipt,5933,,"FIREWRAP® GRIP KIT
Color: GLOW Green (+$12.95)",1,37.95  ,37.95  ,"14,722.35  "
FireWrap® Grip Kit GLOW - Green ( 927 ),08/23/2021,Sales Receipt,5969,,"FIREWRAP® GRIP KIT
Color: GLOW Green (+$12.95)",1,37.95  ,37.95  ,"14,760.30  "
FireWrap® Grip Kit GLOW - Green ( 927 ),09/01/2021,Sales Receipt,6027,,"FIREWRAP® GRIP KIT
Color: GLOW Green (+$12.95)",1,37.95  ,37.95  ,"14,798.25  "
FireWrap® Grip Kit GLOW - Green ( 927 ),09/07/2021,Sales Receipt,6050,,"FIREWRAP® GRIP KIT
Color: GLOW Green (+$12.95)",5,37.95  ,189.75  ,"14,988.00  "
FireWrap® Grip Kit GLOW - Green ( 927 ),09/22/2021,Sales Receipt,6133,,"FIREWRAP® GRIP KIT
Color: GLOW Green (+$12.95)",1,32.99  ,32.99  ,"15,020.99  "
FireWrap® Grip Kit GLOW - Green ( 927 ),09/26/2021,Sales Receipt,6165,,"FIREWRAP® GRIP KIT
Color: GLOW Green (+$12.95)",1,32.99  ,32.99  ,"15,053.98  "
FireWrap® Grip Kit GLOW - Green ( 927 ),09/29/2021,Sales Receipt,6190,,"FIREWRAP® GRIP KIT
Color: GLOW Green (+$12.95)",4,32.99  ,131.96  ,"15,185.94  "
FireWrap® Grip Kit GLOW - Green ( 927 ),10/03/2021,Sales Receipt,6215,,"FIREWRAP® GRIP KIT
Color: GLOW Green (+$12.95)",1,37.95  ,37.95  ,"15,223.89  "
FireWrap® Grip Kit GLOW - Green ( 927 ),10/11/2021,Sales Receipt,6275,,"FIREWRAP® GRIP KIT
Color: GLOW Green (+$12.95)",1,37.95  ,37.95  ,"15,261.84  "
FireWrap® Grip Kit GLOW - Green ( 927 ),10/13/2021,Sales Receipt,6296,,"FIREWRAP® GRIP KIT
Color: GLOW Green (+$12.95)",1,37.95  ,37.95  ,"15,299.79  "
FireWrap® Grip Kit GLOW - Green ( 927 ),10/14/2021,Sales Receipt,6297,,"FIREWRAP® GRIP KIT
Color: GLOW Green (+$12.95)",1,37.95  ,37.95  ,"15,337.74  "
FireWrap® Grip Kit GLOW - Green ( 927 ),10/17/2021,Sales Receipt,6321,,"FIREWRAP® GRIP KIT
Color: GLOW Green (+$12.95)",1,37.95  ,37.95  ,"15,375.69  "
FireWrap® Grip Kit GLOW - Green ( 927 ),10/18/2021,Sales Receipt,6327,,"FIREWRAP® GRIP KIT
Color: GLOW Green (+$12.95)",1,37.95  ,37.95  ,"15,413.64  "
FireWrap® Grip Kit GLOW - Green ( 927 ),10/22/2021,Sales Receipt,6351,,"FIREWRAP® GRIP KIT
Color: GLOW Green (+$12.95)",1,37.95  ,37.95  ,"15,451.59  "
FireWrap® Grip Kit GLOW - Green ( 927 ),10/23/2021,Sales Receipt,6355,,"FIREWRAP® GRIP KIT
Color: GLOW Green (+$12.95)",1,37.95  ,37.95  ,"15,489.54  "
FireWrap® Grip Kit GLOW - Green ( 927 ),10/24/2021,Sales Receipt,6362,,"FIREWRAP® GRIP KIT
Color: GLOW Green (+$12.95)",1,37.95  ,37.95  ,"15,527.49  "
FireWrap® Grip Kit GLOW - Green ( 927 ),10/31/2021,Sales Receipt,6404,,"FIREWRAP® GRIP KIT
Color: GLOW Green (+$12.95)",1,37.95  ,37.95  ,"15,565.44  "
FireWrap® Grip Kit GLOW - Green ( 927 ),11/09/2021,Sales Receipt,6455,,"FIREWRAP® GRIP KIT
Color: GLOW Green (+$12.95)",1,37.95  ,37.95  ,"15,603.39  "
FireWrap® Grip Kit GLOW - Green ( 927 ),11/10/2021,Sales Receipt,6462,,"FIREWRAP® GRIP KIT
Color: GLOW Green (+$12.95)",1,37.95  ,37.95  ,"15,641.34  "
FireWrap® Grip Kit GLOW - Green ( 927 ),11/16/2021,Sales Receipt,6520,,"FIREWRAP® GRIP KIT
Color: GLOW Green (+$12.95)",1,37.95  ,37.95  ,"15,679.29  "
FireWrap® Grip Kit GLOW - Green ( 927 ),11/21/2021,Sales Receipt,6555,,"FIREWRAP® GRIP KIT
Color: GLOW Green (+$12.95)",1,37.95  ,37.95  ,"15,717.24  "
FireWrap® Grip Kit GLOW - Green ( 927 ),11/23/2021,Sales Receipt,6565,,"FIREWRAP® GRIP KIT
Color: GLOW Green (+$12.95)",1,37.95  ,37.95  ,"15,755.19  "
FireWrap® Grip Kit GLOW - Green ( 927 ),11/25/2021,Sales Receipt,6586,,"FIREWRAP® GRIP KIT
Color: GLOW Green (+$12.95)",1,32.99  ,32.99  ,"15,788.18  "
FireWrap® Grip Kit GLOW - Green ( 927 ),11/27/2021,Sales Receipt,6610,,"FIREWRAP® GRIP KIT
Color: GLOW Green (+$12.95)",1,32.99  ,32.99  ,"15,821.17  "
FireWrap® Grip Kit GLOW - Green ( 927 ),12/02/2021,Sales Receipt,6651,,"FIREWRAP® GRIP KIT
Color: GLOW Green (+$12.95)",1,32.99  ,32.99  ,"15,854.16  "
FireWrap® Grip Kit GLOW - Green ( 927 ),12/03/2021,Sales Receipt,6657,,"FIREWRAP® GRIP KIT
Color: GLOW Green (+$12.95)",1,32.99  ,32.99  ,"15,887.15  "
FireWrap® Grip Kit GLOW - Green ( 927 ),12/03/2021,Sales Receipt,6660,,"FIREWRAP® GRIP KIT
Color: GLOW Green (+$12.95)",1,32.99  ,32.99  ,"15,920.14  "
FireWrap® Grip Kit GLOW - Green ( 927 ),12/07/2021,Sales Receipt,6691,,"FIREWRAP® GRIP KIT
Color: GLOW Green (+$12.95)",1,37.95  ,37.95  ,"15,958.09  "
FireWrap® Grip Kit GLOW - Green ( 927 ),12/12/2021,Sales Receipt,6729,,"FIREWRAP® GRIP KIT
Color: GLOW Green (+$12.95)",1,37.95  ,37.95  ,"15,996.04  "
FireWrap® Grip Kit GLOW - Green ( 927 ),12/18/2021,Sales Receipt,6773,,"FIREWRAP® GRIP KIT
Color: GLOW Green (+$12.95)",1,37.95  ,37.95  ,"16,033.99  "
FireWrap® Grip Kit GLOW - Green ( 927 ),12/19/2021,Sales Receipt,6782,,"FIREWRAP® GRIP KIT
Color: GLOW Green (+$12.95)",1,37.95  ,37.95  ,"16,071.94  "
FireWrap® Grip Kit GLOW - Green ( 927 ),12/25/2021,Sales Receipt,6821,,"FIREWRAP® GRIP KIT
Color: GLOW Green (+$12.95)",1,37.95  ,37.95  ,"16,109.89  "
FireWrap® Grip Kit GLOW - Green ( 927 ),12/25/2021,Sales Receipt,6826,,"FIREWRAP® GRIP KIT
Color: GLOW Green (+$12.95)",1,37.95  ,37.95  ,"16,147.84  "
FireWrap® Grip Kit GLOW - Green ( 927 ),12/26/2021,Sales Receipt,6833,,"FIREWRAP® GRIP KIT
Color: GLOW Green (+$12.95)",1,37.95  ,37.95  ,"16,185.79  "
FireWrap® Grip Kit GLOW - Green ( 927 ),12/30/2021,Sales Receipt,6864,,"FIREWRAP® GRIP KIT
Color: GLOW Green (+$12.95)",2,37.95  ,75.90  ,"16,261.69  "
FireWrap® Grip Kit GLOW - Green ( 927 ),01/01/2022,Sales Receipt,6886,,"FIREWRAP® GRIP KIT
Color: GLOW Green (+$12.95)",3,37.95  ,113.85  ,"16,375.54  "
FireWrap® Grip Kit GLOW - Green ( 927 ),01/08/2022,Sales Receipt,6953,,"FIREWRAP® GRIP KIT
Color: GLOW Green (+$12.95)",2,37.95  ,75.90  ,"16,451.44  "
FireWrap® Grip Kit GLOW - Green ( 927 ),01/08/2022,Sales Receipt,6957,,"FIREWRAP® GRIP KIT
Color: GLOW Green (+$12.95)",1,37.95  ,37.95  ,"16,489.39  "
FireWrap® Grip Kit GLOW - Green ( 927 ),01/09/2022,Sales Receipt,6960,,"FIREWRAP® GRIP KIT
Color: GLOW Green (+$12.95)",1,37.95  ,37.95  ,"16,527.34  "
FireWrap® Grip Kit GLOW - Green ( 927 ),01/17/2022,Sales Receipt,7018,,"FIREWRAP® GRIP KIT
Color: GLOW Green (+$12.95)",1,37.95  ,37.95  ,"16,565.29  "
FireWrap® Grip Kit GLOW - Green ( 927 ),01/17/2022,Sales Receipt,7019,,"FIREWRAP® GRIP KIT
Color: GLOW Green (+$12.95)",1,37.95  ,37.95  ,"16,603.24  "
FireWrap® Grip Kit GLOW - Green ( 927 ),01/19/2022,Sales Receipt,7046,,"FIREWRAP® GRIP KIT
Color: GLOW Green (+$12.95)",1,37.95  ,37.95  ,"16,641.19  "
FireWrap® Grip Kit GLOW - Green ( 927 ),01/26/2022,Sales Receipt,7100,,"FIREWRAP® GRIP KIT
Color: GLOW Green (+$12.95)",1,37.95  ,37.95  ,"16,679.14  "
FireWrap® Grip Kit GLOW - Green ( 927 ),01/27/2022,Sales Receipt,7108,,"FIREWRAP® GRIP KIT
Color: GLOW Green (+$12.95)",1,37.95  ,37.95  ,"16,717.09  "
FireWrap® Grip Kit GLOW - Green ( 927 ),01/27/2022,Sales Receipt,7113,,"FIREWRAP® GRIP KIT
Color: GLOW Green (+$12.95)",2,37.95  ,75.90  ,"16,792.99  "
FireWrap® Grip Kit GLOW - Green ( 927 ),01/30/2022,Sales Receipt,7161,,"FIREWRAP® GRIP KIT
Color: GLOW Green (+$12.95)",1,37.95  ,37.95  ,"16,830.94  "
FireWrap® Grip Kit GLOW - Green ( 927 ),01/30/2022,Sales Receipt,7162,,"FIREWRAP® GRIP KIT
Color: GLOW Green (+$12.95)",1,37.95  ,37.95  ,"16,868.89  "
FireWrap® Grip Kit GLOW - Green ( 927 ),02/01/2022,Sales Receipt,7178,,"FIREWRAP® GRIP KIT
Color: GLOW Green (+$12.95)",1,37.95  ,37.95  ,"16,906.84  "
FireWrap® Grip Kit GLOW - Green ( 927 ),02/03/2022,Sales Receipt,7188,,"FIREWRAP® GRIP KIT
Color: GLOW Green (+$12.95)",1,40.95  ,40.95  ,"16,947.79  "
FireWrap® Grip Kit GLOW - Green ( 927 ),02/07/2022,Sales Receipt,7213,,"FIREWRAP® GRIP KIT
Color: GLOW Green (+$12.95)",1,40.95  ,40.95  ,"16,988.74  "
FireWrap® Grip Kit GLOW - Green ( 927 ),02/08/2022,Sales Receipt,7234,,"FIREWRAP® GRIP KIT
Color: GLOW Green (+$12.95)",1,40.95  ,40.95  ,"17,029.69  "
FireWrap® Grip Kit GLOW - Green ( 927 ),02/10/2022,Sales Receipt,7261,,"FIREWRAP® GRIP KIT
Color: GLOW Green (+$12.95)",1,40.95  ,40.95  ,"17,070.64  "
FireWrap® Grip Kit GLOW - Green ( 927 ),02/11/2022,Sales Receipt,7264,,"FIREWRAP® GRIP KIT
Color: GLOW Green (+$12.95)",1,40.95  ,40.95  ,"17,111.59  "
FireWrap® Grip Kit GLOW - Green ( 927 ),02/15/2022,Sales Receipt,7286,,"FIREWRAP® GRIP KIT
Color: GLOW Green (+$12.95)",1,40.95  ,40.95  ,"17,152.54  "
FireWrap® Grip Kit GLOW - Green ( 927 ),02/18/2022,Sales Receipt,7311,,"FIREWRAP® GRIP KIT
Color: GLOW Green (+$12.95)",1,40.95  ,40.95  ,"17,193.49  "
FireWrap® Grip Kit GLOW - Green ( 927 ),02/20/2022,Sales Receipt,7332,,"FIREWRAP® GRIP KIT
Color: GLOW Green (+$12.95)",1,40.95  ,40.95  ,"17,234.44  "
FireWrap® Grip Kit GLOW - Green ( 927 ),02/22/2022,Sales Receipt,7361,,"FIREWRAP® GRIP KIT
Color: GLOW Green (+$12.95)",1,40.95  ,40.95  ,"17,275.39  "
FireWrap® Grip Kit GLOW - Green ( 927 ),02/24/2022,Sales Receipt,7375,,"FIREWRAP® GRIP KIT
Color: GLOW Green (+$12.95)",1,40.95  ,40.95  ,"17,316.34  "
FireWrap® Grip Kit GLOW - Green ( 927 ),02/28/2022,Sales Receipt,7421,,"FIREWRAP® GRIP KIT
Color: GLOW Green (+$12.95)",3,40.95  ,122.85  ,"17,439.19  "
FireWrap® Grip Kit GLOW - Green ( 927 ),03/04/2022,Sales Receipt,7468,,"FIREWRAP® GRIP KIT
Color: GLOW Green (+$12.95)",1,40.95  ,40.95  ,"17,480.14  "
FireWrap® Grip Kit GLOW - Green ( 927 ),03/05/2022,Sales Receipt,7476,,"FIREWRAP® GRIP KIT
Color: GLOW Green (+$12.95)",2,40.95  ,81.90  ,"17,562.04  "
FireWrap® Grip Kit GLOW - Green ( 927 ),03/14/2022,Sales Receipt,7537,,"FIREWRAP® GRIP KIT
Color: GLOW Green (+$12.95)",1,40.95  ,40.95  ,"17,602.99  "
FireWrap® Grip Kit GLOW - Green ( 927 ),03/19/2022,Sales Receipt,7573,,"FIREWRAP® GRIP KIT
Color: GLOW Green (+$12.95)",1,40.95  ,40.95  ,"17,643.94  "
FireWrap® Grip Kit GLOW - Green ( 927 ),03/22/2022,Sales Receipt,7600,,"FIREWRAP® GRIP KIT
Color: GLOW Green (+$12.95)",1,40.95  ,40.95  ,"17,684.89  "
FireWrap® Grip Kit GLOW - Green ( 927 ),03/22/2022,Sales Receipt,7599,,"FIREWRAP® GRIP KIT
Color: GLOW Green (+$12.95)",1,40.95  ,40.95  ,"17,725.84  "
FireWrap® Grip Kit GLOW - Green ( 927 ),03/30/2022,Sales Receipt,7660,,"FIREWRAP® GRIP KIT
Color: GLOW Green (+$12.95)",1,40.95  ,40.95  ,"17,766.79  "
FireWrap® Grip Kit GLOW - Green ( 927 ),04/02/2022,Sales Receipt,7675,,"FIREWRAP® GRIP KIT
Color: GLOW Green (+$12.95)",1,40.95  ,40.95  ,"17,807.74  "
FireWrap® Grip Kit GLOW - Green ( 927 ),04/05/2022,Sales Receipt,7696,,"FIREWRAP® GRIP KIT
Color: GLOW Green (+$12.95)",1,40.95  ,40.95  ,"17,848.69  "
FireWrap® Grip Kit GLOW - Green ( 927 ),04/05/2022,Sales Receipt,7695,,"FIREWRAP® GRIP KIT
Color: GLOW Green (+$12.95)",2,40.95  ,81.90  ,"17,930.59  "
FireWrap® Grip Kit GLOW - Green ( 927 ),04/06/2022,Sales Receipt,7699,,"FIREWRAP® GRIP KIT
Color: GLOW Green (+$12.95)",1,40.95  ,40.95  ,"17,971.54  "
FireWrap® Grip Kit GLOW - Green ( 927 ),04/15/2022,Sales Receipt,7759,,"FIREWRAP® GRIP KIT
Color: GLOW Green (+$12.95)",1,40.95  ,40.95  ,"18,012.49  "
FireWrap® Grip Kit GLOW - Green ( 927 ),04/22/2022,Sales Receipt,7793,,"FIREWRAP® GRIP KIT
Color: GLOW Green (+$12.95)",4,40.95  ,163.80  ,"18,176.29  "
FireWrap® Grip Kit GLOW - Green ( 927 ),04/29/2022,Sales Receipt,7840,,"FIREWRAP® GRIP KIT
Color: GLOW Green (+$12.95)",1,35.99  ,35.99  ,"18,212.28  "
FireWrap® Grip Kit GLOW - Green ( 927 ),04/30/2022,Sales Receipt,7853,,"FIREWRAP® GRIP KIT
Color: GLOW Green (+$12.95)",1,35.99  ,35.99  ,"18,248.27  "
FireWrap® Grip Kit GLOW - Green ( 927 ),05/04/2022,Sales Receipt,7898,,"FIREWRAP® GRIP KIT
Color: GLOW Green (+$12.95)",2,35.99  ,71.98  ,"18,320.25  "
FireWrap® Grip Kit GLOW - Green ( 927 ),05/05/2022,Sales Receipt,7908,,"FIREWRAP® GRIP KIT
Color: GLOW Green (+$12.95)",6,35.99  ,215.94  ,"18,536.19  "
FireWrap® Grip Kit GLOW - Green ( 927 ),05/11/2022,Sales Receipt,7934,,"FIREWRAP® GRIP KIT
Color: GLOW Green (+$12.95)",1,40.95  ,40.95  ,"18,577.14  "
FireWrap® Grip Kit GLOW - Green ( 927 ),05/17/2022,Sales Receipt,7965,,"FIREWRAP® GRIP KIT
Color: GLOW Green (+$12.95)",1,40.95  ,40.95  ,"18,618.09  "
FireWrap® Grip Kit GLOW - Green ( 927 ),05/25/2022,Sales Receipt,8000,,"FIREWRAP® GRIP KIT
Color: GLOW Green (+$12.95)",1,40.95  ,40.95  ,"18,659.04  "
FireWrap® Grip Kit GLOW - Green ( 927 ),05/26/2022,Sales Receipt,8004,,"FIREWRAP® GRIP KIT
Color: GLOW Green (+$12.95)",3,40.95  ,122.85  ,"18,781.89  "
FireWrap® Grip Kit GLOW - Green ( 927 ),05/27/2022,Sales Receipt,8010,,"FIREWRAP® GRIP KIT
Color: GLOW Green (+$12.95)",1,40.95  ,40.95  ,"18,822.84  "
FireWrap® Grip Kit GLOW - Green ( 927 ),05/30/2022,Sales Receipt,8023,,"FIREWRAP® GRIP KIT
Color: GLOW Green (+$12.95)",1,40.95  ,40.95  ,"18,863.79  "
FireWrap® Grip Kit GLOW - Green ( 927 ),06/03/2022,Sales Receipt,8046,,"FIREWRAP® GRIP KIT
Color: GLOW Green (+$12.95)",1,40.95  ,40.95  ,"18,904.74  "
FireWrap® Grip Kit GLOW - Green ( 927 ),06/07/2022,Sales Receipt,8060,,"FIREWRAP® GRIP KIT
Color: GLOW Green (+$13)",1,40.95  ,40.95  ,"18,945.69  "
FireWrap® Grip Kit GLOW - Green ( 927 ),06/09/2022,Sales Receipt,8084,,"FIREWRAP® GRIP KIT
Color: GLOW Green (+$13)",1,40.95  ,40.95  ,"18,986.64  "
FireWrap® Grip Kit GLOW - Green ( 927 ),06/10/2022,Sales Receipt,8093,,"FIREWRAP® GRIP KIT
Color: GLOW Green (+$13)",1,40.95  ,40.95  ,"19,027.59  "
FireWrap® Grip Kit GLOW - Green ( 927 ),06/11/2022,Sales Receipt,8105,,"FIREWRAP® GRIP KIT
Color: GLOW Green (+$13)",20,40.95  ,819.00  ,"19,846.59  "
FireWrap® Grip Kit GLOW - Green ( 927 ),06/13/2022,Sales Receipt,8122,,"FIREWRAP® GRIP KIT
Color: GLOW Green (+$13)",1,40.95  ,40.95  ,"19,887.54  "
FireWrap® Grip Kit GLOW - Green ( 927 ),06/14/2022,Sales Receipt,8123,,"FIREWRAP® GRIP KIT
Color: GLOW Green (+$13)",1,40.95  ,40.95  ,"19,928.49  "
FireWrap® Grip Kit GLOW - Green ( 927 ),06/15/2022,Sales Receipt,8128,,"FIREWRAP® GRIP KIT
Color: GLOW Green (+$13)",2,40.95  ,81.90  ,"20,010.39  "
FireWrap® Grip Kit GLOW - Green ( 927 ),06/18/2022,Sales Receipt,8151,,"FIREWRAP® GRIP KIT
Color: GLOW Green (+$13)",1,40.95  ,40.95  ,"20,051.34  "
FireWrap® Grip Kit GLOW - Green ( 927 ),06/18/2022,Sales Receipt,8149,,"FIREWRAP® GRIP KIT
Color: GLOW Green (+$13)",2,40.95  ,81.90  ,"20,133.24  "
FireWrap® Grip Kit GLOW - Green ( 927 ),06/23/2022,Sales Receipt,8173,,"FIREWRAP® GRIP KIT
Color: GLOW Green (+$13)",2,40.95  ,81.90  ,"20,215.14  "
FireWrap® Grip Kit GLOW - Green ( 927 ),06/23/2022,Sales Receipt,8171,,"FIREWRAP® GRIP KIT
Color: GLOW Green (+$13)",1,40.95  ,40.95  ,"20,256.09  "
FireWrap® Grip Kit GLOW - Green ( 927 ),06/25/2022,Sales Receipt,8176,,"FIREWRAP® GRIP KIT
Color: GLOW Green (+$13)",1,40.95  ,40.95  ,"20,297.04  "
FireWrap® Grip Kit GLOW - Green ( 927 ),06/27/2022,Sales Receipt,8188,,"FIREWRAP® GRIP KIT
Color: GLOW Green (+$13)",1,40.95  ,40.95  ,"20,337.99  "
FireWrap® Grip Kit GLOW - Green ( 927 ),06/28/2022,Sales Receipt,8192,,"FIREWRAP® GRIP KIT
Color: GLOW Green (+$13)",1,40.95  ,40.95  ,"20,378.94  "
FireWrap® Grip Kit GLOW - Green ( 927 ),06/28/2022,Sales Receipt,8195,,"FIREWRAP® GRIP KIT
Color: GLOW Green (+$13)",1,40.95  ,40.95  ,"20,419.89  "
FireWrap® Grip Kit GLOW - Green ( 927 ),07/03/2022,Sales Receipt,8239,,"FIREWRAP® GRIP KIT
Color: GLOW Green (+$13)",1,40.95  ,40.95  ,"20,460.84  "
FireWrap® Grip Kit GLOW - Green ( 927 ),07/09/2022,Sales Receipt,8275,,"FIREWRAP® GRIP KIT
Color: GLOW Green (+$13)",1,40.95  ,40.95  ,"20,501.79  "
FireWrap® Grip Kit GLOW - Green ( 927 ),07/15/2022,Sales Receipt,8307,,"FIREWRAP® GRIP KIT
Color: GLOW Green (+$13)",1,40.95  ,40.95  ,"20,542.74  "
FireWrap® Grip Kit GLOW - Green ( 927 ),07/15/2022,Sales Receipt,8306,,"FIREWRAP® GRIP KIT
Color: GLOW Green (+$13)",2,40.95  ,81.90  ,"20,624.64  "
FireWrap® Grip Kit GLOW - Green ( 927 ),07/24/2022,Sales Receipt,8354,,"FIREWRAP® GRIP KIT
Color: GLOW Green (+$13)",2,40.95  ,81.90  ,"20,706.54  "
FireWrap® Grip Kit GLOW - Green ( 927 ),07/31/2022,Sales Receipt,8406,,"FIREWRAP® GRIP KIT
Color: GLOW Green (+$13)",1,40.95  ,40.95  ,"20,747.49  "
FireWrap® Grip Kit GLOW - Green ( 927 ),08/14/2022,Sales Receipt,8482,,"FIREWRAP® GRIP KIT
Color: GLOW Green (+$13)",2,40.95  ,81.90  ,"20,829.39  "
FireWrap® Grip Kit GLOW - Green ( 927 ),08/15/2022,Sales Receipt,8488,,"FIREWRAP® GRIP KIT
Color: GLOW Green (+$13)",2,40.95  ,81.90  ,"20,911.29  "
FireWrap® Grip Kit GLOW - Green ( 927 ),08/17/2022,Sales Receipt,8502,,"FIREWRAP® GRIP KIT
Color: GLOW Green (+$13)",1,40.95  ,40.95  ,"20,952.24  "
FireWrap® Grip Kit GLOW - Green ( 927 ),08/27/2022,Sales Receipt,8569,,"FIREWRAP® GRIP KIT
Color: GLOW Green (+$13)",1,40.95  ,40.95  ,"20,993.19  "
FireWrap® Grip Kit GLOW - Green ( 927 ),08/28/2022,Sales Receipt,8579,,"FIREWRAP® GRIP KIT
Color: GLOW Green (+$13)",1,40.95  ,40.95  ,"21,034.14  "
FireWrap® Grip Kit GLOW - Green ( 927 ),08/28/2022,Sales Receipt,8584,,"FIREWRAP® GRIP KIT
Color: GLOW Green (+$13)",1,40.95  ,40.95  ,"21,075.09  "
FireWrap® Grip Kit GLOW - Green ( 927 ),08/30/2022,Sales Receipt,8593,,"FIREWRAP® GRIP KIT
Color: GLOW Green (+$13)",1,40.95  ,40.95  ,"21,116.04  "
FireWrap® Grip Kit GLOW - Green ( 927 ),09/01/2022,Sales Receipt,8606,,"FIREWRAP® GRIP KIT
Color: GLOW Green (+$13)",1,40.95  ,40.95  ,"21,156.99  "
FireWrap® Grip Kit GLOW - Green ( 927 ),09/02/2022,Sales Receipt,8611,,"FIREWRAP® GRIP KIT
Color: GLOW Green (+$13)",1,40.95  ,40.95  ,"21,197.94  "
FireWrap® Grip Kit GLOW - Green ( 927 ),09/11/2022,Sales Receipt,8666,,"FIREWRAP® GRIP KIT
Color: GLOW Green (+$13)",1,40.95  ,40.95  ,"21,238.89  "
FireWrap® Grip Kit GLOW - Green ( 927 ),09/15/2022,Sales Receipt,8691,,"FIREWRAP® GRIP KIT
Color: GLOW Green (+$13)",2,40.95  ,81.90  ,"21,320.79  "
FireWrap® Grip Kit GLOW - Green ( 927 ),09/22/2022,Sales Receipt,8736,,"FIREWRAP® GRIP KIT
Color: GLOW Green (+$13)",2,40.95  ,81.90  ,"21,402.69  "
FireWrap® Grip Kit GLOW - Green ( 927 ),09/26/2022,Sales Receipt,8755,,"FIREWRAP® GRIP KIT
Color: GLOW Green (+$13)",1,40.95  ,40.95  ,"21,443.64  "
FireWrap® Grip Kit GLOW - Green ( 927 ),09/28/2022,Sales Receipt,8778,,"FIREWRAP® GRIP KIT
Color: GLOW Green (+$13)",1,40.95  ,40.95  ,"21,484.59  "
FireWrap® Grip Kit GLOW - Green ( 927 ),09/29/2022,Sales Receipt,8799,,"FIREWRAP® GRIP KIT
Color: GLOW Green (+$13)",5,40.95  ,204.75  ,"21,689.34  "
FireWrap® Grip Kit GLOW - Green ( 927 ),10/01/2022,Sales Receipt,8819,,"FIREWRAP® GRIP KIT
Color: GLOW Green (+$13)",1,40.95  ,40.95  ,"21,730.29  "
FireWrap® Grip Kit GLOW - Green ( 927 ),10/11/2022,Sales Receipt,8882,,"FIREWRAP® GRIP KIT
Color: GLOW Green (+$13)",1,40.95  ,40.95  ,"21,771.24  "
FireWrap® Grip Kit GLOW - Green ( 927 ),10/15/2022,Sales Receipt,8916,,"FIREWRAP® GRIP KIT
Color: GLOW Green (+$13)",1,40.95  ,40.95  ,"21,812.19  "
FireWrap® Grip Kit GLOW - Green ( 927 ),10/20/2022,Sales Receipt,8952,,"FIREWRAP® GRIP KIT
Color: GLOW Green (+$13)",1,40.95  ,40.95  ,"21,853.14  "
FireWrap® Grip Kit GLOW - Green ( 927 ),10/23/2022,Sales Receipt,8966,,"FIREWRAP® GRIP KIT
Color: GLOW Green (+$13)",1,40.95  ,40.95  ,"21,894.09  "
FireWrap® Grip Kit GLOW - Green ( 927 ),10/24/2022,Sales Receipt,8973,,"FIREWRAP® GRIP KIT
Color: GLOW Green (+$13)",1,40.95  ,40.95  ,"21,935.04  "
FireWrap® Grip Kit GLOW - Green ( 927 ),10/30/2022,Sales Receipt,9005,,"FIREWRAP® GRIP KIT
Color: GLOW Green (+$13)",1,40.95  ,40.95  ,"21,975.99  "
FireWrap® Grip Kit GLOW - Green ( 927 ),10/30/2022,Sales Receipt,9006,,"FIREWRAP® GRIP KIT
Color: GLOW Green (+$13)",1,40.95  ,40.95  ,"22,016.94  "
FireWrap® Grip Kit GLOW - Green ( 927 ),11/02/2022,Sales Receipt,9015,,"FIREWRAP® GRIP KIT
Color: GLOW Green (+$13)",1,40.95  ,40.95  ,"22,057.89  "
FireWrap® Grip Kit GLOW - Green ( 927 ),11/09/2022,Sales Receipt,9051,,"FIREWRAP® GRIP KIT
Color: GLOW Green (+$13)",1,40.95  ,40.95  ,"22,098.84  "
FireWrap® Grip Kit GLOW - Green ( 927 ),11/11/2022,Sales Receipt,9061,,"FIREWRAP® GRIP KIT
Color: GLOW Green (+$13)",1,40.95  ,40.95  ,"22,139.79  "
FireWrap® Grip Kit GLOW - Green ( 927 ),11/12/2022,Sales Receipt,M-113-2925633-5433800,,FireWrap® Grip Kit - Glow Green,1,41.95  ,41.95  ,"22,181.74  "
FireWrap® Grip Kit GLOW - Green ( 927 ),11/13/2022,Sales Receipt,9072,,"FIREWRAP® GRIP KIT
Color: GLOW Green (+$13)",1,40.95  ,40.95  ,"22,222.69  "
FireWrap® Grip Kit GLOW - Green ( 927 ),11/14/2022,Sales Receipt,M-112-4240856-6866630,,FireWrap® Grip Kit - Glow Green,5,41.95  ,209.75  ,"22,432.44  "
FireWrap® Grip Kit GLOW - Green ( 927 ),11/18/2022,Sales Receipt,9111,,"FIREWRAP® GRIP KIT
Color: GLOW Green (+$13)",1,40.95  ,40.95  ,"22,473.39  "
FireWrap® Grip Kit GLOW - Green ( 927 ),11/18/2022,Sales Receipt,M-111-4355558-3835460,,FireWrap® Grip Kit - Glow Green,1,41.95  ,41.95  ,"22,515.34  "
FireWrap® Grip Kit GLOW - Green ( 927 ),11/20/2022,Sales Receipt,9128,,"FIREWRAP® GRIP KIT
Color: GLOW Green (+$13)",1,40.95  ,40.95  ,"22,556.29  "
FireWrap® Grip Kit GLOW - Green ( 927 ),11/21/2022,Sales Receipt,9134,,"FIREWRAP® GRIP KIT
Color: GLOW Green (+$13)",1,40.95  ,40.95  ,"22,597.24  "
FireWrap® Grip Kit GLOW - Green ( 927 ),11/24/2022,Sales Receipt,M-113-7438787-3609031,,FireWrap® Grip Kit - Glow Green,1,41.95  ,41.95  ,"22,639.19  "
FireWrap® Grip Kit GLOW - Green ( 927 ),11/26/2022,Sales Receipt,9178,,"FIREWRAP® GRIP KIT
Color: GLOW Green (+$13)",1,40.95  ,40.95  ,"22,680.14  "
FireWrap® Grip Kit GLOW - Green ( 927 ),11/26/2022,Sales Receipt,M-112-2989072-6714625,,FireWrap® Grip Kit - Glow Green,2,41.95  ,83.90  ,"22,764.04  "
FireWrap® Grip Kit GLOW - Green ( 927 ),12/01/2022,Sales Receipt,M-112-7430129-3179410,,FireWrap® Grip Kit - Glow Green,1,41.95  ,41.95  ,"22,805.99  "
FireWrap® Grip Kit GLOW - Green ( 927 ),12/02/2022,Sales Receipt,M-113-6213622-6813046,,FireWrap® Grip Kit - Glow Green,2,41.95  ,83.90  ,"22,889.89  "
FireWrap® Grip Kit GLOW - Green ( 927 ),12/05/2022,Sales Receipt,M-114-1891985-7804261,,FireWrap® Grip Kit - Glow Green,1,41.95  ,41.95  ,"22,931.84  "
FireWrap® Grip Kit GLOW - Green ( 927 ),12/05/2022,Sales Receipt,9255,,"FIREWRAP® GRIP KIT
Color: GLOW Green (+$13)",2,40.95  ,81.90  ,"23,013.74  "
FireWrap® Grip Kit GLOW - Green ( 927 ),12/09/2022,Sales Receipt,9287,,"FIREWRAP® GRIP KIT
Color: GLOW Green (+$13)",4,40.95  ,163.80  ,"23,177.54  "
FireWrap® Grip Kit GLOW - Green ( 927 ),12/10/2022,Sales Receipt,9298,,"FIREWRAP® GRIP KIT
Color: GLOW Green (+$13)",1,40.95  ,40.95  ,"23,218.49  "
FireWrap® Grip Kit GLOW - Green ( 927 ),12/16/2022,Sales Receipt,9344,,"FIREWRAP® GRIP KIT
Color: GLOW Green (+$13)",1,40.95  ,40.95  ,"23,259.44  "
FireWrap® Grip Kit GLOW - Green ( 927 ),12/17/2022,Sales Receipt,9352,,"FIREWRAP® GRIP KIT
Color: GLOW Green (+$13)",4,40.95  ,163.80  ,"23,423.24  "
FireWrap® Grip Kit GLOW - Green ( 927 ),12/19/2022,Sales Receipt,9361,,"FIREWRAP® GRIP KIT
Color: GLOW Green (+$13)",1,40.95  ,40.95  ,"23,464.19  "
FireWrap® Grip Kit GLOW - Green ( 927 ),12/22/2022,Sales Receipt,M-112-9202838-4121006,,FireWrap® Grip Kit - Glow Green,1,41.95  ,41.95  ,"23,506.14  "
FireWrap® Grip Kit GLOW - Green ( 927 ),12/23/2022,Sales Receipt,M-112-3605703-2421868,,FireWrap® Grip Kit - Glow Green,1,41.95  ,41.95  ,"23,548.09  "
FireWrap® Grip Kit GLOW - Green ( 927 ),12/26/2022,Sales Receipt,M-114-0492714-5970605,,FireWrap® Grip Kit - Glow Green,1,41.95  ,41.95  ,"23,590.04  "
FireWrap® Grip Kit GLOW - Green ( 927 ),12/26/2022,Sales Receipt,9399,,"FIREWRAP® GRIP KIT
Color: GLOW Green (+$13)",1,40.95  ,40.95  ,"23,630.99  "
FireWrap® Grip Kit GLOW - Green ( 927 ),12/28/2022,Sales Receipt,M-112-2055382-0480251,,FireWrap® Grip Kit - Glow Green,1,41.95  ,41.95  ,"23,672.94  "
FireWrap® Grip Kit GLOW - Green ( 927 ),12/28/2022,Sales Receipt,M-112-5167974-3126646,,FireWrap® Grip Kit - Glow Green,1,41.95  ,41.95  ,"23,714.89  "
FireWrap® Grip Kit GLOW - Green ( 927 ),01/01/2023,Sales Receipt,M-112-8237336-9381055,,FireWrap® Grip Kit - Glow Green,1,41.95  ,41.95  ,"23,756.84  "
FireWrap® Grip Kit GLOW - Green ( 927 ),01/03/2023,Sales Receipt,M-111-4906617-9125059,,FireWrap® Grip Kit - Glow Green,1,41.95  ,41.95  ,"23,798.79  "
FireWrap® Grip Kit GLOW - Green ( 927 ),01/05/2023,Sales Receipt,M-111-4177566-3419448,,FireWrap® Grip Kit - Glow Green,1,41.95  ,41.95  ,"23,840.74  "
FireWrap® Grip Kit GLOW - Green ( 927 ),01/08/2023,Sales Receipt,9480,,"FIREWRAP® GRIP KIT
Color: GLOW Green (+$13)",1,40.95  ,40.95  ,"23,881.69  "
FireWrap® Grip Kit GLOW - Green ( 927 ),01/09/2023,Sales Receipt,9483,,"FIREWRAP® GRIP KIT
Color: GLOW Green (+$13)",1,40.95  ,40.95  ,"23,922.64  "
FireWrap® Grip Kit GLOW - Green ( 927 ),01/10/2023,Sales Receipt,9494,,"FIREWRAP® GRIP KIT
Color: GLOW Green (+$13)",1,40.95  ,40.95  ,"23,963.59  "
Total for FireWrap® Grip Kit GLOW - Green ( 927 ),,,,,,617,,"$	23,963.59  ",
FireWrap® Grip Kit Orange,,,,,,,,,
FireWrap® Grip Kit Orange,03/24/2018,Sales Receipt,#1397,,FireWrap  Grip Kit - Pre-Order,1,24.95  ,24.95  ,24.95  
FireWrap® Grip Kit Orange,03/24/2018,Sales Receipt,#1399,,FireWrap  Grip Kit - Pre-Order,1,24.95  ,24.95  ,49.90  
FireWrap® Grip Kit Orange,03/24/2018,Sales Receipt,#1404,,FireWrap  Grip Kit - Pre-Order,1,24.95  ,24.95  ,74.85  
FireWrap® Grip Kit Orange,04/05/2018,Sales Receipt,#1427,,FireWrap  Grip Kit - Pre-Order,1,24.95  ,24.95  ,99.80  
FireWrap® Grip Kit Orange,04/07/2018,Refund,#1427 (Refund 1),,FireWrap  Grip Kit - Pre-Order,-1,24.95  ,-24.95  ,74.85  
FireWrap® Grip Kit Orange,04/07/2018,Sales Receipt,#1430,,FireWrap  Grip Kit - Pre-Order,1,24.95  ,24.95  ,99.80  
FireWrap® Grip Kit Orange,04/12/2018,Sales Receipt,#1439,,FireWrap  Grip Kit - Pre-Order,1,24.95  ,24.95  ,124.75  
FireWrap® Grip Kit Orange,04/14/2018,Sales Receipt,#1445,,FireWrap  Grip Kit - Pre-Order,1,24.95  ,24.95  ,149.70  
FireWrap® Grip Kit Orange,04/14/2018,Sales Receipt,#1446,,FireWrap  Grip Kit - Pre-Order,2,24.95  ,49.90  ,199.60  
FireWrap® Grip Kit Orange,04/15/2018,Sales Receipt,#1449,,FireWrap  Grip Kit - Pre-Order,1,24.95  ,24.95  ,224.55  
FireWrap® Grip Kit Orange,04/18/2018,Sales Receipt,#1459,,FireWrap  Grip Kit - Pre-Order,2,24.95  ,49.90  ,274.45  
FireWrap® Grip Kit Orange,04/18/2018,Invoice,1104,,,1,0.00  ,0.00  ,274.45  
FireWrap® Grip Kit Orange,04/26/2018,Sales Receipt,#1476,,FireWrap  Grip Kit - Pre-Order,3,24.95  ,74.85  ,349.30  
FireWrap® Grip Kit Orange,04/26/2018,Sales Receipt,#1496,,FireWrap  Grip Kit - Pre-Order,1,24.95  ,24.95  ,374.25  
FireWrap® Grip Kit Orange,04/27/2018,Sales Receipt,#1538,,FireWrap  Grip Kit - Pre-Order,3,24.95  ,74.85  ,449.10  
FireWrap® Grip Kit Orange,04/27/2018,Sales Receipt,#1526,,FireWrap  Grip Kit - Pre-Order,1,24.95  ,24.95  ,474.05  
FireWrap® Grip Kit Orange,04/27/2018,Sales Receipt,#1524,,FireWrap  Grip Kit - Pre-Order,1,24.95  ,24.95  ,499.00  
FireWrap® Grip Kit Orange,04/28/2018,Sales Receipt,#1560,,FireWrap  Grip Kit - Pre-Order,1,24.95  ,24.95  ,523.95  
FireWrap® Grip Kit Orange,04/28/2018,Sales Receipt,#1551,,FireWrap  Grip Kit - Pre-Order,1,24.95  ,24.95  ,548.90  
FireWrap® Grip Kit Orange,04/28/2018,Sales Receipt,#1564,,FireWrap  Grip Kit - Pre-Order,1,24.95  ,24.95  ,573.85  
FireWrap® Grip Kit Orange,04/30/2018,Invoice,1113,,,3,20.00  ,60.00  ,633.85  
FireWrap® Grip Kit Orange,05/05/2018,Sales Receipt,#1597,,FireWrap  Grip Kit,1,34.95  ,34.95  ,668.80  
FireWrap® Grip Kit Orange,05/08/2018,Sales Receipt,#1608,,FireWrap  Grip Kit,2,34.95  ,69.90  ,738.70  
FireWrap® Grip Kit Orange,05/12/2018,Invoice,1115,,,4,26.00  ,104.00  ,842.70  
FireWrap® Grip Kit Orange,05/16/2018,Sales Receipt,#1622,,FireWrap  Grip Kit,1,34.95  ,34.95  ,877.65  
FireWrap® Grip Kit Orange,05/16/2018,Sales Receipt,#1621,,FireWrap  Grip Kit,2,34.95  ,69.90  ,947.55  
FireWrap® Grip Kit Orange,05/31/2018,Sales Receipt,#1655,,FireWrap  Grip Kit,1,34.95  ,34.95  ,982.50  
FireWrap® Grip Kit Orange,06/01/2018,Sales Receipt,#1658,,FireWrap  Grip Kit,2,34.95  ,69.90  ,"1,052.40  "
FireWrap® Grip Kit Orange,06/18/2018,Sales Receipt,#1682,,FireWrap  Grip Kit,1,34.95  ,34.95  ,"1,087.35  "
FireWrap® Grip Kit Orange,06/21/2018,Sales Receipt,#1686,,FireWrap  Grip Kit,1,34.95  ,34.95  ,"1,122.30  "
FireWrap® Grip Kit Orange,06/22/2018,Invoice,1133,,,8,26.00  ,208.00  ,"1,330.30  "
FireWrap® Grip Kit Orange,07/08/2018,Sales Receipt,#1710,,FireWrap  Grip Kit,1,34.95  ,34.95  ,"1,365.25  "
FireWrap® Grip Kit Orange,07/19/2018,Sales Receipt,#1727,,FireWrap  Grip Kit,4,34.95  ,139.80  ,"1,505.05  "
FireWrap® Grip Kit Orange,07/20/2018,Sales Receipt,#1732,,FireWrap  Grip Kit,2,34.95  ,69.90  ,"1,574.95  "
FireWrap® Grip Kit Orange,07/26/2018,Sales Receipt,#1739,,FireWrap  Grip Kit,1,34.95  ,34.95  ,"1,609.90  "
FireWrap® Grip Kit Orange,07/31/2018,Invoice,1149,,,1,34.95  ,34.95  ,"1,644.85  "
FireWrap® Grip Kit Orange,08/05/2018,Sales Receipt,#1756,,FireWrap  Grip Kit,1,34.95  ,34.95  ,"1,679.80  "
FireWrap® Grip Kit Orange,08/06/2018,Sales Receipt,#1759,,FireWrap  Grip Kit,2,34.95  ,69.90  ,"1,749.70  "
FireWrap® Grip Kit Orange,08/15/2018,Sales Receipt,#1774,,FireWrap  Grip Kit,1,34.95  ,34.95  ,"1,784.65  "
FireWrap® Grip Kit Orange,08/24/2018,Invoice,1166,,,1,30.00  ,30.00  ,"1,814.65  "
FireWrap® Grip Kit Orange,08/25/2018,Sales Receipt,#1792,,FireWrap  Grip Kit,1,34.95  ,34.95  ,"1,849.60  "
FireWrap® Grip Kit Orange,09/06/2018,Sales Receipt,#1816,,FireWrap  Grip Kit,1,34.95  ,34.95  ,"1,884.55  "
FireWrap® Grip Kit Orange,09/10/2018,Sales Receipt,#1822,,FireWrap  Grip Kit,1,34.95  ,34.95  ,"1,919.50  "
FireWrap® Grip Kit Orange,09/12/2018,Sales Receipt,#1826,,FireWrap  Grip Kit,1,34.95  ,34.95  ,"1,954.45  "
FireWrap® Grip Kit Orange,09/18/2018,Sales Receipt,#1846,,FireWrap  Grip Kit,1,34.95  ,34.95  ,"1,989.40  "
FireWrap® Grip Kit Orange,09/19/2018,Sales Receipt,#1852,,FireWrap  Grip Kit,1,34.95  ,34.95  ,"2,024.35  "
FireWrap® Grip Kit Orange,09/21/2018,Sales Receipt,#1858,,FireWrap  Grip Kit,1,34.95  ,34.95  ,"2,059.30  "
FireWrap® Grip Kit Orange,09/21/2018,Sales Receipt,#1860,,FireWrap  Grip Kit,1,34.95  ,34.95  ,"2,094.25  "
FireWrap® Grip Kit Orange,09/21/2018,Sales Receipt,#1859,,FireWrap  Grip Kit,1,34.95  ,34.95  ,"2,129.20  "
FireWrap® Grip Kit Orange,09/26/2018,Sales Receipt,#1871,,FireWrap  Grip Kit,1,34.95  ,34.95  ,"2,164.15  "
FireWrap® Grip Kit Orange,10/04/2018,Sales Receipt,#1890,,FireWrap  Grip Kit,1,34.95  ,34.95  ,"2,199.10  "
FireWrap® Grip Kit Orange,10/09/2018,Sales Receipt,#1895,,FireWrap  Grip Kit,1,34.95  ,34.95  ,"2,234.05  "
FireWrap® Grip Kit Orange,10/16/2018,Sales Receipt,#1904,,FireWrap  Grip Kit,1,34.95  ,34.95  ,"2,269.00  "
FireWrap® Grip Kit Orange,10/16/2018,Sales Receipt,#1907,,FireWrap  Grip Kit,2,34.95  ,69.90  ,"2,338.90  "
FireWrap® Grip Kit Orange,10/19/2018,Sales Receipt,#1931,,FireWrap  Grip Kit,1,34.95  ,34.95  ,"2,373.85  "
FireWrap® Grip Kit Orange,10/26/2018,Sales Receipt,#1963,,FireWrap  Grip Kit,1,34.95  ,34.95  ,"2,408.80  "
FireWrap® Grip Kit Orange,10/29/2018,Invoice,1192,,,13,24.00  ,312.00  ,"2,720.80  "
FireWrap® Grip Kit Orange,11/02/2018,Sales Receipt,#1980,,FireWrap  Grip Kit,1,34.95  ,34.95  ,"2,755.75  "
FireWrap® Grip Kit Orange,11/03/2018,Sales Receipt,#1984,,FireWrap  Grip Kit,2,34.95  ,69.90  ,"2,825.65  "
FireWrap® Grip Kit Orange,11/12/2018,Sales Receipt,#1993,,FireWrap  Grip Kit,1,34.95  ,34.95  ,"2,860.60  "
FireWrap® Grip Kit Orange,11/13/2018,Sales Receipt,#1996,,FireWrap  Grip Kit,4,34.95  ,139.80  ,"3,000.40  "
FireWrap® Grip Kit Orange,11/14/2018,Sales Receipt,#1999,,FireWrap  Grip Kit,2,34.95  ,69.90  ,"3,070.30  "
FireWrap® Grip Kit Orange,11/24/2018,Sales Receipt,#2023,,FireWrap  Grip Kit,1,34.95  ,34.95  ,"3,105.25  "
FireWrap® Grip Kit Orange,12/05/2018,Invoice,1215,,,6,25.00  ,150.00  ,"3,255.25  "
FireWrap® Grip Kit Orange,12/06/2018,Sales Receipt,#2066,,FireWrap  Grip Kit,5,34.95  ,174.75  ,"3,430.00  "
FireWrap® Grip Kit Orange,12/06/2018,Invoice,1216,,,20,30.00  ,600.00  ,"4,030.00  "
FireWrap® Grip Kit Orange,12/06/2018,Invoice,1216,,,20,30.00  ,600.00  ,"4,630.00  "
FireWrap® Grip Kit Orange,12/10/2018,Sales Receipt,#2078,,FireWrap  Grip Kit,2,34.95  ,69.90  ,"4,699.90  "
FireWrap® Grip Kit Orange,12/21/2018,Invoice,1237,,,2,34.95  ,69.90  ,"4,769.80  "
FireWrap® Grip Kit Orange,12/29/2018,Sales Receipt,#2141,,FireWrap Grip Kit,1,34.95  ,34.95  ,"4,804.75  "
FireWrap® Grip Kit Orange,01/04/2019,Sales Receipt,#2167,,FireWrap Grip Kit,1,34.95  ,34.95  ,"4,839.70  "
FireWrap® Grip Kit Orange,01/04/2019,Sales Receipt,#2164,,FireWrap  Grip Kit,7,34.95  ,244.65  ,"5,084.35  "
FireWrap® Grip Kit Orange,01/05/2019,Sales Receipt,#2169,,FireWrap  Grip Kit,1,34.95  ,34.95  ,"5,119.30  "
FireWrap® Grip Kit Orange,01/07/2019,Sales Receipt,#2174,,FireWrap  Grip Kit,1,34.95  ,34.95  ,"5,154.25  "
FireWrap® Grip Kit Orange,01/09/2019,Sales Receipt,#2184,,FireWrap  Grip Kit,2,34.95  ,69.90  ,"5,224.15  "
FireWrap® Grip Kit Orange,01/14/2019,Sales Receipt,#2198,,FireWrap Grip Kit,1,34.95  ,34.95  ,"5,259.10  "
FireWrap® Grip Kit Orange,01/18/2019,Sales Receipt,#2213,,FireWrap  Grip Kit,1,34.95  ,34.95  ,"5,294.05  "
FireWrap® Grip Kit Orange,01/18/2019,Sales Receipt,#2217,,FireWrap  Grip Kit,1,34.95  ,34.95  ,"5,329.00  "
FireWrap® Grip Kit Orange,01/22/2019,Sales Receipt,#2231,,FireWrap  Grip Kit,1,34.95  ,34.95  ,"5,363.95  "
FireWrap® Grip Kit Orange,01/23/2019,Sales Receipt,#2232,,FireWrap  Grip Kit,2,34.95  ,69.90  ,"5,433.85  "
FireWrap® Grip Kit Orange,01/25/2019,Invoice,1248,,,6,26.00  ,156.00  ,"5,589.85  "
FireWrap® Grip Kit Orange,01/28/2019,Sales Receipt,#2247,,FireWrap  Grip Kit,1,34.95  ,34.95  ,"5,624.80  "
FireWrap® Grip Kit Orange,01/28/2019,Invoice,1263,,,5,30.00  ,150.00  ,"5,774.80  "
FireWrap® Grip Kit Orange,01/29/2019,Sales Receipt,#2250,,FireWrap  Grip Kit,2,34.95  ,69.90  ,"5,844.70  "
FireWrap® Grip Kit Orange,01/31/2019,Sales Receipt,#2255,,FireWrap  Grip Kit,2,34.95  ,69.90  ,"5,914.60  "
FireWrap® Grip Kit Orange,02/01/2019,Sales Receipt,#2259,,FireWrap  Grip Kit,1,34.95  ,34.95  ,"5,949.55  "
FireWrap® Grip Kit Orange,02/02/2019,Invoice,1242,,P.O. Number: 19-0103-11,1,30.00  ,30.00  ,"5,979.55  "
FireWrap® Grip Kit Orange,02/03/2019,Sales Receipt,#2267,,FireWrap  Grip Kit,1,34.95  ,34.95  ,"6,014.50  "
FireWrap® Grip Kit Orange,02/05/2019,Sales Receipt,#2270,,FireWrap  Grip Kit,1,34.95  ,34.95  ,"6,049.45  "
FireWrap® Grip Kit Orange,02/14/2019,Sales Receipt,#2291,,FireWrap Grip Kit,1,34.95  ,34.95  ,"6,084.40  "
FireWrap® Grip Kit Orange,02/16/2019,Sales Receipt,#2301,,FireWrap Grip Kit,1,34.95  ,34.95  ,"6,119.35  "
FireWrap® Grip Kit Orange,02/18/2019,Invoice,1277,,,1,29.00  ,29.00  ,"6,148.35  "
FireWrap® Grip Kit Orange,02/18/2019,Invoice,1271,,,6,25.00  ,150.00  ,"6,298.35  "
FireWrap® Grip Kit Orange,02/20/2019,Invoice,1270,,,2,30.00  ,60.00  ,"6,358.35  "
FireWrap® Grip Kit Orange,02/20/2019,Sales Receipt,#2318,,FireWrap  Grip Kit,1,34.95  ,34.95  ,"6,393.30  "
FireWrap® Grip Kit Orange,02/27/2019,Sales Receipt,#2348,,FireWrap Grip Kit,2,34.95  ,69.90  ,"6,463.20  "
FireWrap® Grip Kit Orange,02/28/2019,Sales Receipt,#2354,,FireWrap  Grip Kit,1,34.95  ,34.95  ,"6,498.15  "
FireWrap® Grip Kit Orange,03/01/2019,Sales Receipt,#2358,,FireWrap  Grip Kit,1,34.95  ,34.95  ,"6,533.10  "
FireWrap® Grip Kit Orange,03/07/2019,Sales Receipt,#2387,,FireWrap Grip Kit,1,34.95  ,34.95  ,"6,568.05  "
FireWrap® Grip Kit Orange,03/11/2019,Invoice,1293,,,6,30.00  ,180.00  ,"6,748.05  "
FireWrap® Grip Kit Orange,03/13/2019,Sales Receipt,#2406,,FireWrap Grip Kit,1,34.95  ,34.95  ,"6,783.00  "
FireWrap® Grip Kit Orange,03/21/2019,Sales Receipt,#2430,,FireWrap  Grip Kit,1,34.95  ,34.95  ,"6,817.95  "
FireWrap® Grip Kit Orange,03/21/2019,Sales Receipt,#2428,,FireWrap Grip Kit,1,34.95  ,34.95  ,"6,852.90  "
FireWrap® Grip Kit Orange,03/22/2019,Sales Receipt,#2436,,FireWrap® Grip Kit,2,34.95  ,69.90  ,"6,922.80  "
FireWrap® Grip Kit Orange,03/24/2019,Sales Receipt,#2439,,FireWrap Grip Kit,1,34.95  ,34.95  ,"6,957.75  "
FireWrap® Grip Kit Orange,03/26/2019,Sales Receipt,#2446,,FireWrap® Grip Kit,2,34.95  ,69.90  ,"7,027.65  "
FireWrap® Grip Kit Orange,03/26/2019,Sales Receipt,#2448,,FireWrap Grip Kit,1,34.95  ,34.95  ,"7,062.60  "
FireWrap® Grip Kit Orange,03/28/2019,Sales Receipt,#2452,,FireWrap® Grip Kit,1,34.95  ,34.95  ,"7,097.55  "
FireWrap® Grip Kit Orange,04/01/2019,Sales Receipt,#2469,,FireWrap Grip Kit,1,34.95  ,34.95  ,"7,132.50  "
FireWrap® Grip Kit Orange,04/02/2019,Sales Receipt,#2477,,FireWrap Grip Kit,1,34.95  ,34.95  ,"7,167.45  "
FireWrap® Grip Kit Orange,04/05/2019,Sales Receipt,#2491,,FireWrap® Grip Kit,2,34.95  ,69.90  ,"7,237.35  "
FireWrap® Grip Kit Orange,04/05/2019,Invoice,1323,,,2,34.95  ,69.90  ,"7,307.25  "
FireWrap® Grip Kit Orange,04/24/2019,Sales Receipt,#2613,,FireWrap® Grip Kit,1,34.95  ,34.95  ,"7,342.20  "
FireWrap® Grip Kit Orange,05/24/2019,Invoice,1353,,,2,30.00  ,60.00  ,"7,402.20  "
FireWrap® Grip Kit Orange,05/24/2019,Invoice,1357,,,1,30.00  ,30.00  ,"7,432.20  "
FireWrap® Grip Kit Orange,06/03/2019,Invoice,1340,,,2,30.00  ,60.00  ,"7,492.20  "
FireWrap® Grip Kit Orange,06/03/2019,Invoice,1339,,P.O. Number: 19-0528-5,1,30.00  ,30.00  ,"7,522.20  "
FireWrap® Grip Kit Orange,06/04/2019,Invoice,1364,,,1,30.00  ,30.00  ,"7,552.20  "
FireWrap® Grip Kit Orange,06/11/2019,Invoice,1365,,,1,30.00  ,30.00  ,"7,582.20  "
FireWrap® Grip Kit Orange,06/12/2019,Sales Receipt,#2683,,FireWrap® Grip Kit,1,34.95  ,34.95  ,"7,617.15  "
FireWrap® Grip Kit Orange,06/15/2019,Sales Receipt,#2695,,FireWrap® Grip Kit,10,34.95  ,349.50  ,"7,966.65  "
FireWrap® Grip Kit Orange,06/19/2019,Invoice,1368,,,1,34.95  ,34.95  ,"8,001.60  "
FireWrap® Grip Kit Orange,06/19/2019,Sales Receipt,#2703,,FireWrap® Grip Kit,1,34.95  ,34.95  ,"8,036.55  "
FireWrap® Grip Kit Orange,06/20/2019,Sales Receipt,#2705,,FireWrap® Grip Kit,1,34.95  ,34.95  ,"8,071.50  "
FireWrap® Grip Kit Orange,06/24/2019,Invoice,1369,,,8,30.00  ,240.00  ,"8,311.50  "
FireWrap® Grip Kit Orange,06/28/2019,Invoice,1372,,"Zachary Cramer
33 E Main St
Sykesville PA 15865",2,30.00  ,60.00  ,"8,371.50  "
FireWrap® Grip Kit Orange,06/28/2019,Invoice,1372,,"Ryan Amormino
Clinton Twp Fire Dept.
42601 Romeo Plank Rd
Clinton Township MI 48038",1,30.00  ,30.00  ,"8,401.50  "
FireWrap® Grip Kit Orange,07/01/2019,Sales Receipt,#2740,,FireWrap® Grip Kit,1,34.95  ,34.95  ,"8,436.45  "
FireWrap® Grip Kit Orange,07/02/2019,Sales Receipt,#2746,,FireWrap Grip Kit,1,34.95  ,34.95  ,"8,471.40  "
FireWrap® Grip Kit Orange,07/02/2019,Invoice,1361,,"P.O. Number: 19-0619-7 
Ryan Reeves
5885 Scarlet Oak Rd
Guthrie, OK 73044",1,30.00  ,30.00  ,"8,501.40  "
FireWrap® Grip Kit Orange,07/03/2019,Sales Receipt,#2748,,FireWrap® Grip Kit,3,34.95  ,104.85  ,"8,606.25  "
FireWrap® Grip Kit Orange,07/07/2019,Sales Receipt,#2756,,FireWrap® Grip Kit,3,34.95  ,104.85  ,"8,711.10  "
FireWrap® Grip Kit Orange,07/24/2019,Sales Receipt,113-5159244-0484252,,FireWrap Grip Kit,1,34.95  ,34.95  ,"8,746.05  "
FireWrap® Grip Kit Orange,07/30/2019,Sales Receipt,114-2693983-6624235,,FireWrap Grip Kit (New),1,34.95  ,34.95  ,"8,781.00  "
FireWrap® Grip Kit Orange,08/01/2019,Invoice,1376,,"P.O. Number: 19-0725-3
Jason Shelby
1439 Boyce Rd
Waxahachie, TX 75165",1,26.00  ,26.00  ,"8,807.00  "
FireWrap® Grip Kit Orange,08/08/2019,Sales Receipt,114-8090894-7573056,,FireWrap Grip Kit,1,34.95  ,34.95  ,"8,841.95  "
FireWrap® Grip Kit Orange,08/14/2019,Sales Receipt,114-7412556-1933044,,FireWrap Grip Kit,1,34.95  ,34.95  ,"8,876.90  "
FireWrap® Grip Kit Orange,08/30/2019,Sales Receipt,112-9294171-5730643,,FireWrap Grip Kit (New),1,34.95  ,34.95  ,"8,911.85  "
FireWrap® Grip Kit Orange,09/12/2019,Sales Receipt,113-5974654-5676239,,FireWrap Grip Kit (New),1,34.95  ,34.95  ,"8,946.80  "
FireWrap® Grip Kit Orange,09/18/2019,Sales Receipt,111-0761755-8332230,,FireWrap Grip Kit (New),2,34.95  ,69.90  ,"9,016.70  "
FireWrap® Grip Kit Orange,09/21/2019,Sales Receipt,113-8611128-6349052,,FireWrap Grip Kit (New),1,34.95  ,34.95  ,"9,051.65  "
FireWrap® Grip Kit Orange,10/02/2019,Sales Receipt,112-3633542-9689866,,FireWrap Grip Kit (New),1,34.95  ,34.95  ,"9,086.60  "
FireWrap® Grip Kit Orange,01/03/2020,Sales Receipt,111-2426503-9951402,,FireWrap Grip Kit - Orange (New),1,24.95  ,24.95  ,"9,111.55  "
FireWrap® Grip Kit Orange,01/04/2020,Sales Receipt,111-4238042-5947436,,FireWrap Grip Kit - Orange (New),1,24.95  ,24.95  ,"9,136.50  "
FireWrap® Grip Kit Orange,01/06/2020,Sales Receipt,113-0968421-0703465,,FireWrap Grip Kit - Orange (New),1,24.95  ,24.95  ,"9,161.45  "
FireWrap® Grip Kit Orange,01/13/2020,Sales Receipt,113-9378556-5505865,,FireWrap Grip Kit - Orange (New),1,24.95  ,24.95  ,"9,186.40  "
FireWrap® Grip Kit Orange,01/30/2020,Sales Receipt,111-4546581-1139425,,FireWrap Grip Kit - Orange (New),1,24.95  ,24.95  ,"9,211.35  "
FireWrap® Grip Kit Orange,02/10/2020,Sales Receipt,114-4970473-3696238,,FireWrap Grip Kit - Orange (New),1,24.95  ,24.95  ,"9,236.30  "
FireWrap® Grip Kit Orange,03/15/2020,Sales Receipt,114-6479507-8073863,,FireWrap Grip Kit - Orange (New),1,24.95  ,24.95  ,"9,261.25  "
FireWrap® Grip Kit Orange,04/05/2020,Sales Receipt,3613,,FireWrap® Grip Kit - Orange,7,24.95  ,174.65  ,"9,435.90  "
FireWrap® Grip Kit Orange,04/15/2020,Sales Receipt,113-0948132-9413854,,FireWrap Grip Kit - Orange,0,0.00  ,0.00  ,"9,435.90  "
FireWrap® Grip Kit Orange,04/15/2020,Sales Receipt,114-2050346-8981016,,FireWrap Grip Kit - Orange (New),1,24.95  ,24.95  ,"9,460.85  "
FireWrap® Grip Kit Orange,04/20/2020,Sales Receipt,3671,,FireWrap® Grip Kit - Orange,1,24.95  ,24.95  ,"9,485.80  "
FireWrap® Grip Kit Orange,04/21/2020,Sales Receipt,3674,,FireWrap® Grip Kit - Orange,1,24.95  ,24.95  ,"9,510.75  "
FireWrap® Grip Kit Orange,04/22/2020,Sales Receipt,113-2577895-9585808,,FireWrap Grip Kit - Orange (New),1,24.95  ,24.95  ,"9,535.70  "
FireWrap® Grip Kit Orange,04/29/2020,Sales Receipt,3705,,FireWrap® Grip Kit - Orange,2,24.95  ,49.90  ,"9,585.60  "
FireWrap® Grip Kit Orange,04/29/2020,Sales Receipt,3707,,FireWrap® Grip Kit - Orange,1,24.95  ,24.95  ,"9,610.55  "
FireWrap® Grip Kit Orange,05/01/2020,Sales Receipt,3713,,FireWrap® Grip Kit - Orange,4,24.95  ,99.80  ,"9,710.35  "
FireWrap® Grip Kit Orange,05/04/2020,Sales Receipt,3723,,FireWrap® Grip Kit - Orange,1,24.95  ,24.95  ,"9,735.30  "
FireWrap® Grip Kit Orange,05/05/2020,Sales Receipt,3724,,FireWrap® Grip Kit - Orange,1,24.95  ,24.95  ,"9,760.25  "
FireWrap® Grip Kit Orange,05/16/2020,Sales Receipt,3770,,FireWrap® Grip Kit - Orange,1,24.95  ,24.95  ,"9,785.20  "
FireWrap® Grip Kit Orange,05/19/2020,Sales Receipt,3783,,FireWrap® Grip Kit - Orange,1,24.95  ,24.95  ,"9,810.15  "
FireWrap® Grip Kit Orange,05/21/2020,Sales Receipt,3788,,FireWrap® Grip Kit - Orange,1,24.95  ,24.95  ,"9,835.10  "
FireWrap® Grip Kit Orange,06/04/2020,Sales Receipt,3824,,FireWrap® Grip Kit - Orange,8,24.95  ,199.60  ,"10,034.70  "
FireWrap® Grip Kit Orange,06/11/2020,Sales Receipt,3848,,FireWrap® Grip Kit - Orange,3,24.95  ,74.85  ,"10,109.55  "
FireWrap® Grip Kit Orange,06/15/2020,Sales Receipt,3863,,FireWrap® Grip Kit - Orange,3,24.95  ,74.85  ,"10,184.40  "
FireWrap® Grip Kit Orange,06/16/2020,Sales Receipt,3870,,FireWrap® Grip Kit - Orange,3,24.95  ,74.85  ,"10,259.25  "
FireWrap® Grip Kit Orange,06/19/2020,Sales Receipt,3876,,FireWrap® Grip Kit - Orange,1,24.95  ,24.95  ,"10,284.20  "
FireWrap® Grip Kit Orange,06/23/2020,Sales Receipt,3943,,FireWrap® Grip Kit - Orange,2,24.95  ,49.90  ,"10,334.10  "
FireWrap® Grip Kit Orange,06/28/2020,Sales Receipt,3970,,FireWrap® Grip Kit - Orange,2,24.95  ,49.90  ,"10,384.00  "
FireWrap® Grip Kit Orange,06/30/2020,Sales Receipt,3978,,FireWrap® Grip Kit - Orange,1,24.95  ,24.95  ,"10,408.95  "
FireWrap® Grip Kit Orange,07/24/2020,Sales Receipt,4051,,FireWrap® Grip Kit - Orange,1,24.95  ,24.95  ,"10,433.90  "
FireWrap® Grip Kit Orange,07/30/2020,Sales Receipt,4066,,FireWrap® Grip Kit - Orange,1,24.95  ,24.95  ,"10,458.85  "
FireWrap® Grip Kit Orange,08/09/2020,Sales Receipt,4091,,FireWrap® Grip Kit - Orange,1,24.95  ,24.95  ,"10,483.80  "
FireWrap® Grip Kit Orange,08/17/2020,Sales Receipt,4115,,FireWrap® Grip Kit - Orange,2,24.95  ,49.90  ,"10,533.70  "
FireWrap® Grip Kit Orange,08/20/2020,Sales Receipt,4125,,FireWrap® Grip Kit - Orange,1,24.95  ,24.95  ,"10,558.65  "
FireWrap® Grip Kit Orange,08/24/2020,Sales Receipt,4151,,FireWrap® Grip Kit - Orange,2,24.95  ,49.90  ,"10,608.55  "
FireWrap® Grip Kit Orange,08/25/2020,Sales Receipt,4155,,FireWrap® Grip Kit - Orange,1,24.95  ,24.95  ,"10,633.50  "
FireWrap® Grip Kit Orange,09/02/2020,Sales Receipt,4183,,FireWrap® Grip Kit - Orange,1,24.95  ,24.95  ,"10,658.45  "
FireWrap® Grip Kit Orange,09/02/2020,Sales Receipt,4181,,FireWrap® Grip Kit - Orange,1,24.95  ,24.95  ,"10,683.40  "
FireWrap® Grip Kit Orange,09/09/2020,Sales Receipt,4202,,FireWrap® Grip Kit - Orange,1,24.95  ,24.95  ,"10,708.35  "
FireWrap® Grip Kit Orange,09/17/2020,Sales Receipt,4222,,FireWrap® Grip Kit - Orange,1,24.95  ,24.95  ,"10,733.30  "
FireWrap® Grip Kit Orange,09/23/2020,Sales Receipt,4261,,FireWrap® Grip Kit - Orange,2,24.95  ,49.90  ,"10,783.20  "
FireWrap® Grip Kit Orange,09/24/2020,Sales Receipt,4266,,FireWrap® Grip Kit - Orange,2,24.95  ,49.90  ,"10,833.10  "
FireWrap® Grip Kit Orange,09/24/2020,Sales Receipt,4272,,FireWrap® Grip Kit - Orange,1,24.95  ,24.95  ,"10,858.05  "
FireWrap® Grip Kit Orange,10/05/2020,Sales Receipt,4305,,FireWrap® Grip Kit - Orange,3,24.95  ,74.85  ,"10,932.90  "
FireWrap® Grip Kit Orange,10/07/2020,Sales Receipt,4315,,FireWrap® Grip Kit - Orange,2,24.95  ,49.90  ,"10,982.80  "
FireWrap® Grip Kit Orange,10/07/2020,Sales Receipt,4316,,FireWrap® Grip Kit - Orange,5,24.95  ,124.75  ,"11,107.55  "
FireWrap® Grip Kit Orange,10/09/2020,Sales Receipt,4335,,FireWrap® Grip Kit - Orange,1,24.95  ,24.95  ,"11,132.50  "
FireWrap® Grip Kit Orange,10/15/2020,Sales Receipt,4354,,FireWrap® Grip Kit - Orange,1,24.95  ,24.95  ,"11,157.45  "
FireWrap® Grip Kit Orange,10/20/2020,Sales Receipt,4383,,FireWrap® Grip Kit - Orange,2,24.95  ,49.90  ,"11,207.35  "
FireWrap® Grip Kit Orange,10/23/2020,Sales Receipt,4398,,FireWrap® Grip Kit - Orange,4,24.95  ,99.80  ,"11,307.15  "
FireWrap® Grip Kit Orange,10/27/2020,Sales Receipt,4421,,FireWrap® Grip Kit - Orange,1,24.95  ,24.95  ,"11,332.10  "
FireWrap® Grip Kit Orange,10/28/2020,Sales Receipt,4428,,FireWrap® Grip Kit - Orange,1,24.95  ,24.95  ,"11,357.05  "
FireWrap® Grip Kit Orange,11/01/2020,Sales Receipt,4451,,FireWrap® Grip Kit - Orange,1,24.95  ,24.95  ,"11,382.00  "
FireWrap® Grip Kit Orange,11/08/2020,Sales Receipt,4475,,FireWrap® Grip Kit - Orange,1,24.95  ,24.95  ,"11,406.95  "
FireWrap® Grip Kit Orange,11/10/2020,Sales Receipt,4488,,FireWrap® Grip Kit - Orange,1,24.95  ,24.95  ,"11,431.90  "
FireWrap® Grip Kit Orange,11/13/2020,Sales Receipt,4503,,FireWrap® Grip Kit - Orange,1,24.95  ,24.95  ,"11,456.85  "
FireWrap® Grip Kit Orange,11/15/2020,Sales Receipt,4511,,FireWrap® Grip Kit - Orange,6,24.95  ,149.70  ,"11,606.55  "
FireWrap® Grip Kit Orange,11/20/2020,Sales Receipt,4530,,FireWrap® Grip Kit - Orange,1,24.95  ,24.95  ,"11,631.50  "
FireWrap® Grip Kit Orange,11/30/2020,Sales Receipt,4601,,FireWrap® Grip Kit - Orange,1,24.95  ,24.95  ,"11,656.45  "
FireWrap® Grip Kit Orange,12/06/2020,Sales Receipt,4635,,FireWrap® Grip Kit - Orange,1,24.95  ,24.95  ,"11,681.40  "
FireWrap® Grip Kit Orange,12/16/2020,Sales Receipt,4685,,FireWrap® Grip Kit - Orange,1,24.95  ,24.95  ,"11,706.35  "
FireWrap® Grip Kit Orange,12/18/2020,Invoice,M-121820-006,,FireWrap® Grip Kit Orange,5,18.75  ,93.75  ,"11,800.10  "
FireWrap® Grip Kit Orange,12/21/2020,Sales Receipt,4709,,FireWrap® Grip Kit - Orange,1,24.95  ,24.95  ,"11,825.05  "
FireWrap® Grip Kit Orange,12/21/2020,Sales Receipt,4714,,FireWrap® Grip Kit - Orange,1,24.95  ,24.95  ,"11,850.00  "
FireWrap® Grip Kit Orange,12/23/2020,Sales Receipt,4720,,FireWrap® Grip Kit - Orange,1,24.95  ,24.95  ,"11,874.95  "
FireWrap® Grip Kit Orange,01/02/2021,Sales Receipt,4780,,FireWrap® Grip Kit - Orange,1,24.95  ,24.95  ,"11,899.90  "
FireWrap® Grip Kit Orange,01/08/2021,Sales Receipt,4802,,FireWrap® Grip Kit - Orange,2,24.95  ,49.90  ,"11,949.80  "
FireWrap® Grip Kit Orange,01/08/2021,Sales Receipt,4803,,FireWrap® Grip Kit - Orange,2,24.95  ,49.90  ,"11,999.70  "
FireWrap® Grip Kit Orange,01/19/2021,Invoice,M-011921-004,,FireWrap® Grip Kit Orange,7,18.75  ,131.25  ,"12,130.95  "
FireWrap® Grip Kit Orange,01/19/2021,Invoice,M-011921-020,,FireWrap® Grip Kit Orange,2,18.75  ,37.50  ,"12,168.45  "
FireWrap® Grip Kit Orange,01/19/2021,Invoice,M-011921-002,,FireWrap® Grip Kit Orange,4,18.75  ,75.00  ,"12,243.45  "
FireWrap® Grip Kit Orange,01/19/2021,Invoice,M-011921-005,,FireWrap® Grip Kit Orange,1,18.75  ,18.75  ,"12,262.20  "
FireWrap® Grip Kit Orange,01/26/2021,Invoice,M-012621-009,,FireWrap® Grip Kit Orange,2,18.75  ,37.50  ,"12,299.70  "
FireWrap® Grip Kit Orange,01/26/2021,Invoice,M-012621-018,,FireWrap® Grip Kit Orange,6,18.75  ,112.50  ,"12,412.20  "
FireWrap® Grip Kit Orange,01/26/2021,Invoice,M-012621-013,,FireWrap® Grip Kit Orange,1,18.75  ,18.75  ,"12,430.95  "
FireWrap® Grip Kit Orange,02/03/2021,Sales Receipt,4918,,FireWrap® Grip Kit - Orange,2,24.95  ,49.90  ,"12,480.85  "
FireWrap® Grip Kit Orange,02/03/2021,Invoice,M-020321-001,,FireWrap® Grip Kit Orange,1,18.75  ,18.75  ,"12,499.60  "
FireWrap® Grip Kit Orange,02/04/2021,Sales Receipt,4923,,FireWrap® Grip Kit - Orange,1,24.95  ,24.95  ,"12,524.55  "
FireWrap® Grip Kit Orange,02/11/2021,Sales Receipt,4950,,FireWrap® Grip Kit - Orange,4,24.95  ,99.80  ,"12,624.35  "
FireWrap® Grip Kit Orange,02/16/2021,Invoice,M-021621-002,,FireWrap® Grip Kit Orange,6,18.75  ,112.50  ,"12,736.85  "
FireWrap® Grip Kit Orange,02/16/2021,Invoice,M-021621-004,,FireWrap® Grip Kit Orange,1,18.75  ,18.75  ,"12,755.60  "
FireWrap® Grip Kit Orange,02/16/2021,Invoice,M-021621-018,,FireWrap® Grip Kit Orange,1,18.75  ,18.75  ,"12,774.35  "
FireWrap® Grip Kit Orange,02/16/2021,Invoice,M-021621-010,,FireWrap® Grip Kit Orange,1,18.75  ,18.75  ,"12,793.10  "
FireWrap® Grip Kit Orange,02/16/2021,Invoice,M-021621-020,,FireWrap® Grip Kit Orange,2,18.75  ,37.50  ,"12,830.60  "
FireWrap® Grip Kit Orange,02/18/2021,Sales Receipt,4983,,"FIREWRAP® GRIP KIT
Color: Orange",4,24.99  ,99.96  ,"12,930.56  "
FireWrap® Grip Kit Orange,02/20/2021,Sales Receipt,4996,,"FIREWRAP® GRIP KIT
Color: Orange",3,24.99  ,74.97  ,"13,005.53  "
FireWrap® Grip Kit Orange,02/21/2021,Sales Receipt,4999,,"FIREWRAP® GRIP KIT
Color: Orange",1,24.99  ,24.99  ,"13,030.52  "
FireWrap® Grip Kit Orange,02/22/2021,Sales Receipt,5007,,"FIREWRAP® GRIP KIT
Color: Orange",1,24.99  ,24.99  ,"13,055.51  "
FireWrap® Grip Kit Orange,02/22/2021,Sales Receipt,5008,,"FIREWRAP® GRIP KIT
Color: Orange",1,24.99  ,24.99  ,"13,080.50  "
FireWrap® Grip Kit Orange,02/23/2021,Sales Receipt,5010,,"FIREWRAP® GRIP KIT
Color: Orange",1,24.99  ,24.99  ,"13,105.49  "
FireWrap® Grip Kit Orange,02/24/2021,Invoice,M-022421-009,,FireWrap® Grip Kit Orange,2,18.75  ,37.50  ,"13,142.99  "
FireWrap® Grip Kit Orange,02/24/2021,Sales Receipt,5015,,"FIREWRAP® GRIP KIT
Color: Orange",1,24.99  ,24.99  ,"13,167.98  "
FireWrap® Grip Kit Orange,02/24/2021,Invoice,M-022421-001,,FireWrap® Grip Kit Orange,1,18.75  ,18.75  ,"13,186.73  "
FireWrap® Grip Kit Orange,03/03/2021,Sales Receipt,5041,,"FIREWRAP® GRIP KIT - Yes, I understand.
Color: Orange",1,24.99  ,24.99  ,"13,211.72  "
FireWrap® Grip Kit Orange,03/12/2021,Invoice,M-031221-008,,FireWrap® Grip Kit Orange,15,24.95  ,374.25  ,"13,585.97  "
FireWrap® Grip Kit Orange,03/12/2021,Sales Receipt,5094,,"FIREWRAP® GRIP KIT - Yes, I understand.
Color: Orange",16,24.99  ,399.84  ,"13,985.81  "
FireWrap® Grip Kit Orange,03/18/2021,Sales Receipt,5134,,"FIREWRAP® GRIP KIT - Yes, I understand.
Color: Orange",2,24.99  ,49.98  ,"14,035.79  "
FireWrap® Grip Kit Orange,03/19/2021,Sales Receipt,5142,,"FIREWRAP® GRIP KIT - Yes, I understand.
Color: Orange",1,24.99  ,24.99  ,"14,060.78  "
FireWrap® Grip Kit Orange,03/20/2021,Sales Receipt,5151,,"FIREWRAP® GRIP KIT - Yes, I understand.
Color: Orange",1,24.99  ,24.99  ,"14,085.77  "
FireWrap® Grip Kit Orange,03/22/2021,Sales Receipt,5161,,"FIREWRAP® GRIP KIT - Yes, I understand.
Color: Orange",3,24.99  ,74.97  ,"14,160.74  "
FireWrap® Grip Kit Orange,03/22/2021,Sales Receipt,5159,,"FIREWRAP® GRIP KIT - Yes, I understand.
Color: Orange",1,24.99  ,24.99  ,"14,185.73  "
FireWrap® Grip Kit Orange,03/22/2021,Sales Receipt,5160,,"FIREWRAP® GRIP KIT - Yes, I understand.
Color: Orange",2,24.99  ,49.98  ,"14,235.71  "
FireWrap® Grip Kit Orange,03/24/2021,Sales Receipt,5167,,"FIREWRAP® GRIP KIT - Yes, I understand.
Color: Orange",1,24.99  ,24.99  ,"14,260.70  "
FireWrap® Grip Kit Orange,03/25/2021,Sales Receipt,5173,,"FIREWRAP® GRIP KIT - Yes, I understand.
Color: Orange",1,24.99  ,24.99  ,"14,285.69  "
FireWrap® Grip Kit Orange,03/27/2021,Invoice,M-032721-006,,FireWrap® Grip Kit Orange,2,18.75  ,37.50  ,"14,323.19  "
FireWrap® Grip Kit Orange,03/27/2021,Invoice,M-032721-001,,FireWrap® Grip Kit Orange,3,18.75  ,56.25  ,"14,379.44  "
FireWrap® Grip Kit Orange,03/27/2021,Invoice,M-032721-001,,FireWrap® Grip Kit Orange,3,18.75  ,56.25  ,"14,435.69  "
FireWrap® Grip Kit Orange,03/27/2021,Invoice,M-021921-001,,FireWrap® Grip Kit Orange,2,18.75  ,37.50  ,"14,473.19  "
FireWrap® Grip Kit Orange,03/27/2021,Invoice,M-032721-002,,FireWrap® Grip Kit Orange,3,18.75  ,56.25  ,"14,529.44  "
FireWrap® Grip Kit Orange,03/27/2021,Invoice,M-032721-006,,FireWrap® Grip Kit Orange,4,18.75  ,75.00  ,"14,604.44  "
FireWrap® Grip Kit Orange,03/30/2021,Invoice,M-033021-005,,FireWrap® Grip Kit Orange,3,18.75  ,56.25  ,"14,660.69  "
FireWrap® Grip Kit Orange,03/30/2021,Sales Receipt,5212,,"FIREWRAP® GRIP KIT - Yes, I understand.
Color: Orange",4,24.99  ,99.96  ,"14,760.65  "
FireWrap® Grip Kit Orange,03/30/2021,Invoice,M-033021-008,,FireWrap® Grip Kit Orange,2,18.75  ,37.50  ,"14,798.15  "
FireWrap® Grip Kit Orange,04/02/2021,Sales Receipt,5228,,"FIREWRAP® GRIP KIT - Yes, I understand.
Color: Orange",1,24.99  ,24.99  ,"14,823.14  "
FireWrap® Grip Kit Orange,04/02/2021,Sales Receipt,5226,,"FIREWRAP® GRIP KIT - Yes, I understand.
Color: Orange",1,24.99  ,24.99  ,"14,848.13  "
FireWrap® Grip Kit Orange,04/02/2021,Sales Receipt,5231,,"FIREWRAP® GRIP KIT - Yes, I understand.
Color: Orange",2,24.99  ,49.98  ,"14,898.11  "
FireWrap® Grip Kit Orange,04/06/2021,Sales Receipt,5252,,"FIREWRAP® GRIP KIT - Yes, I understand.
Color: Orange",2,24.99  ,49.98  ,"14,948.09  "
FireWrap® Grip Kit Orange,04/07/2021,Sales Receipt,5258,,"FIREWRAP® GRIP KIT - Yes, I understand.
Color: Orange",1,24.99  ,24.99  ,"14,973.08  "
FireWrap® Grip Kit Orange,04/07/2021,Invoice,M-040721-003,,FireWrap® Grip Kit Orange,8,18.75  ,150.00  ,"15,123.08  "
FireWrap® Grip Kit Orange,04/08/2021,Invoice,M-040821-003,,FireWrap® Grip Kit Orange,1,18.75  ,18.75  ,"15,141.83  "
FireWrap® Grip Kit Orange,04/15/2021,Sales Receipt,5301,,"FIREWRAP® GRIP KIT - Yes, I understand.
Color: Orange",1,24.99  ,24.99  ,"15,166.82  "
FireWrap® Grip Kit Orange,04/16/2021,Sales Receipt,5308,,"FIREWRAP® GRIP KIT - Yes, I understand.
Color: Orange",2,24.99  ,49.98  ,"15,216.80  "
FireWrap® Grip Kit Orange,04/19/2021,Invoice,M-041921-001,,FireWrap® Grip Kit Orange,1,18.75  ,18.75  ,"15,235.55  "
FireWrap® Grip Kit Orange,04/20/2021,Sales Receipt,5334,,"FIREWRAP® GRIP KIT
Color: Orange",1,24.99  ,24.99  ,"15,260.54  "
FireWrap® Grip Kit Orange,04/21/2021,Sales Receipt,5341,,"FIREWRAP® GRIP KIT
Color: Orange",4,24.99  ,99.96  ,"15,360.50  "
FireWrap® Grip Kit Orange,04/23/2021,Invoice,M-042321-005,,FireWrap® Grip Kit Orange,2,24.95  ,49.90  ,"15,410.40  "
FireWrap® Grip Kit Orange,04/23/2021,Invoice,M-042321-003,,FireWrap® Grip Kit Orange,1,18.75  ,18.75  ,"15,429.15  "
FireWrap® Grip Kit Orange,04/24/2021,Sales Receipt,5368,,"FIREWRAP® GRIP KIT
Color: Orange",4,24.99  ,99.96  ,"15,529.11  "
FireWrap® Grip Kit Orange,04/26/2021,Sales Receipt,5395,,"FIREWRAP® GRIP KIT
Color: Orange",1,24.99  ,24.99  ,"15,554.10  "
FireWrap® Grip Kit Orange,04/26/2021,Sales Receipt,5392,,"FIREWRAP® GRIP KIT
Color: Orange",1,24.99  ,24.99  ,"15,579.09  "
FireWrap® Grip Kit Orange,04/30/2021,Invoice,M-043021-003,,FireWrap® Grip Kit Orange,4,18.75  ,75.00  ,"15,654.09  "
FireWrap® Grip Kit Orange,05/01/2021,Sales Receipt,5432,,"FIREWRAP® GRIP KIT
Color: Orange",1,24.99  ,24.99  ,"15,679.08  "
FireWrap® Grip Kit Orange,05/02/2021,Sales Receipt,5440,,"FIREWRAP® GRIP KIT
Color: Orange",1,24.99  ,24.99  ,"15,704.07  "
FireWrap® Grip Kit Orange,05/03/2021,Invoice,M-050321-003,,FireWrap® Grip Kit Orange,4,18.75  ,75.00  ,"15,779.07  "
FireWrap® Grip Kit Orange,05/05/2021,Sales Receipt,5452,,"FIREWRAP® GRIP KIT
Color: Orange",1,24.99  ,24.99  ,"15,804.06  "
FireWrap® Grip Kit Orange,05/07/2021,Sales Receipt,5461,,"FIREWRAP® GRIP KIT
Color: Orange",1,24.99  ,24.99  ,"15,829.05  "
FireWrap® Grip Kit Orange,05/09/2021,Sales Receipt,5475,,"FIREWRAP® GRIP KIT
Color: Orange",3,24.99  ,74.97  ,"15,904.02  "
FireWrap® Grip Kit Orange,05/10/2021,Sales Receipt,5480,,"FIREWRAP® GRIP KIT
Color: Orange",1,24.99  ,24.99  ,"15,929.01  "
FireWrap® Grip Kit Orange,05/12/2021,Sales Receipt,5490,,"FIREWRAP® GRIP KIT
Color: Orange",1,24.99  ,24.99  ,"15,954.00  "
FireWrap® Grip Kit Orange,05/13/2021,Sales Receipt,5501,,"FIREWRAP® GRIP KIT
Color: Orange",1,24.99  ,24.99  ,"15,978.99  "
FireWrap® Grip Kit Orange,05/13/2021,Sales Receipt,5499,,"FIREWRAP® GRIP KIT
Color: Orange",1,24.99  ,24.99  ,"16,003.98  "
FireWrap® Grip Kit Orange,05/15/2021,Sales Receipt,5512,,"FIREWRAP® GRIP KIT
Color: Orange",2,24.99  ,49.98  ,"16,053.96  "
FireWrap® Grip Kit Orange,05/16/2021,Sales Receipt,5518,,"FIREWRAP® GRIP KIT
Color: Orange",1,24.99  ,24.99  ,"16,078.95  "
FireWrap® Grip Kit Orange,05/26/2021,Sales Receipt,5582,,"FIREWRAP® GRIP KIT
Color: Orange",1,24.99  ,24.99  ,"16,103.94  "
FireWrap® Grip Kit Orange,06/01/2021,Invoice,M-060121-002,,FireWrap® Grip Kit Orange,2,18.75  ,37.50  ,"16,141.44  "
FireWrap® Grip Kit Orange,06/17/2021,Sales Receipt,5680,,"FIREWRAP® GRIP KIT
Color: Orange",2,24.99  ,49.98  ,"16,191.42  "
FireWrap® Grip Kit Orange,06/20/2021,Sales Receipt,5687,,"FIREWRAP® GRIP KIT
Color: Orange",1,24.99  ,24.99  ,"16,216.41  "
FireWrap® Grip Kit Orange,06/22/2021,Invoice,M-062221-004,,FireWrap® Grip Kit Orange,3,24.99  ,74.97  ,"16,291.38  "
FireWrap® Grip Kit Orange,06/22/2021,Sales Receipt,5697,,"FIREWRAP® GRIP KIT
Color: Orange",1,24.99  ,24.99  ,"16,316.37  "
FireWrap® Grip Kit Orange,06/28/2021,Sales Receipt,5713,,"FIREWRAP® GRIP KIT
Color: Orange",1,24.99  ,24.99  ,"16,341.36  "
FireWrap® Grip Kit Orange,06/29/2021,Sales Receipt,5720,,"FIREWRAP® GRIP KIT
Color: Orange",5,24.99  ,124.95  ,"16,466.31  "
FireWrap® Grip Kit Orange,07/02/2021,Sales Receipt,5736,,"FIREWRAP® GRIP KIT
Color: Orange",2,24.99  ,49.98  ,"16,516.29  "
FireWrap® Grip Kit Orange,07/04/2021,Sales Receipt,5744,,"FIREWRAP® GRIP KIT
Color: Orange",1,24.99  ,24.99  ,"16,541.28  "
FireWrap® Grip Kit Orange,07/05/2021,Sales Receipt,5749,,"FIREWRAP® GRIP KIT
Color: Orange",1,24.99  ,24.99  ,"16,566.27  "
FireWrap® Grip Kit Orange,07/09/2021,Sales Receipt,5764,,"FIREWRAP® GRIP KIT
Color: Orange",1,24.99  ,24.99  ,"16,591.26  "
FireWrap® Grip Kit Orange,07/15/2021,Sales Receipt,5786,,"FIREWRAP® GRIP KIT
Color: Orange",6,24.99  ,149.94  ,"16,741.20  "
FireWrap® Grip Kit Orange,07/15/2021,Invoice,M-052521-004,,FireWrap® Grip Kit Orange,4,18.75  ,75.00  ,"16,816.20  "
FireWrap® Grip Kit Orange,07/20/2021,Sales Receipt,5802,,"FIREWRAP® GRIP KIT
Color: Orange",1,24.99  ,24.99  ,"16,841.19  "
FireWrap® Grip Kit Orange,07/21/2021,Sales Receipt,5808,,"FIREWRAP® GRIP KIT
Color: Orange",1,24.99  ,24.99  ,"16,866.18  "
FireWrap® Grip Kit Orange,07/27/2021,Sales Receipt,5830,,"FIREWRAP® GRIP KIT
Color: Orange",1,24.99  ,24.99  ,"16,891.17  "
FireWrap® Grip Kit Orange,07/31/2021,Sales Receipt,5842,,"FIREWRAP® GRIP KIT
Color: Orange",5,24.99  ,124.95  ,"17,016.12  "
FireWrap® Grip Kit Orange,08/01/2021,Sales Receipt,5848,,"FIREWRAP® GRIP KIT
Color: Orange",2,24.99  ,49.98  ,"17,066.10  "
FireWrap® Grip Kit Orange,08/04/2021,Sales Receipt,5855,,"FIREWRAP® GRIP KIT
Color: Orange",3,24.99  ,74.97  ,"17,141.07  "
FireWrap® Grip Kit Orange,08/16/2021,Sales Receipt,5928,,"FIREWRAP® GRIP KIT
Color: Orange",5,24.99  ,124.95  ,"17,266.02  "
FireWrap® Grip Kit Orange,08/18/2021,Sales Receipt,5936,,"FIREWRAP® GRIP KIT
Color: Orange",3,24.99  ,74.97  ,"17,340.99  "
FireWrap® Grip Kit Orange,08/25/2021,Sales Receipt,5977,,"FIREWRAP® GRIP KIT
Color: Orange",1,24.99  ,24.99  ,"17,365.98  "
FireWrap® Grip Kit Orange,08/30/2021,Sales Receipt,6001,,"FIREWRAP® GRIP KIT
Color: Orange",1,24.99  ,24.99  ,"17,390.97  "
FireWrap® Grip Kit Orange,09/13/2021,Sales Receipt,6076,,"FIREWRAP® GRIP KIT
Color: Orange",8,24.99  ,199.92  ,"17,590.89  "
FireWrap® Grip Kit Orange,09/18/2021,Sales Receipt,6107,,"FIREWRAP® GRIP KIT
Color: Orange",1,24.99  ,24.99  ,"17,615.88  "
FireWrap® Grip Kit Orange,10/08/2021,Sales Receipt,6264,,"FIREWRAP® GRIP KIT
Color: Orange",1,24.95  ,24.95  ,"17,640.83  "
FireWrap® Grip Kit Orange,10/15/2021,Sales Receipt,6304,,"FIREWRAP® GRIP KIT
Color: Orange",1,24.95  ,24.95  ,"17,665.78  "
FireWrap® Grip Kit Orange,10/21/2021,Sales Receipt,6347,,"FIREWRAP® GRIP KIT
Color: Orange",1,24.95  ,24.95  ,"17,690.73  "
FireWrap® Grip Kit Orange,11/07/2021,Sales Receipt,6443,,"FIREWRAP® GRIP KIT
Color: Orange",1,24.95  ,24.95  ,"17,715.68  "
FireWrap® Grip Kit Orange,11/10/2021,Sales Receipt,6472,,"FIREWRAP® GRIP KIT
Color: Orange",1,24.95  ,24.95  ,"17,740.63  "
FireWrap® Grip Kit Orange,11/10/2021,Sales Receipt,6471,,"FIREWRAP® GRIP KIT
Color: Orange",1,24.95  ,24.95  ,"17,765.58  "
FireWrap® Grip Kit Orange,11/14/2021,Sales Receipt,6510,,"FIREWRAP® GRIP KIT
Color: Orange",1,24.95  ,24.95  ,"17,790.53  "
FireWrap® Grip Kit Orange,11/16/2021,Sales Receipt,6521,,"FIREWRAP® GRIP KIT
Color: Orange",1,24.95  ,24.95  ,"17,815.48  "
FireWrap® Grip Kit Orange,11/28/2021,Sales Receipt,6615,,"FIREWRAP® GRIP KIT
Color: Orange",1,19.99  ,19.99  ,"17,835.47  "
FireWrap® Grip Kit Orange,12/01/2021,Sales Receipt,6640,,"FIREWRAP® GRIP KIT
Color: Orange",2,19.99  ,39.98  ,"17,875.45  "
FireWrap® Grip Kit Orange,12/03/2021,Sales Receipt,6656,,"FIREWRAP® GRIP KIT
Color: Orange",1,19.99  ,19.99  ,"17,895.44  "
FireWrap® Grip Kit Orange,12/06/2021,Sales Receipt,6682,,"FIREWRAP® GRIP KIT
Color: Orange",1,24.95  ,24.95  ,"17,920.39  "
FireWrap® Grip Kit Orange,12/06/2021,Sales Receipt,6687,,"FIREWRAP® GRIP KIT
Color: Orange",17,24.95  ,424.15  ,"18,344.54  "
FireWrap® Grip Kit Orange,12/06/2021,Sales Receipt,6686,,"FIREWRAP® GRIP KIT
Color: Orange",1,24.95  ,24.95  ,"18,369.49  "
FireWrap® Grip Kit Orange,12/09/2021,Sales Receipt,6710,,"FIREWRAP® GRIP KIT
Color: Orange",1,24.95  ,24.95  ,"18,394.44  "
FireWrap® Grip Kit Orange,12/13/2021,Sales Receipt,6735,,"FIREWRAP® GRIP KIT
Color: Orange",2,24.95  ,49.90  ,"18,444.34  "
FireWrap® Grip Kit Orange,12/13/2021,Sales Receipt,6737,,"FIREWRAP® GRIP KIT
Color: Orange",1,24.95  ,24.95  ,"18,469.29  "
FireWrap® Grip Kit Orange,12/18/2021,Sales Receipt,6773,,"FIREWRAP® GRIP KIT
Color: Orange",1,24.95  ,24.95  ,"18,494.24  "
FireWrap® Grip Kit Orange,12/20/2021,Sales Receipt,6787,,"FIREWRAP® GRIP KIT
Color: Orange",12,24.95  ,299.40  ,"18,793.64  "
FireWrap® Grip Kit Orange,12/21/2021,Sales Receipt,6795,,"FIREWRAP® GRIP KIT
Color: Orange",1,24.95  ,24.95  ,"18,818.59  "
FireWrap® Grip Kit Orange,12/22/2021,Sales Receipt,6797,,"FIREWRAP® GRIP KIT
Color: Orange",1,24.95  ,24.95  ,"18,843.54  "
FireWrap® Grip Kit Orange,12/23/2021,Sales Receipt,6806,,"FIREWRAP® GRIP KIT
Color: Orange",4,24.95  ,99.80  ,"18,943.34  "
FireWrap® Grip Kit Orange,12/24/2021,Sales Receipt,6812,,"FIREWRAP® GRIP KIT
Color: Orange",1,24.95  ,24.95  ,"18,968.29  "
FireWrap® Grip Kit Orange,12/24/2021,Sales Receipt,6815,,"FIREWRAP® GRIP KIT
Color: Orange",1,24.95  ,24.95  ,"18,993.24  "
FireWrap® Grip Kit Orange,12/25/2021,Sales Receipt,6826,,"FIREWRAP® GRIP KIT
Color: Orange",1,24.95  ,24.95  ,"19,018.19  "
FireWrap® Grip Kit Orange,12/29/2021,Sales Receipt,6852,,"FIREWRAP® GRIP KIT
Color: Orange",1,24.95  ,24.95  ,"19,043.14  "
FireWrap® Grip Kit Orange,01/06/2022,Sales Receipt,6933,,"FIREWRAP® GRIP KIT
Color: Orange",1,24.95  ,24.95  ,"19,068.09  "
FireWrap® Grip Kit Orange,01/06/2022,Sales Receipt,6935,,"FIREWRAP® GRIP KIT
Color: Orange",3,24.95  ,74.85  ,"19,142.94  "
FireWrap® Grip Kit Orange,01/10/2022,Sales Receipt,6967,,"FIREWRAP® GRIP KIT
Color: Orange",3,24.95  ,74.85  ,"19,217.79  "
FireWrap® Grip Kit Orange,01/12/2022,Sales Receipt,6983,,"FIREWRAP® GRIP KIT
Color: Orange",1,24.95  ,24.95  ,"19,242.74  "
FireWrap® Grip Kit Orange,01/14/2022,Sales Receipt,7004,,"FIREWRAP® GRIP KIT
Color: Orange",2,24.95  ,49.90  ,"19,292.64  "
FireWrap® Grip Kit Orange,01/20/2022,Sales Receipt,7052,,"FIREWRAP® GRIP KIT
Color: Orange",1,24.95  ,24.95  ,"19,317.59  "
FireWrap® Grip Kit Orange,01/21/2022,Sales Receipt,7058,,"FIREWRAP® GRIP KIT
Color: Orange",1,24.95  ,24.95  ,"19,342.54  "
FireWrap® Grip Kit Orange,01/21/2022,Sales Receipt,7060,,"FIREWRAP® GRIP KIT
Color: Orange",3,24.95  ,74.85  ,"19,417.39  "
FireWrap® Grip Kit Orange,01/22/2022,Sales Receipt,7069,,"FIREWRAP® GRIP KIT
Color: Orange",2,24.95  ,49.90  ,"19,467.29  "
FireWrap® Grip Kit Orange,01/25/2022,Sales Receipt,7087,,"FIREWRAP® GRIP KIT
Color: Orange",2,24.95  ,49.90  ,"19,517.19  "
FireWrap® Grip Kit Orange,01/27/2022,Sales Receipt,7110,,"FIREWRAP® GRIP KIT
Color: Orange",1,24.95  ,24.95  ,"19,542.14  "
FireWrap® Grip Kit Orange,01/28/2022,Sales Receipt,7129,,"FIREWRAP® GRIP KIT
Color: Orange",10,24.95  ,249.50  ,"19,791.64  "
FireWrap® Grip Kit Orange,01/28/2022,Sales Receipt,7135,,"FIREWRAP® GRIP KIT
Color: Orange",5,24.95  ,124.75  ,"19,916.39  "
FireWrap® Grip Kit Orange,01/30/2022,Sales Receipt,7160,,"FIREWRAP® GRIP KIT
Color: Orange",1,24.95  ,24.95  ,"19,941.34  "
FireWrap® Grip Kit Orange,01/31/2022,Sales Receipt,7170,,"FIREWRAP® GRIP KIT
Color: Orange",1,24.95  ,24.95  ,"19,966.29  "
FireWrap® Grip Kit Orange,02/02/2022,Sales Receipt,7185,,"FIREWRAP® GRIP KIT
Color: Orange",1,27.95  ,27.95  ,"19,994.24  "
FireWrap® Grip Kit Orange,02/04/2022,Sales Receipt,7194,,"FIREWRAP® GRIP KIT
Color: Orange",1,27.95  ,27.95  ,"20,022.19  "
FireWrap® Grip Kit Orange,02/05/2022,Sales Receipt,7202,,"FIREWRAP® GRIP KIT
Color: Orange",1,27.95  ,27.95  ,"20,050.14  "
FireWrap® Grip Kit Orange,02/09/2022,Sales Receipt,7247,,"FIREWRAP® GRIP KIT
Color: Orange",5,27.95  ,139.75  ,"20,189.89  "
FireWrap® Grip Kit Orange,02/18/2022,Sales Receipt,7321,,"FIREWRAP® GRIP KIT
Color: Orange",1,27.95  ,27.95  ,"20,217.84  "
FireWrap® Grip Kit Orange,02/21/2022,Sales Receipt,7352,,"FIREWRAP® GRIP KIT
Color: Orange",1,27.95  ,27.95  ,"20,245.79  "
FireWrap® Grip Kit Orange,02/23/2022,Sales Receipt,7367,,"FIREWRAP® GRIP KIT
Color: Orange",1,27.95  ,27.95  ,"20,273.74  "
FireWrap® Grip Kit Orange,02/27/2022,Sales Receipt,7412,,"FIREWRAP® GRIP KIT
Color: Orange",1,27.95  ,27.95  ,"20,301.69  "
FireWrap® Grip Kit Orange,03/09/2022,Sales Receipt,7507,,"FIREWRAP® GRIP KIT
Color: Orange",1,27.95  ,27.95  ,"20,329.64  "
FireWrap® Grip Kit Orange,03/10/2022,Sales Receipt,7511,,"FIREWRAP® GRIP KIT
Color: Orange",2,27.95  ,55.90  ,"20,385.54  "
FireWrap® Grip Kit Orange,03/17/2022,Sales Receipt,7553,,"FIREWRAP® GRIP KIT
Color: Orange",2,27.95  ,55.90  ,"20,441.44  "
FireWrap® Grip Kit Orange,03/23/2022,Sales Receipt,7603,,"FIREWRAP® GRIP KIT
Color: Orange",3,27.95  ,83.85  ,"20,525.29  "
FireWrap® Grip Kit Orange,03/23/2022,Sales Receipt,7608,,"FIREWRAP® GRIP KIT
Color: Orange",2,27.95  ,55.90  ,"20,581.19  "
FireWrap® Grip Kit Orange,03/23/2022,Sales Receipt,7601,,"FIREWRAP® GRIP KIT
Color: Orange",1,27.95  ,27.95  ,"20,609.14  "
FireWrap® Grip Kit Orange,03/29/2022,Sales Receipt,7650,,"FIREWRAP® GRIP KIT
Color: Orange",8,27.95  ,223.60  ,"20,832.74  "
FireWrap® Grip Kit Orange,04/02/2022,Sales Receipt,7680,,"FIREWRAP® GRIP KIT
Color: Orange",1,27.95  ,27.95  ,"20,860.69  "
FireWrap® Grip Kit Orange,04/08/2022,Sales Receipt,7713,,"FIREWRAP® GRIP KIT
Color: Orange",5,27.95  ,139.75  ,"21,000.44  "
FireWrap® Grip Kit Orange,04/08/2022,Sales Receipt,7715,,"FIREWRAP® GRIP KIT
Color: Orange",2,27.95  ,55.90  ,"21,056.34  "
FireWrap® Grip Kit Orange,04/08/2022,Sales Receipt,7717,,"FIREWRAP® GRIP KIT
Color: Orange",1,27.95  ,27.95  ,"21,084.29  "
FireWrap® Grip Kit Orange,04/14/2022,Sales Receipt,7757,,"FIREWRAP® GRIP KIT
Color: Orange",1,27.95  ,27.95  ,"21,112.24  "
FireWrap® Grip Kit Orange,04/16/2022,Sales Receipt,7765,,"FIREWRAP® GRIP KIT
Color: Orange",1,27.95  ,27.95  ,"21,140.19  "
FireWrap® Grip Kit Orange,04/18/2022,Sales Receipt,7775,,"FIREWRAP® GRIP KIT
Color: Orange",1,27.95  ,27.95  ,"21,168.14  "
FireWrap® Grip Kit Orange,04/18/2022,Sales Receipt,7771,,"FIREWRAP® GRIP KIT
Color: Orange",1,27.95  ,27.95  ,"21,196.09  "
FireWrap® Grip Kit Orange,04/24/2022,Sales Receipt,7810,,"FIREWRAP® GRIP KIT
Color: Orange",2,27.95  ,55.90  ,"21,251.99  "
FireWrap® Grip Kit Orange,04/30/2022,Sales Receipt,7856,,"FIREWRAP® GRIP KIT
Color: Orange",2,22.95  ,45.90  ,"21,297.89  "
FireWrap® Grip Kit Orange,05/04/2022,Sales Receipt,7902,,"FIREWRAP® GRIP KIT
Color: Orange",4,22.95  ,91.80  ,"21,389.69  "
FireWrap® Grip Kit Orange,05/14/2022,Sales Receipt,7955,,"FIREWRAP® GRIP KIT
Color: Orange",2,27.95  ,55.90  ,"21,445.59  "
FireWrap® Grip Kit Orange,05/17/2022,Sales Receipt,7970,,"FIREWRAP® GRIP KIT
Color: Orange",1,27.95  ,27.95  ,"21,473.54  "
FireWrap® Grip Kit Orange,05/23/2022,Sales Receipt,7994,,"FIREWRAP® GRIP KIT
Color: Orange",1,27.95  ,27.95  ,"21,501.49  "
FireWrap® Grip Kit Orange,05/29/2022,Sales Receipt,8019,,"FIREWRAP® GRIP KIT
Color: Orange",1,27.95  ,27.95  ,"21,529.44  "
FireWrap® Grip Kit Orange,05/31/2022,Sales Receipt,8028,,"FIREWRAP® GRIP KIT
Color: Orange",5,27.95  ,139.75  ,"21,669.19  "
FireWrap® Grip Kit Orange,06/07/2022,Sales Receipt,8062,,"FIREWRAP® GRIP KIT
Color: Orange",5,27.95  ,139.75  ,"21,808.94  "
FireWrap® Grip Kit Orange,06/14/2022,Sales Receipt,8126,,"FIREWRAP® GRIP KIT
Color: Orange",3,27.95  ,83.85  ,"21,892.79  "
FireWrap® Grip Kit Orange,06/17/2022,Sales Receipt,8147,,"FIREWRAP® GRIP KIT
Color: Orange",2,27.95  ,55.90  ,"21,948.69  "
FireWrap® Grip Kit Orange,06/21/2022,Sales Receipt,8164,,"FIREWRAP® GRIP KIT
Color: Orange",8,27.95  ,223.60  ,"22,172.29  "
FireWrap® Grip Kit Orange,06/26/2022,Sales Receipt,8179,,"FIREWRAP® GRIP KIT
Color: Orange",1,27.95  ,27.95  ,"22,200.24  "
FireWrap® Grip Kit Orange,07/03/2022,Sales Receipt,8238,,"FIREWRAP® GRIP KIT
Color: Orange",1,27.95  ,27.95  ,"22,228.19  "
FireWrap® Grip Kit Orange,07/05/2022,Sales Receipt,8247,,"FIREWRAP® GRIP KIT
Color: Orange",2,27.95  ,55.90  ,"22,284.09  "
FireWrap® Grip Kit Orange,07/06/2022,Sales Receipt,8249,,"FIREWRAP® GRIP KIT
Color: Orange",4,27.95  ,111.80  ,"22,395.89  "
FireWrap® Grip Kit Orange,07/06/2022,Sales Receipt,8250,,"FIREWRAP® GRIP KIT
Color: Orange",1,27.95  ,27.95  ,"22,423.84  "
FireWrap® Grip Kit Orange,07/14/2022,Sales Receipt,8300,,"FIREWRAP® GRIP KIT
Color: Orange",1,27.95  ,27.95  ,"22,451.79  "
FireWrap® Grip Kit Orange,07/14/2022,Sales Receipt,8297,,"FIREWRAP® GRIP KIT
Color: Orange",1,27.95  ,27.95  ,"22,479.74  "
FireWrap® Grip Kit Orange,07/19/2022,Sales Receipt,8323,,"FIREWRAP® GRIP KIT
Color: Orange",4,27.95  ,111.80  ,"22,591.54  "
FireWrap® Grip Kit Orange,07/19/2022,Sales Receipt,8327,,"FIREWRAP® GRIP KIT
Color: Orange",1,27.95  ,27.95  ,"22,619.49  "
FireWrap® Grip Kit Orange,07/24/2022,Sales Receipt,8351,,"FIREWRAP® GRIP KIT
Color: Orange",1,27.95  ,27.95  ,"22,647.44  "
FireWrap® Grip Kit Orange,07/25/2022,Sales Receipt,8364,,"FIREWRAP® GRIP KIT
Color: Orange",2,27.95  ,55.90  ,"22,703.34  "
FireWrap® Grip Kit Orange,07/29/2022,Sales Receipt,8389,,"FIREWRAP® GRIP KIT
Color: Orange",1,27.95  ,27.95  ,"22,731.29  "
FireWrap® Grip Kit Orange,08/07/2022,Sales Receipt,8440,,"FIREWRAP® GRIP KIT
Color: Orange",6,27.95  ,167.70  ,"22,898.99  "
FireWrap® Grip Kit Orange,08/09/2022,Sales Receipt,8452,,"FIREWRAP® GRIP KIT
Color: Orange",2,27.95  ,55.90  ,"22,954.89  "
FireWrap® Grip Kit Orange,08/15/2022,Sales Receipt,8487,,"FIREWRAP® GRIP KIT
Color: Orange",10,27.95  ,279.50  ,"23,234.39  "
FireWrap® Grip Kit Orange,08/15/2022,Sales Receipt,8489,,"FIREWRAP® GRIP KIT
Color: Orange",10,27.95  ,279.50  ,"23,513.89  "
FireWrap® Grip Kit Orange,08/18/2022,Sales Receipt,8506,,"FIREWRAP® GRIP KIT
Color: Orange",1,27.95  ,27.95  ,"23,541.84  "
FireWrap® Grip Kit Orange,08/22/2022,Sales Receipt,8539,,"FIREWRAP® GRIP KIT
Color: Orange",1,27.95  ,27.95  ,"23,569.79  "
FireWrap® Grip Kit Orange,08/25/2022,Sales Receipt,8551,,"FIREWRAP® GRIP KIT
Color: Orange",1,27.95  ,27.95  ,"23,597.74  "
FireWrap® Grip Kit Orange,08/25/2022,Sales Receipt,8553,,"FIREWRAP® GRIP KIT
Color: Orange",1,27.95  ,27.95  ,"23,625.69  "
FireWrap® Grip Kit Orange,08/26/2022,Sales Receipt,8559,,"FIREWRAP® GRIP KIT
Color: Orange",3,27.95  ,83.85  ,"23,709.54  "
FireWrap® Grip Kit Orange,09/12/2022,Sales Receipt,8671,,"FIREWRAP® GRIP KIT
Color: Orange",1,27.95  ,27.95  ,"23,737.49  "
FireWrap® Grip Kit Orange,09/13/2022,Sales Receipt,8680,,"FIREWRAP® GRIP KIT
Color: Orange",1,27.95  ,27.95  ,"23,765.44  "
FireWrap® Grip Kit Orange,09/21/2022,Sales Receipt,8725,,"FIREWRAP® GRIP KIT
Color: Orange",1,27.95  ,27.95  ,"23,793.39  "
FireWrap® Grip Kit Orange,09/23/2022,Sales Receipt,8742,,"FIREWRAP® GRIP KIT
Color: Orange",1,27.95  ,27.95  ,"23,821.34  "
FireWrap® Grip Kit Orange,09/28/2022,Sales Receipt,8785,,"FIREWRAP® GRIP KIT
Color: Orange",1,27.95  ,27.95  ,"23,849.29  "
FireWrap® Grip Kit Orange,09/29/2022,Sales Receipt,8799,,"FIREWRAP® GRIP KIT
Color: Orange",5,27.95  ,139.75  ,"23,989.04  "
FireWrap® Grip Kit Orange,09/29/2022,Sales Receipt,8801,,"FIREWRAP® GRIP KIT
Color: Orange",1,27.95  ,27.95  ,"24,016.99  "
FireWrap® Grip Kit Orange,09/30/2022,Sales Receipt,8810,,"FIREWRAP® GRIP KIT
Color: Orange",4,27.95  ,111.80  ,"24,128.79  "
FireWrap® Grip Kit Orange,10/04/2022,Sales Receipt,8839,,"FIREWRAP® GRIP KIT
Color: Orange",1,27.95  ,27.95  ,"24,156.74  "
FireWrap® Grip Kit Orange,10/06/2022,Sales Receipt,8848,,"FIREWRAP® GRIP KIT
Color: Orange",1,27.95  ,27.95  ,"24,184.69  "
FireWrap® Grip Kit Orange,10/07/2022,Sales Receipt,8865,,"FIREWRAP® GRIP KIT
Color: Orange",1,27.95  ,27.95  ,"24,212.64  "
FireWrap® Grip Kit Orange,10/10/2022,Sales Receipt,8875,,"FIREWRAP® GRIP KIT
Color: Orange",2,27.95  ,55.90  ,"24,268.54  "
FireWrap® Grip Kit Orange,10/19/2022,Sales Receipt,8936,,"FIREWRAP® GRIP KIT
Color: Orange",4,27.95  ,111.80  ,"24,380.34  "
FireWrap® Grip Kit Orange,10/20/2022,Sales Receipt,8946,,"FIREWRAP® GRIP KIT
Color: Orange",2,27.95  ,55.90  ,"24,436.24  "
FireWrap® Grip Kit Orange,10/26/2022,Sales Receipt,8978,,"FIREWRAP® GRIP KIT
Color: Orange",1,27.95  ,27.95  ,"24,464.19  "
FireWrap® Grip Kit Orange,10/30/2022,Sales Receipt,9008,,"FIREWRAP® GRIP KIT
Color: Orange",1,27.95  ,27.95  ,"24,492.14  "
FireWrap® Grip Kit Orange,11/05/2022,Sales Receipt,M-114-0869749-8816218,,FireWrap® Grip Kit - Orange,1,28.95  ,28.95  ,"24,521.09  "
FireWrap® Grip Kit Orange,11/07/2022,Sales Receipt,9038,,"FIREWRAP® GRIP KIT
Color: Orange",2,27.95  ,55.90  ,"24,576.99  "
FireWrap® Grip Kit Orange,11/10/2022,Sales Receipt,9056,,"FIREWRAP® GRIP KIT
Color: Orange",1,27.95  ,27.95  ,"24,604.94  "
FireWrap® Grip Kit Orange,11/11/2022,Sales Receipt,M-111-1196557-5657034,,FireWrap® Grip Kit - Orange,1,28.95  ,28.95  ,"24,633.89  "
FireWrap® Grip Kit Orange,11/19/2022,Sales Receipt,9120,,"FIREWRAP® GRIP KIT
Color: Orange",2,27.95  ,55.90  ,"24,689.79  "
FireWrap® Grip Kit Orange,11/25/2022,Sales Receipt,M-113-2998776-9269037,,FireWrap® Grip Kit - Orange,1,28.95  ,28.95  ,"24,718.74  "
FireWrap® Grip Kit Orange,11/29/2022,Sales Receipt,9210,,"FIREWRAP® GRIP KIT
Color: Orange",1,27.95  ,27.95  ,"24,746.69  "
FireWrap® Grip Kit Orange,11/29/2022,Sales Receipt,9205,,"FIREWRAP® GRIP KIT
Color: Orange",1,27.95  ,27.95  ,"24,774.64  "
FireWrap® Grip Kit Orange,12/05/2022,Sales Receipt,9258,,"FIREWRAP® GRIP KIT
Color: Orange",2,27.95  ,55.90  ,"24,830.54  "
FireWrap® Grip Kit Orange,12/07/2022,Sales Receipt,9263,,"FIREWRAP® GRIP KIT
Color: Orange",1,27.95  ,27.95  ,"24,858.49  "
FireWrap® Grip Kit Orange,12/08/2022,Sales Receipt,9277,,"FIREWRAP® GRIP KIT
Color: Orange",1,27.95  ,27.95  ,"24,886.44  "
FireWrap® Grip Kit Orange,12/08/2022,Sales Receipt,9281,,"FIREWRAP® GRIP KIT
Color: Orange",1,27.95  ,27.95  ,"24,914.39  "
FireWrap® Grip Kit Orange,12/09/2022,Sales Receipt,M-111-0566281-7910615,,FireWrap® Grip Kit - Orange,6,28.95  ,173.70  ,"25,088.09  "
FireWrap® Grip Kit Orange,12/16/2022,Sales Receipt,9343,,"FIREWRAP® GRIP KIT
Color: Orange",1,27.95  ,27.95  ,"25,116.04  "
FireWrap® Grip Kit Orange,12/22/2022,Sales Receipt,9378,,"FIREWRAP® GRIP KIT
Color: Orange",1,27.95  ,27.95  ,"25,143.99  "
FireWrap® Grip Kit Orange,12/27/2022,Sales Receipt,M-113-4212263-1289804,,FireWrap® Grip Kit - Orange,1,28.95  ,28.95  ,"25,172.94  "
FireWrap® Grip Kit Orange,12/28/2022,Sales Receipt,9416,,"FIREWRAP® GRIP KIT
Color: Orange",1,27.95  ,27.95  ,"25,200.89  "
FireWrap® Grip Kit Orange,12/29/2022,Sales Receipt,M-114-7176662-4630657,,FireWrap® Grip Kit - Orange,1,28.95  ,28.95  ,"25,229.84  "
FireWrap® Grip Kit Orange,01/01/2023,Sales Receipt,9439,,"FIREWRAP® GRIP KIT
Color: Orange",1,27.95  ,27.95  ,"25,257.79  "
FireWrap® Grip Kit Orange,01/08/2023,Sales Receipt,9477,,"FIREWRAP® GRIP KIT
Color: Orange",10,27.95  ,279.50  ,"25,537.29  "
Total for FireWrap® Grip Kit Orange,,,,,,951,,"$	25,537.29  ",
FireWrap® Grip Kit Red,,,,,,,,,
FireWrap® Grip Kit Red,03/23/2018,Sales Receipt,#1392,,FireWrap  Grip Kit - Pre-Order,1,24.95  ,24.95  ,24.95  
FireWrap® Grip Kit Red,03/24/2018,Sales Receipt,#1400,,FireWrap  Grip Kit - Pre-Order,1,24.95  ,24.95  ,49.90  
FireWrap® Grip Kit Red,03/24/2018,Sales Receipt,#1402,,FireWrap  Grip Kit - Pre-Order,2,24.95  ,49.90  ,99.80  
FireWrap® Grip Kit Red,03/25/2018,Sales Receipt,#1409,,FireWrap  Grip Kit - Pre-Order,1,24.95  ,24.95  ,124.75  
FireWrap® Grip Kit Red,03/26/2018,Sales Receipt,#1412,,FireWrap  Grip Kit - Pre-Order,1,24.95  ,24.95  ,149.70  
FireWrap® Grip Kit Red,04/01/2018,Sales Receipt,#1422,,FireWrap  Grip Kit - Pre-Order,1,24.95  ,24.95  ,174.65  
FireWrap® Grip Kit Red,04/05/2018,Sales Receipt,#1425,,FireWrap  Grip Kit - Pre-Order,1,24.95  ,24.95  ,199.60  
FireWrap® Grip Kit Red,04/05/2018,Sales Receipt,#1426,,FireWrap  Grip Kit - Pre-Order,3,24.95  ,74.85  ,274.45  
FireWrap® Grip Kit Red,04/09/2018,Sales Receipt,#1434,,FireWrap  Grip Kit - Pre-Order,1,24.95  ,24.95  ,299.40  
FireWrap® Grip Kit Red,04/13/2018,Sales Receipt,#1442,,FireWrap  Grip Kit - Pre-Order,1,24.95  ,24.95  ,324.35  
FireWrap® Grip Kit Red,04/14/2018,Sales Receipt,#1446,,FireWrap  Grip Kit - Pre-Order,2,24.95  ,49.90  ,374.25  
FireWrap® Grip Kit Red,04/19/2018,Sales Receipt,#1460,,FireWrap  Grip Kit - Pre-Order,1,24.95  ,24.95  ,399.20  
FireWrap® Grip Kit Red,04/26/2018,Sales Receipt,#1494,,FireWrap  Grip Kit - Pre-Order,1,24.95  ,24.95  ,424.15  
FireWrap® Grip Kit Red,04/26/2018,Sales Receipt,#1496,,FireWrap  Grip Kit - Pre-Order,1,24.95  ,24.95  ,449.10  
FireWrap® Grip Kit Red,04/26/2018,Sales Receipt,#1490,,FireWrap  Grip Kit - Pre-Order,1,24.95  ,24.95  ,474.05  
FireWrap® Grip Kit Red,04/26/2018,Sales Receipt,#1476,,FireWrap  Grip Kit - Pre-Order,1,24.95  ,24.95  ,499.00  
FireWrap® Grip Kit Red,04/26/2018,Sales Receipt,#1478,,FireWrap  Grip Kit - Pre-Order,1,24.95  ,24.95  ,523.95  
FireWrap® Grip Kit Red,04/26/2018,Sales Receipt,#1472,,FireWrap  Grip Kit - Pre-Order,1,24.95  ,24.95  ,548.90  
FireWrap® Grip Kit Red,04/26/2018,Sales Receipt,#1470,,FireWrap  Grip Kit - Pre-Order,1,24.95  ,24.95  ,573.85  
FireWrap® Grip Kit Red,04/26/2018,Sales Receipt,#1479,,FireWrap  Grip Kit - Pre-Order,1,24.95  ,24.95  ,598.80  
FireWrap® Grip Kit Red,04/26/2018,Sales Receipt,#1468,,FireWrap  Grip Kit - Pre-Order,1,24.95  ,24.95  ,623.75  
FireWrap® Grip Kit Red,04/26/2018,Sales Receipt,#1482,,FireWrap  Grip Kit - Pre-Order,1,24.95  ,24.95  ,648.70  
FireWrap® Grip Kit Red,04/27/2018,Sales Receipt,#1531,,FireWrap  Grip Kit - Pre-Order,1,24.95  ,24.95  ,673.65  
FireWrap® Grip Kit Red,04/27/2018,Sales Receipt,#1507,,FireWrap  Grip Kit - Pre-Order,1,24.95  ,24.95  ,698.60  
FireWrap® Grip Kit Red,04/27/2018,Sales Receipt,#1527,,FireWrap  Grip Kit - Pre-Order,2,24.95  ,49.90  ,748.50  
FireWrap® Grip Kit Red,04/27/2018,Invoice,1107,,,4,24.95  ,99.80  ,848.30  
FireWrap® Grip Kit Red,04/27/2018,Sales Receipt,#1523,,FireWrap  Grip Kit - Pre-Order,1,24.95  ,24.95  ,873.25  
FireWrap® Grip Kit Red,04/27/2018,Sales Receipt,#1530,,FireWrap  Grip Kit - Pre-Order,1,24.95  ,24.95  ,898.20  
FireWrap® Grip Kit Red,04/27/2018,Sales Receipt,#1510,,FireWrap  Grip Kit - Pre-Order,1,24.95  ,24.95  ,923.15  
FireWrap® Grip Kit Red,04/28/2018,Sales Receipt,#1549,,FireWrap  Grip Kit - Pre-Order,1,24.95  ,24.95  ,948.10  
FireWrap® Grip Kit Red,04/28/2018,Sales Receipt,#1568,,FireWrap  Grip Kit - Pre-Order,1,24.95  ,24.95  ,973.05  
FireWrap® Grip Kit Red,04/28/2018,Sales Receipt,#1554,,FireWrap  Grip Kit - Pre-Order,1,24.95  ,24.95  ,998.00  
FireWrap® Grip Kit Red,04/28/2018,Sales Receipt,#1551,,FireWrap  Grip Kit - Pre-Order,1,24.95  ,24.95  ,"1,022.95  "
FireWrap® Grip Kit Red,04/28/2018,Sales Receipt,#1573,,FireWrap  Grip Kit - Pre-Order,1,24.95  ,24.95  ,"1,047.90  "
FireWrap® Grip Kit Red,04/28/2018,Sales Receipt,#1552,,FireWrap  Grip Kit - Pre-Order,1,24.95  ,24.95  ,"1,072.85  "
FireWrap® Grip Kit Red,04/28/2018,Sales Receipt,#1553,,FireWrap  Grip Kit - Pre-Order,1,24.95  ,24.95  ,"1,097.80  "
FireWrap® Grip Kit Red,04/30/2018,Sales Receipt,#1580,,FireWrap  Grip Kit - Pre-Order,1,24.95  ,24.95  ,"1,122.75  "
FireWrap® Grip Kit Red,04/30/2018,Invoice,1112,,,3,20.00  ,60.00  ,"1,182.75  "
FireWrap® Grip Kit Red,04/30/2018,Invoice,1111,,,2,20.00  ,40.00  ,"1,222.75  "
FireWrap® Grip Kit Red,05/03/2018,Sales Receipt,#1592,,FireWrap  Grip Kit,1,34.95  ,34.95  ,"1,257.70  "
FireWrap® Grip Kit Red,05/09/2018,Sales Receipt,#1610,,FireWrap  Grip Kit,1,34.95  ,34.95  ,"1,292.65  "
FireWrap® Grip Kit Red,05/09/2018,Invoice,1114,,,2,30.00  ,60.00  ,"1,352.65  "
FireWrap® Grip Kit Red,05/11/2018,Sales Receipt,#1616,,FireWrap  Grip Kit,1,34.95  ,34.95  ,"1,387.60  "
FireWrap® Grip Kit Red,05/12/2018,Invoice,1115,,,5,26.00  ,130.00  ,"1,517.60  "
FireWrap® Grip Kit Red,05/14/2018,Sales Receipt,#1617,,FireWrap  Grip Kit,1,34.95  ,34.95  ,"1,552.55  "
FireWrap® Grip Kit Red,05/16/2018,Sales Receipt,#1621,,FireWrap  Grip Kit,2,34.95  ,69.90  ,"1,622.45  "
FireWrap® Grip Kit Red,05/18/2018,Sales Receipt,#1628,,FireWrap  Grip Kit,1,34.95  ,34.95  ,"1,657.40  "
FireWrap® Grip Kit Red,05/18/2018,Sales Receipt,#1626,,FireWrap  Grip Kit,1,34.95  ,34.95  ,"1,692.35  "
FireWrap® Grip Kit Red,05/22/2018,Sales Receipt,#1638,,FireWrap  Grip Kit,3,34.95  ,104.85  ,"1,797.20  "
FireWrap® Grip Kit Red,05/22/2018,Sales Receipt,#1637,,FireWrap  Grip Kit,1,34.95  ,34.95  ,"1,832.15  "
FireWrap® Grip Kit Red,05/24/2018,Sales Receipt,#1645,,FireWrap  Grip Kit,1,34.95  ,34.95  ,"1,867.10  "
FireWrap® Grip Kit Red,05/24/2018,Invoice,1121,,,3,30.00  ,90.00  ,"1,957.10  "
FireWrap® Grip Kit Red,05/25/2018,Sales Receipt,#1646,,FireWrap  Grip Kit,3,34.95  ,104.85  ,"2,061.95  "
FireWrap® Grip Kit Red,05/26/2018,Sales Receipt,#1648,,FireWrap  Grip Kit,1,34.95  ,34.95  ,"2,096.90  "
FireWrap® Grip Kit Red,05/26/2018,Sales Receipt,#1649,,FireWrap  Grip Kit,1,34.95  ,34.95  ,"2,131.85  "
FireWrap® Grip Kit Red,05/30/2018,Sales Receipt,#1654,,FireWrap  Grip Kit,1,34.95  ,34.95  ,"2,166.80  "
FireWrap® Grip Kit Red,06/01/2018,Sales Receipt,#1656,,FireWrap  Grip Kit,1,34.95  ,34.95  ,"2,201.75  "
FireWrap® Grip Kit Red,06/01/2018,Sales Receipt,#1657,,FireWrap  Grip Kit,1,34.95  ,34.95  ,"2,236.70  "
FireWrap® Grip Kit Red,06/04/2018,Invoice,1124,,,1,34.95  ,34.95  ,"2,271.65  "
FireWrap® Grip Kit Red,06/06/2018,Sales Receipt,#1666,,FireWrap  Grip Kit,3,34.95  ,104.85  ,"2,376.50  "
FireWrap® Grip Kit Red,06/09/2018,Sales Receipt,#1670,,FireWrap  Grip Kit,1,34.95  ,34.95  ,"2,411.45  "
FireWrap® Grip Kit Red,06/12/2018,Invoice,1128,,,2,34.95  ,69.90  ,"2,481.35  "
FireWrap® Grip Kit Red,06/15/2018,Sales Receipt,#1676,,FireWrap  Grip Kit,1,34.95  ,34.95  ,"2,516.30  "
FireWrap® Grip Kit Red,06/16/2018,Sales Receipt,#1677,,FireWrap  Grip Kit,1,34.95  ,34.95  ,"2,551.25  "
FireWrap® Grip Kit Red,06/18/2018,Invoice,1131,,,3,34.95  ,104.85  ,"2,656.10  "
FireWrap® Grip Kit Red,06/18/2018,Sales Receipt,#1681,,FireWrap  Grip Kit,4,34.95  ,139.80  ,"2,795.90  "
FireWrap® Grip Kit Red,06/18/2018,Sales Receipt,#1680,,FireWrap  Grip Kit,2,34.95  ,69.90  ,"2,865.80  "
FireWrap® Grip Kit Red,06/22/2018,Invoice,1133,,,17,26.00  ,442.00  ,"3,307.80  "
FireWrap® Grip Kit Red,06/23/2018,Sales Receipt,#1690,,FireWrap  Grip Kit,1,34.95  ,34.95  ,"3,342.75  "
FireWrap® Grip Kit Red,06/28/2018,Sales Receipt,#1692,,FireWrap  Grip Kit,1,34.95  ,34.95  ,"3,377.70  "
FireWrap® Grip Kit Red,06/29/2018,Sales Receipt,#1696,,FireWrap  Grip Kit,11,34.95  ,384.45  ,"3,762.15  "
FireWrap® Grip Kit Red,07/06/2018,Invoice,1137,,,1,0.00  ,0.00  ,"3,762.15  "
FireWrap® Grip Kit Red,07/07/2018,Sales Receipt,#1707,,FireWrap  Grip Kit,1,34.95  ,34.95  ,"3,797.10  "
FireWrap® Grip Kit Red,07/07/2018,Sales Receipt,#1706,,FireWrap  Grip Kit,1,34.95  ,34.95  ,"3,832.05  "
FireWrap® Grip Kit Red,07/12/2018,Sales Receipt,#1713,,FireWrap  Grip Kit,1,34.95  ,34.95  ,"3,867.00  "
FireWrap® Grip Kit Red,07/13/2018,Invoice,1140,,,6,30.00  ,180.00  ,"4,047.00  "
FireWrap® Grip Kit Red,07/14/2018,Sales Receipt,#1719,,FireWrap  Grip Kit,2,34.95  ,69.90  ,"4,116.90  "
FireWrap® Grip Kit Red,07/15/2018,Sales Receipt,#1720,,FireWrap  Grip Kit,1,34.95  ,34.95  ,"4,151.85  "
FireWrap® Grip Kit Red,07/18/2018,Sales Receipt,#1726,,FireWrap  Grip Kit,1,34.95  ,34.95  ,"4,186.80  "
FireWrap® Grip Kit Red,07/19/2018,Sales Receipt,#1728,,FireWrap  Grip Kit,1,34.95  ,34.95  ,"4,221.75  "
FireWrap® Grip Kit Red,07/19/2018,Invoice,1141,,,1,34.95  ,34.95  ,"4,256.70  "
FireWrap® Grip Kit Red,07/20/2018,Sales Receipt,#1732,,FireWrap  Grip Kit,2,34.95  ,69.90  ,"4,326.60  "
FireWrap® Grip Kit Red,07/23/2018,Sales Receipt,#1737,,FireWrap  Grip Kit,1,34.95  ,34.95  ,"4,361.55  "
FireWrap® Grip Kit Red,07/30/2018,Sales Receipt,#1742,,FireWrap  Grip Kit,1,34.95  ,34.95  ,"4,396.50  "
FireWrap® Grip Kit Red,07/31/2018,Invoice,1148,,,2,34.95  ,69.90  ,"4,466.40  "
FireWrap® Grip Kit Red,08/01/2018,Invoice,1154,,,30,34.95  ,"1,048.50  ","5,514.90  "
FireWrap® Grip Kit Red,08/02/2018,Sales Receipt,#1750,,FireWrap  Grip Kit,1,34.95  ,34.95  ,"5,549.85  "
FireWrap® Grip Kit Red,08/06/2018,Sales Receipt,#1759,,FireWrap  Grip Kit,2,34.95  ,69.90  ,"5,619.75  "
FireWrap® Grip Kit Red,08/08/2018,Sales Receipt,#1761,,FireWrap  Grip Kit,1,34.95  ,34.95  ,"5,654.70  "
FireWrap® Grip Kit Red,08/09/2018,Invoice,1156,,,2,30.00  ,60.00  ,"5,714.70  "
FireWrap® Grip Kit Red,08/13/2018,Sales Receipt,#1771,,FireWrap  Grip Kit,3,34.95  ,104.85  ,"5,819.55  "
FireWrap® Grip Kit Red,08/21/2018,Invoice,1163,,,9,28.00  ,252.00  ,"6,071.55  "
FireWrap® Grip Kit Red,08/24/2018,Invoice,1166,,,1,30.00  ,30.00  ,"6,101.55  "
FireWrap® Grip Kit Red,09/06/2018,Sales Receipt,#1816,,FireWrap  Grip Kit,1,34.95  ,34.95  ,"6,136.50  "
FireWrap® Grip Kit Red,09/10/2018,Sales Receipt,#1822,,FireWrap  Grip Kit,1,34.95  ,34.95  ,"6,171.45  "
FireWrap® Grip Kit Red,09/11/2018,Sales Receipt,#1825,,FireWrap  Grip Kit,1,34.95  ,34.95  ,"6,206.40  "
FireWrap® Grip Kit Red,09/18/2018,Sales Receipt,#1846,,FireWrap  Grip Kit,1,34.95  ,34.95  ,"6,241.35  "
FireWrap® Grip Kit Red,09/20/2018,Sales Receipt,#1854,,FireWrap  Grip Kit,1,34.95  ,34.95  ,"6,276.30  "
FireWrap® Grip Kit Red,09/24/2018,Sales Receipt,#1863,,FireWrap  Grip Kit,1,34.95  ,34.95  ,"6,311.25  "
FireWrap® Grip Kit Red,09/30/2018,Sales Receipt,#1879,,FireWrap  Grip Kit,1,34.95  ,34.95  ,"6,346.20  "
FireWrap® Grip Kit Red,10/01/2018,Sales Receipt,#1882,,FireWrap  Grip Kit,1,34.95  ,34.95  ,"6,381.15  "
FireWrap® Grip Kit Red,10/02/2018,Sales Receipt,#1884,,FireWrap  Grip Kit,2,34.95  ,69.90  ,"6,451.05  "
FireWrap® Grip Kit Red,10/02/2018,Sales Receipt,#1883,,FireWrap  Grip Kit,1,34.95  ,34.95  ,"6,486.00  "
FireWrap® Grip Kit Red,10/04/2018,Sales Receipt,#1888,,FireWrap  Grip Kit,1,34.95  ,34.95  ,"6,520.95  "
FireWrap® Grip Kit Red,10/10/2018,Sales Receipt,#1897,,FireWrap  Grip Kit,1,34.95  ,34.95  ,"6,555.90  "
FireWrap® Grip Kit Red,10/10/2018,Sales Receipt,#1896,,FireWrap  Grip Kit,1,34.95  ,34.95  ,"6,590.85  "
FireWrap® Grip Kit Red,10/12/2018,Sales Receipt,#1900,,FireWrap  Grip Kit,2,34.95  ,69.90  ,"6,660.75  "
FireWrap® Grip Kit Red,10/13/2018,Sales Receipt,#1901,,FireWrap  Grip Kit,2,34.95  ,69.90  ,"6,730.65  "
FireWrap® Grip Kit Red,10/17/2018,Invoice,1180,,,20,34.95  ,699.00  ,"7,429.65  "
FireWrap® Grip Kit Red,10/18/2018,Sales Receipt,#1927,,FireWrap  Grip Kit,4,34.95  ,139.80  ,"7,569.45  "
FireWrap® Grip Kit Red,10/22/2018,Sales Receipt,#1954,,FireWrap  Grip Kit,1,34.95  ,34.95  ,"7,604.40  "
FireWrap® Grip Kit Red,10/23/2018,Invoice,1184,,,9,28.00  ,252.00  ,"7,856.40  "
FireWrap® Grip Kit Red,10/23/2018,Sales Receipt,#1957,,FireWrap  Grip Kit,1,34.95  ,34.95  ,"7,891.35  "
FireWrap® Grip Kit Red,10/23/2018,Sales Receipt,#1956,,FireWrap  Grip Kit,2,34.95  ,69.90  ,"7,961.25  "
FireWrap® Grip Kit Red,10/25/2018,Sales Receipt,#1959,,FireWrap  Grip Kit,1,34.95  ,34.95  ,"7,996.20  "
FireWrap® Grip Kit Red,10/25/2018,Sales Receipt,#1961,,FireWrap  Grip Kit,3,34.95  ,104.85  ,"8,101.05  "
FireWrap® Grip Kit Red,10/26/2018,Sales Receipt,#1962,,FireWrap  Grip Kit,1,34.95  ,34.95  ,"8,136.00  "
FireWrap® Grip Kit Red,10/26/2018,Invoice,1189,,,9,30.00  ,270.00  ,"8,406.00  "
FireWrap® Grip Kit Red,10/29/2018,Invoice,1192,,,33,24.00  ,792.00  ,"9,198.00  "
FireWrap® Grip Kit Red,10/29/2018,Sales Receipt,#1969,,FireWrap  Grip Kit,1,34.95  ,34.95  ,"9,232.95  "
FireWrap® Grip Kit Red,10/31/2018,Sales Receipt,#1971,,FireWrap  Grip Kit,1,34.95  ,34.95  ,"9,267.90  "
FireWrap® Grip Kit Red,11/02/2018,Sales Receipt,#1978,,FireWrap  Grip Kit,1,34.95  ,34.95  ,"9,302.85  "
FireWrap® Grip Kit Red,11/02/2018,Sales Receipt,#1981,,FireWrap  Grip Kit,1,34.95  ,34.95  ,"9,337.80  "
FireWrap® Grip Kit Red,11/03/2018,Sales Receipt,#1985,,FireWrap  Grip Kit,2,34.95  ,69.90  ,"9,407.70  "
FireWrap® Grip Kit Red,11/03/2018,Sales Receipt,#1984,,FireWrap  Grip Kit,2,34.95  ,69.90  ,"9,477.60  "
FireWrap® Grip Kit Red,11/05/2018,Sales Receipt,#1986,,FireWrap  Grip Kit,2,34.95  ,69.90  ,"9,547.50  "
FireWrap® Grip Kit Red,11/07/2018,Sales Receipt,#1987,,FireWrap  Grip Kit,1,34.95  ,34.95  ,"9,582.45  "
FireWrap® Grip Kit Red,11/13/2018,Invoice,1203,,,4,28.00  ,112.00  ,"9,694.45  "
FireWrap® Grip Kit Red,11/14/2018,Invoice,1204,,,4,34.95  ,139.80  ,"9,834.25  "
FireWrap® Grip Kit Red,11/19/2018,Sales Receipt,#2007,,FireWrap  Grip Kit,1,34.95  ,34.95  ,"9,869.20  "
FireWrap® Grip Kit Red,11/24/2018,Sales Receipt,#2028,,FireWrap  Grip Kit,1,34.95  ,34.95  ,"9,904.15  "
FireWrap® Grip Kit Red,11/25/2018,Sales Receipt,#2031,,FireWrap  Grip Kit,1,34.95  ,34.95  ,"9,939.10  "
FireWrap® Grip Kit Red,11/29/2018,Invoice,1212,,,1,30.00  ,30.00  ,"9,969.10  "
FireWrap® Grip Kit Red,11/29/2018,Sales Receipt,#2042,,FireWrap  Grip Kit,2,34.95  ,69.90  ,"10,039.00  "
FireWrap® Grip Kit Red,12/03/2018,Sales Receipt,#2054,,FireWrap Grip Kit,1,34.95  ,34.95  ,"10,073.95  "
FireWrap® Grip Kit Red,12/05/2018,Invoice,1215,,,6,25.00  ,150.00  ,"10,223.95  "
FireWrap® Grip Kit Red,12/11/2018,Sales Receipt,#2079,,FireWrap  Grip Kit,4,34.95  ,139.80  ,"10,363.75  "
FireWrap® Grip Kit Red,12/11/2018,Invoice,1221,,,2,26.00  ,52.00  ,"10,415.75  "
FireWrap® Grip Kit Red,12/12/2018,Sales Receipt,#2084,,FireWrap  Grip Kit,1,34.95  ,34.95  ,"10,450.70  "
FireWrap® Grip Kit Red,12/13/2018,Sales Receipt,#2088,,FireWrap  Grip Kit,2,34.95  ,69.90  ,"10,520.60  "
FireWrap® Grip Kit Red,12/14/2018,Sales Receipt,#2092,,FireWrap  Grip Kit,1,34.95  ,34.95  ,"10,555.55  "
FireWrap® Grip Kit Red,12/16/2018,Sales Receipt,#2099,,FireWrap Grip Kit,1,34.95  ,34.95  ,"10,590.50  "
FireWrap® Grip Kit Red,12/17/2018,Invoice,1226,,,1,30.00  ,30.00  ,"10,620.50  "
FireWrap® Grip Kit Red,12/19/2018,Sales Receipt,#2110,,FireWrap  Grip Kit,1,34.95  ,34.95  ,"10,655.45  "
FireWrap® Grip Kit Red,12/19/2018,Refund,#2110 (Refund 1),,FireWrap  Grip Kit,-1,34.95  ,-34.95  ,"10,620.50  "
FireWrap® Grip Kit Red,12/19/2018,Sales Receipt,#2109,,FireWrap  Grip Kit,1,34.95  ,34.95  ,"10,655.45  "
FireWrap® Grip Kit Red,12/20/2018,Sales Receipt,#2116,,FireWrap Grip Kit,1,34.95  ,34.95  ,"10,690.40  "
FireWrap® Grip Kit Red,12/22/2018,Sales Receipt,#2118,,FireWrap  Grip Kit,1,34.95  ,34.95  ,"10,725.35  "
FireWrap® Grip Kit Red,12/24/2018,Sales Receipt,#2122,,FireWrap  Grip Kit,1,34.95  ,34.95  ,"10,760.30  "
FireWrap® Grip Kit Red,12/26/2018,Sales Receipt,#2127,,FireWrap  Grip Kit,2,34.95  ,69.90  ,"10,830.20  "
FireWrap® Grip Kit Red,12/26/2018,Sales Receipt,#2126,,FireWrap  Grip Kit,1,34.95  ,34.95  ,"10,865.15  "
FireWrap® Grip Kit Red,12/28/2018,Sales Receipt,#2135,,FireWrap  Grip Kit,1,34.95  ,34.95  ,"10,900.10  "
FireWrap® Grip Kit Red,12/31/2018,Sales Receipt,#2150,,FireWrap  Grip Kit,1,34.95  ,34.95  ,"10,935.05  "
FireWrap® Grip Kit Red,01/05/2019,Sales Receipt,#2169,,FireWrap  Grip Kit,1,34.95  ,34.95  ,"10,970.00  "
FireWrap® Grip Kit Red,01/05/2019,Sales Receipt,#2168,,FireWrap  Grip Kit,1,34.95  ,34.95  ,"11,004.95  "
FireWrap® Grip Kit Red,01/06/2019,Sales Receipt,#2172,,FireWrap  Grip Kit,1,34.95  ,34.95  ,"11,039.90  "
FireWrap® Grip Kit Red,01/06/2019,Sales Receipt,#2173,,FireWrap  Grip Kit,1,34.95  ,34.95  ,"11,074.85  "
FireWrap® Grip Kit Red,01/10/2019,Invoice,1243,,,15,29.00  ,435.00  ,"11,509.85  "
FireWrap® Grip Kit Red,01/11/2019,Sales Receipt,#2189,,FireWrap  Grip Kit,1,34.95  ,34.95  ,"11,544.80  "
FireWrap® Grip Kit Red,01/12/2019,Sales Receipt,#2190,,FireWrap  Grip Kit,1,34.95  ,34.95  ,"11,579.75  "
FireWrap® Grip Kit Red,01/13/2019,Invoice,1232,,,1,30.00  ,30.00  ,"11,609.75  "
FireWrap® Grip Kit Red,01/14/2019,Sales Receipt,#2195,,FireWrap  Grip Kit,1,34.95  ,34.95  ,"11,644.70  "
FireWrap® Grip Kit Red,01/14/2019,Sales Receipt,#2199,,FireWrap  Grip Kit,1,34.95  ,34.95  ,"11,679.65  "
FireWrap® Grip Kit Red,01/15/2019,Sales Receipt,#2200,,FireWrap  Grip Kit,1,34.95  ,34.95  ,"11,714.60  "
FireWrap® Grip Kit Red,01/19/2019,Sales Receipt,#2220,,FireWrap  Grip Kit,1,34.95  ,34.95  ,"11,749.55  "
FireWrap® Grip Kit Red,01/19/2019,Sales Receipt,#2222,,FireWrap  Grip Kit,1,34.95  ,34.95  ,"11,784.50  "
FireWrap® Grip Kit Red,01/23/2019,Invoice,1256,,,1,30.00  ,30.00  ,"11,814.50  "
FireWrap® Grip Kit Red,01/23/2019,Invoice,1258,,,1,30.00  ,30.00  ,"11,844.50  "
FireWrap® Grip Kit Red,01/23/2019,Invoice,1253,,,2,30.00  ,60.00  ,"11,904.50  "
FireWrap® Grip Kit Red,01/25/2019,Sales Receipt,#2235,,FireWrap  Grip Kit,1,34.95  ,34.95  ,"11,939.45  "
FireWrap® Grip Kit Red,01/25/2019,Invoice,1248,,,6,26.00  ,156.00  ,"12,095.45  "
FireWrap® Grip Kit Red,01/26/2019,Sales Receipt,#2240,,FireWrap Grip Kit,1,34.95  ,34.95  ,"12,130.40  "
FireWrap® Grip Kit Red,01/27/2019,Sales Receipt,#2242,,FireWrap  Grip Kit,1,34.95  ,34.95  ,"12,165.35  "
FireWrap® Grip Kit Red,01/31/2019,Sales Receipt,#2255,,FireWrap  Grip Kit,2,34.95  ,69.90  ,"12,235.25  "
FireWrap® Grip Kit Red,02/01/2019,Sales Receipt,#2258,,FireWrap  Grip Kit,1,34.95  ,34.95  ,"12,270.20  "
FireWrap® Grip Kit Red,02/01/2019,Sales Receipt,#2262,,FireWrap  Grip Kit,1,34.95  ,34.95  ,"12,305.15  "
FireWrap® Grip Kit Red,02/02/2019,Invoice,1242,,P.O. Number: 19-0129-2,5,30.00  ,150.00  ,"12,455.15  "
FireWrap® Grip Kit Red,02/02/2019,Invoice,1242,,P.O. Number: 19-0103-11,2,30.00  ,60.00  ,"12,515.15  "
FireWrap® Grip Kit Red,02/02/2019,Invoice,1242,,"P.O. Number: 19-0128-4 
Corey Eaton
2040 Newborn Rd
Rutledge, GA 30663",1,30.00  ,30.00  ,"12,545.15  "
FireWrap® Grip Kit Red,02/02/2019,Invoice,1265,,,1,30.00  ,30.00  ,"12,575.15  "
FireWrap® Grip Kit Red,02/06/2019,Invoice,1268,,FireWrap Grip-Kit für Halligan-Tool - Rot,300,25.00  ,"7,500.00  ","20,075.15  "
FireWrap® Grip Kit Red,02/08/2019,Sales Receipt,#2275,,FireWrap  Grip Kit,1,34.95  ,34.95  ,"20,110.10  "
FireWrap® Grip Kit Red,02/11/2019,Invoice,1273,,,3,34.95  ,104.85  ,"20,214.95  "
FireWrap® Grip Kit Red,02/14/2019,Sales Receipt,#2291,,FireWrap Grip Kit,1,34.95  ,34.95  ,"20,249.90  "
FireWrap® Grip Kit Red,02/16/2019,Sales Receipt,#2299,,FireWrap  Grip Kit,1,34.95  ,34.95  ,"20,284.85  "
FireWrap® Grip Kit Red,02/17/2019,Sales Receipt,#2305,,FireWrap  Grip Kit,1,34.95  ,34.95  ,"20,319.80  "
FireWrap® Grip Kit Red,02/18/2019,Invoice,1277,,,1,29.00  ,29.00  ,"20,348.80  "
FireWrap® Grip Kit Red,02/18/2019,Sales Receipt,#2312,,FireWrap  Grip Kit,1,34.95  ,34.95  ,"20,383.75  "
FireWrap® Grip Kit Red,02/18/2019,Sales Receipt,#2309,,FireWrap  Grip Kit,2,34.95  ,69.90  ,"20,453.65  "
FireWrap® Grip Kit Red,02/18/2019,Invoice,1271,,,10,25.00  ,250.00  ,"20,703.65  "
FireWrap® Grip Kit Red,02/19/2019,Sales Receipt,#2315,,FireWrap  Grip Kit,2,34.95  ,69.90  ,"20,773.55  "
FireWrap® Grip Kit Red,02/20/2019,Invoice,1270,,,7,30.00  ,210.00  ,"20,983.55  "
FireWrap® Grip Kit Red,02/22/2019,Sales Receipt,#2327,,FireWrap  Grip Kit,1,34.95  ,34.95  ,"21,018.50  "
FireWrap® Grip Kit Red,02/22/2019,Sales Receipt,#2328,,FireWrap  Grip Kit,2,34.95  ,69.90  ,"21,088.40  "
FireWrap® Grip Kit Red,02/22/2019,Sales Receipt,#2326,,FireWrap Grip Kit,1,34.95  ,34.95  ,"21,123.35  "
FireWrap® Grip Kit Red,02/24/2019,Sales Receipt,#2336,,FireWrap  Grip Kit,1,34.95  ,34.95  ,"21,158.30  "
FireWrap® Grip Kit Red,02/24/2019,Refund,#2326 (Refund 1),,FireWrap Grip Kit,-1,34.95  ,-34.95  ,"21,123.35  "
FireWrap® Grip Kit Red,02/27/2019,Invoice,1280,,,4,28.00  ,112.00  ,"21,235.35  "
FireWrap® Grip Kit Red,02/28/2019,Sales Receipt,#2350,,FireWrap Grip Kit,1,34.95  ,34.95  ,"21,270.30  "
FireWrap® Grip Kit Red,02/28/2019,Sales Receipt,#2351,,FireWrap  Grip Kit,1,34.95  ,34.95  ,"21,305.25  "
FireWrap® Grip Kit Red,03/01/2019,Invoice,1289,,,7,30.00  ,210.00  ,"21,515.25  "
FireWrap® Grip Kit Red,03/04/2019,Sales Receipt,#2366,,FireWrap Grip Kit,1,34.95  ,34.95  ,"21,550.20  "
FireWrap® Grip Kit Red,03/05/2019,Sales Receipt,#2372,,FireWrap Grip Kit,1,34.95  ,34.95  ,"21,585.15  "
FireWrap® Grip Kit Red,03/05/2019,Sales Receipt,#2368,,FireWrap Grip Kit,1,34.95  ,34.95  ,"21,620.10  "
FireWrap® Grip Kit Red,03/06/2019,Sales Receipt,#2375,,FireWrap Grip Kit,1,34.95  ,34.95  ,"21,655.05  "
FireWrap® Grip Kit Red,03/08/2019,Sales Receipt,#2393,,FireWrap  Grip Kit,1,34.95  ,34.95  ,"21,690.00  "
FireWrap® Grip Kit Red,03/12/2019,Invoice,1299,,,1,29.00  ,29.00  ,"21,719.00  "
FireWrap® Grip Kit Red,03/12/2019,Invoice,1299,,,1,29.00  ,29.00  ,"21,748.00  "
FireWrap® Grip Kit Red,03/13/2019,Sales Receipt,#2409,,FireWrap  Grip Kit,2,34.95  ,69.90  ,"21,817.90  "
FireWrap® Grip Kit Red,03/15/2019,Sales Receipt,#2415,,FireWrap Grip Kit,1,34.95  ,34.95  ,"21,852.85  "
FireWrap® Grip Kit Red,03/17/2019,Sales Receipt,#2420,,FireWrap  Grip Kit,1,34.95  ,34.95  ,"21,887.80  "
FireWrap® Grip Kit Red,03/21/2019,Invoice,1313,,,2,30.00  ,60.00  ,"21,947.80  "
FireWrap® Grip Kit Red,03/25/2019,Sales Receipt,#2445,,FireWrap Grip Kit,1,34.95  ,34.95  ,"21,982.75  "
FireWrap® Grip Kit Red,03/25/2019,Sales Receipt,#2441,,FireWrap® Grip Kit,1,34.95  ,34.95  ,"22,017.70  "
FireWrap® Grip Kit Red,03/26/2019,Sales Receipt,#2450,,FireWrap® Grip Kit,1,34.95  ,34.95  ,"22,052.65  "
FireWrap® Grip Kit Red,03/29/2019,Sales Receipt,#2456,,FireWrap Grip Kit,1,34.95  ,34.95  ,"22,087.60  "
FireWrap® Grip Kit Red,04/01/2019,Invoice,1316,,,8,30.00  ,240.00  ,"22,327.60  "
FireWrap® Grip Kit Red,04/02/2019,Sales Receipt,#2476,,FireWrap Grip Kit,1,34.95  ,34.95  ,"22,362.55  "
FireWrap® Grip Kit Red,04/03/2019,Sales Receipt,#2480,,FireWrap® Grip Kit,2,34.95  ,69.90  ,"22,432.45  "
FireWrap® Grip Kit Red,04/04/2019,Sales Receipt,#2487,,FireWrap Grip Kit,1,34.95  ,34.95  ,"22,467.40  "
FireWrap® Grip Kit Red,04/09/2019,Sales Receipt,#2503,,FireWrap® Grip Kit,1,34.95  ,34.95  ,"22,502.35  "
FireWrap® Grip Kit Red,04/11/2019,Sales Receipt,#2525,,FireWrap® Grip Kit,1,34.95  ,34.95  ,"22,537.30  "
FireWrap® Grip Kit Red,04/11/2019,Sales Receipt,#2524,,FireWrap® Grip Kit,3,34.95  ,104.85  ,"22,642.15  "
FireWrap® Grip Kit Red,04/16/2019,Sales Receipt,#2591,,FireWrap® Grip Kit,1,34.95  ,34.95  ,"22,677.10  "
FireWrap® Grip Kit Red,04/16/2019,Sales Receipt,#2594,,FireWrap® Grip Kit,3,34.95  ,104.85  ,"22,781.95  "
FireWrap® Grip Kit Red,04/17/2019,Sales Receipt,#2596,,FireWrap® Grip Kit,4,34.95  ,139.80  ,"22,921.75  "
FireWrap® Grip Kit Red,04/22/2019,Sales Receipt,#2606,,FireWrap® Grip Kit,1,34.95  ,34.95  ,"22,956.70  "
FireWrap® Grip Kit Red,04/23/2019,Sales Receipt,1370,,FireWrap® Grip Kit - Red - FireWrap® Grip Kit - Red,1,34.95  ,34.95  ,"22,991.65  "
FireWrap® Grip Kit Red,05/15/2019,Invoice,1354,,,5,30.00  ,150.00  ,"23,141.65  "
FireWrap® Grip Kit Red,06/04/2019,Invoice,1364,,,1,30.00  ,30.00  ,"23,171.65  "
FireWrap® Grip Kit Red,06/05/2019,Invoice,1360,,,1,30.00  ,30.00  ,"23,201.65  "
FireWrap® Grip Kit Red,06/10/2019,Sales Receipt,#2673,,FireWrap® Grip Kit,1,34.95  ,34.95  ,"23,236.60  "
FireWrap® Grip Kit Red,06/10/2019,Sales Receipt,#2678,,FireWrap® Grip Kit,5,34.95  ,174.75  ,"23,411.35  "
FireWrap® Grip Kit Red,06/10/2019,Sales Receipt,#2674,,FireWrap® Grip Kit,1,34.95  ,34.95  ,"23,446.30  "
FireWrap® Grip Kit Red,06/14/2019,Sales Receipt,#2688,,FireWrap® Grip Kit,1,34.95  ,34.95  ,"23,481.25  "
FireWrap® Grip Kit Red,06/15/2019,Sales Receipt,#2695,,FireWrap® Grip Kit,6,34.95  ,209.70  ,"23,690.95  "
FireWrap® Grip Kit Red,06/18/2019,Sales Receipt,#2702,,FireWrap® Grip Kit,1,34.95  ,34.95  ,"23,725.90  "
FireWrap® Grip Kit Red,06/18/2019,Sales Receipt,#2701,,FireWrap Grip Kit,1,34.95  ,34.95  ,"23,760.85  "
FireWrap® Grip Kit Red,06/19/2019,Invoice,1367,,,4,30.00  ,120.00  ,"23,880.85  "
FireWrap® Grip Kit Red,06/20/2019,Sales Receipt,#2707,,FireWrap® Grip Kit,1,34.95  ,34.95  ,"23,915.80  "
FireWrap® Grip Kit Red,06/20/2019,Sales Receipt,#2708,,FireWrap Grip Kit,1,34.95  ,34.95  ,"23,950.75  "
FireWrap® Grip Kit Red,06/20/2019,Sales Receipt,#2711,,FireWrap Grip Kit,1,34.95  ,34.95  ,"23,985.70  "
FireWrap® Grip Kit Red,06/22/2019,Sales Receipt,#2714,,FireWrap® Grip Kit,1,34.95  ,34.95  ,"24,020.65  "
FireWrap® Grip Kit Red,06/23/2019,Sales Receipt,#2721,,FireWrap® Grip Kit,1,34.95  ,34.95  ,"24,055.60  "
FireWrap® Grip Kit Red,06/25/2019,Sales Receipt,#2730,,FireWrap® Grip Kit,2,34.95  ,69.90  ,"24,125.50  "
FireWrap® Grip Kit Red,06/27/2019,Sales Receipt,#2731,,FireWrap® Grip Kit,2,34.95  ,69.90  ,"24,195.40  "
FireWrap® Grip Kit Red,07/01/2019,Sales Receipt,#2742,,FireWrap® Grip Kit,1,34.95  ,34.95  ,"24,230.35  "
FireWrap® Grip Kit Red,07/02/2019,Invoice,1361,,"P.O. Number: 19-0624-1 
Sean Wilson
5150 Hampshire Dr
Shelby Township, MI 48316",2,30.00  ,60.00  ,"24,290.35  "
FireWrap® Grip Kit Red,07/02/2019,Sales Receipt,#2746,,FireWrap Grip Kit,1,34.95  ,34.95  ,"24,325.30  "
FireWrap® Grip Kit Red,07/02/2019,Invoice,1361,,P.O. Number: 19-0612-5,2,30.00  ,60.00  ,"24,385.30  "
FireWrap® Grip Kit Red,07/04/2019,Sales Receipt,#2752,,FireWrap® Grip Kit,1,34.95  ,34.95  ,"24,420.25  "
FireWrap® Grip Kit Red,07/22/2019,Sales Receipt,114-0251370-2781013,,FireWrap Grip Kit,1,34.95  ,34.95  ,"24,455.20  "
FireWrap® Grip Kit Red,08/01/2019,Invoice,1376,,P.O. Number: 19-0717-13,5,26.00  ,130.00  ,"24,585.20  "
FireWrap® Grip Kit Red,08/05/2019,Sales Receipt,113-6261017-8355414,,FireWrap Grip Kit,1,34.95  ,34.95  ,"24,620.15  "
FireWrap® Grip Kit Red,08/23/2019,Sales Receipt,111-3180087-6105866,,FireWrap Grip Kit,1,34.95  ,34.95  ,"24,655.10  "
FireWrap® Grip Kit Red,08/25/2019,Sales Receipt,111-7716534-5148257,,FireWrap Grip Kit,1,34.95  ,34.95  ,"24,690.05  "
FireWrap® Grip Kit Red,08/29/2019,Sales Receipt,113-3395879-7096214,,FireWrap Grip Kit (New),5,34.95  ,174.75  ,"24,864.80  "
FireWrap® Grip Kit Red,09/04/2019,Sales Receipt,114-4950953-7437042,,FireWrap Grip Kit (New),1,34.95  ,34.95  ,"24,899.75  "
FireWrap® Grip Kit Red,09/11/2019,Sales Receipt,112-3687167-5927452,,FireWrap Grip Kit (New),1,34.95  ,34.95  ,"24,934.70  "
FireWrap® Grip Kit Red,09/24/2019,Sales Receipt,114-8492174-5302652,,FireWrap Grip Kit (New),1,34.95  ,34.95  ,"24,969.65  "
FireWrap® Grip Kit Red,09/25/2019,Sales Receipt,114-7721678-9917028,,FireWrap Grip Kit (New),1,34.95  ,34.95  ,"25,004.60  "
FireWrap® Grip Kit Red,09/30/2019,Sales Receipt,114-5123635-5277057,,FireWrap Grip Kit (New),1,34.95  ,34.95  ,"25,039.55  "
FireWrap® Grip Kit Red,10/02/2019,Sales Receipt,113-0541501-2192253,,FireWrap Grip Kit (New),1,34.95  ,34.95  ,"25,074.50  "
FireWrap® Grip Kit Red,10/03/2019,Sales Receipt,114-2096211-2794668,,FireWrap Grip Kit,1,34.95  ,34.95  ,"25,109.45  "
FireWrap® Grip Kit Red,10/11/2019,Sales Receipt,111-7177234-9448215,,FireWrap Grip Kit (New),1,34.95  ,34.95  ,"25,144.40  "
FireWrap® Grip Kit Red,10/14/2019,Sales Receipt,112-7541325-3205844,,FireWrap Grip Kit (New),1,34.95  ,34.95  ,"25,179.35  "
FireWrap® Grip Kit Red,10/22/2019,Sales Receipt,111-4814513-0667407,,FireWrap Grip Kit (New),2,34.95  ,69.90  ,"25,249.25  "
FireWrap® Grip Kit Red,10/23/2019,Sales Receipt,111-8904163-8189046,,FireWrap Grip Kit (New),1,34.95  ,34.95  ,"25,284.20  "
FireWrap® Grip Kit Red,10/23/2019,Sales Receipt,114-5210439-1593861,,FireWrap Grip Kit (New),1,34.95  ,34.95  ,"25,319.15  "
FireWrap® Grip Kit Red,11/01/2019,Sales Receipt,112-0723101-5501022,,FireWrap Grip Kit (New),1,34.95  ,34.95  ,"25,354.10  "
FireWrap® Grip Kit Red,11/08/2019,Sales Receipt,113-5125710-4261010,,FireWrap Grip Kit - Red (New),1,34.95  ,34.95  ,"25,389.05  "
FireWrap® Grip Kit Red,11/12/2019,Sales Receipt,113-9436039-1880234,,FireWrap Grip Kit - Red (New),2,34.95  ,69.90  ,"25,458.95  "
FireWrap® Grip Kit Red,12/02/2019,Sales Receipt,113-1783065-3782606,,FireWrap Grip Kit - Red (New),1,34.95  ,34.95  ,"25,493.90  "
FireWrap® Grip Kit Red,12/11/2019,Sales Receipt,113-2272843-9045859,,FireWrap Grip Kit - Red (New),1,34.95  ,34.95  ,"25,528.85  "
FireWrap® Grip Kit Red,12/12/2019,Sales Receipt,111-6035934-5702626,,FireWrap Grip Kit - Red (New),1,34.95  ,34.95  ,"25,563.80  "
FireWrap® Grip Kit Red,12/12/2019,Sales Receipt,113-4957565-7297839,,FireWrap Grip Kit - Red (New),1,34.95  ,34.95  ,"25,598.75  "
FireWrap® Grip Kit Red,12/16/2019,Sales Receipt,111-3402454-8633058,,FireWrap Grip Kit - Red (New),1,34.95  ,34.95  ,"25,633.70  "
FireWrap® Grip Kit Red,12/21/2019,Sales Receipt,113-4121206-9313042,,FireWrap Grip Kit - Red (New),1,34.95  ,34.95  ,"25,668.65  "
FireWrap® Grip Kit Red,12/22/2019,Sales Receipt,111-2938659-1135446,,FireWrap Grip Kit - Red (New),1,34.95  ,34.95  ,"25,703.60  "
FireWrap® Grip Kit Red,12/25/2019,Sales Receipt,113-0311319-4801871,,FireWrap Grip Kit - Red (New),1,34.95  ,34.95  ,"25,738.55  "
FireWrap® Grip Kit Red,12/26/2019,Sales Receipt,111-4609279-9248229,,FireWrap Grip Kit - Red (New),1,34.95  ,34.95  ,"25,773.50  "
FireWrap® Grip Kit Red,12/28/2019,Sales Receipt,113-4003601-6594626,,FireWrap Grip Kit - Red (New),1,34.95  ,34.95  ,"25,808.45  "
FireWrap® Grip Kit Red,12/29/2019,Sales Receipt,114-1681883-7042665,,FireWrap Grip Kit - Red (New),1,34.95  ,34.95  ,"25,843.40  "
FireWrap® Grip Kit Red,01/01/2020,Sales Receipt,111-1448692-4022660,,FireWrap Grip Kit - Red (New),1,34.95  ,34.95  ,"25,878.35  "
FireWrap® Grip Kit Red,01/05/2020,Sales Receipt,111-9696527-7721840,,FireWrap Grip Kit - Red (New),1,24.95  ,24.95  ,"25,903.30  "
FireWrap® Grip Kit Red,01/06/2020,Sales Receipt,114-7163910-0698653,,FireWrap Grip Kit - Red (New),1,24.95  ,24.95  ,"25,928.25  "
FireWrap® Grip Kit Red,01/08/2020,Sales Receipt,112-6716299-6920209,,FireWrap Grip Kit - Red (New),1,24.95  ,24.95  ,"25,953.20  "
FireWrap® Grip Kit Red,01/12/2020,Sales Receipt,111-6241656-4147426,,FireWrap Grip Kit - Red (New),1,24.95  ,24.95  ,"25,978.15  "
FireWrap® Grip Kit Red,01/13/2020,Sales Receipt,114-0031748-1313805,,FireWrap Grip Kit - Red (New),1,24.95  ,24.95  ,"26,003.10  "
FireWrap® Grip Kit Red,01/13/2020,Sales Receipt,113-8227500-0945830,,FireWrap Grip Kit - Red (New),1,24.95  ,24.95  ,"26,028.05  "
FireWrap® Grip Kit Red,01/16/2020,Sales Receipt,114-6650998-8488200,,FireWrap Grip Kit - Red (New),1,24.95  ,24.95  ,"26,053.00  "
FireWrap® Grip Kit Red,01/17/2020,Sales Receipt,111-2471646-8342647,,FireWrap Grip Kit - Red (New),1,24.95  ,24.95  ,"26,077.95  "
FireWrap® Grip Kit Red,02/06/2020,Sales Receipt,112-4182489-0970645,,FireWrap Grip Kit - Red (New),2,24.95  ,49.90  ,"26,127.85  "
FireWrap® Grip Kit Red,02/09/2020,Sales Receipt,112-0182939-5040217,,FireWrap Grip Kit - Red (New),1,24.95  ,24.95  ,"26,152.80  "
FireWrap® Grip Kit Red,02/09/2020,Sales Receipt,113-6342055-6845816,,FireWrap Grip Kit - Red (New),1,24.95  ,24.95  ,"26,177.75  "
FireWrap® Grip Kit Red,02/09/2020,Sales Receipt,114-6223851-5476205,,FireWrap Grip Kit - Red (New),1,24.95  ,24.95  ,"26,202.70  "
FireWrap® Grip Kit Red,02/10/2020,Sales Receipt,113-0194980-9275446,,FireWrap Grip Kit - Red (New),1,24.95  ,24.95  ,"26,227.65  "
FireWrap® Grip Kit Red,02/10/2020,Sales Receipt,114-4970473-3696238,,FireWrap Grip Kit - Red (New),1,24.95  ,24.95  ,"26,252.60  "
FireWrap® Grip Kit Red,02/20/2020,Sales Receipt,111-0902740-3409012,,FireWrap Grip Kit - Red (New),1,24.95  ,24.95  ,"26,277.55  "
FireWrap® Grip Kit Red,03/13/2020,Sales Receipt,112-2437374-3127420,,FireWrap Grip Kit - Red (New),1,24.95  ,24.95  ,"26,302.50  "
FireWrap® Grip Kit Red,03/16/2020,Sales Receipt,111-8678465-8023465,,FireWrap Grip Kit - Red (New),1,24.95  ,24.95  ,"26,327.45  "
FireWrap® Grip Kit Red,03/18/2020,Sales Receipt,113-6895607-4745807,,FireWrap Grip Kit - Red (New),2,24.95  ,49.90  ,"26,377.35  "
FireWrap® Grip Kit Red,04/04/2020,Sales Receipt,113-5062902-4252213,,FireWrap Grip Kit - Red (New),1,24.95  ,24.95  ,"26,402.30  "
FireWrap® Grip Kit Red,04/04/2020,Sales Receipt,3610,,FireWrap® Grip Kit - Red,1,24.95  ,24.95  ,"26,427.25  "
FireWrap® Grip Kit Red,04/11/2020,Sales Receipt,3626,,FireWrap® Grip Kit - Red,1,24.95  ,24.95  ,"26,452.20  "
FireWrap® Grip Kit Red,04/13/2020,Sales Receipt,3632,,FireWrap® Grip Kit - Red,1,24.95  ,24.95  ,"26,477.15  "
FireWrap® Grip Kit Red,04/14/2020,Sales Receipt,113-0038066-5729842,,FireWrap Grip Kit - Red (New),1,24.95  ,24.95  ,"26,502.10  "
FireWrap® Grip Kit Red,04/14/2020,Sales Receipt,112-2184798-7676245,,FireWrap Grip Kit - Red (New),1,24.95  ,24.95  ,"26,527.05  "
FireWrap® Grip Kit Red,04/15/2020,Sales Receipt,3640,,FireWrap® Grip Kit - Red,1,24.95  ,24.95  ,"26,552.00  "
FireWrap® Grip Kit Red,04/16/2020,Sales Receipt,3648,,FireWrap® Grip Kit - Red,1,24.95  ,24.95  ,"26,576.95  "
FireWrap® Grip Kit Red,04/16/2020,Sales Receipt,3646,,FireWrap® Grip Kit - Red,1,24.95  ,24.95  ,"26,601.90  "
FireWrap® Grip Kit Red,04/16/2020,Sales Receipt,3645,,FireWrap® Grip Kit - Red,1,24.95  ,24.95  ,"26,626.85  "
FireWrap® Grip Kit Red,04/17/2020,Sales Receipt,111-2542062-6360222,,FireWrap Grip Kit - Red (New),1,24.95  ,24.95  ,"26,651.80  "
FireWrap® Grip Kit Red,04/17/2020,Sales Receipt,3650,,FireWrap® Grip Kit - Red,1,24.95  ,24.95  ,"26,676.75  "
FireWrap® Grip Kit Red,04/19/2020,Sales Receipt,114-0079334-8495472,,FireWrap Grip Kit - Red (New),1,24.95  ,24.95  ,"26,701.70  "
FireWrap® Grip Kit Red,04/20/2020,Sales Receipt,3667,,FireWrap® Grip Kit - Red,1,24.95  ,24.95  ,"26,726.65  "
FireWrap® Grip Kit Red,04/20/2020,Sales Receipt,3672,,FireWrap® Grip Kit - Red,1,24.95  ,24.95  ,"26,751.60  "
FireWrap® Grip Kit Red,04/21/2020,Sales Receipt,112-7271937-4523417,,FireWrap Grip Kit - Red (New),1,24.95  ,24.95  ,"26,776.55  "
FireWrap® Grip Kit Red,04/22/2020,Sales Receipt,112-8004911-6601815,,FireWrap Grip Kit - Red (New),1,24.95  ,24.95  ,"26,801.50  "
FireWrap® Grip Kit Red,04/25/2020,Sales Receipt,111-8372010-8929831,,FireWrap Grip Kit - Red (New),1,24.95  ,24.95  ,"26,826.45  "
FireWrap® Grip Kit Red,04/26/2020,Sales Receipt,113-1654285-0971461,,FireWrap Grip Kit - Red (New),1,24.95  ,24.95  ,"26,851.40  "
FireWrap® Grip Kit Red,04/27/2020,Sales Receipt,113-6017635-9331453,,FireWrap Grip Kit - Red (New),1,24.95  ,24.95  ,"26,876.35  "
FireWrap® Grip Kit Red,04/28/2020,Sales Receipt,3700,,FireWrap® Grip Kit - Red,1,24.95  ,24.95  ,"26,901.30  "
FireWrap® Grip Kit Red,04/28/2020,Sales Receipt,3702,,FireWrap® Grip Kit - Red,10,24.95  ,249.50  ,"27,150.80  "
FireWrap® Grip Kit Red,04/29/2020,Sales Receipt,111-6188571-1210653,,FireWrap Grip Kit - Red (New),1,24.95  ,24.95  ,"27,175.75  "
FireWrap® Grip Kit Red,04/29/2020,Sales Receipt,3705,,FireWrap® Grip Kit - Red,2,24.95  ,49.90  ,"27,225.65  "
FireWrap® Grip Kit Red,04/29/2020,Sales Receipt,3706,,FireWrap® Grip Kit - Red,1,24.95  ,24.95  ,"27,250.60  "
FireWrap® Grip Kit Red,04/30/2020,Sales Receipt,112-5404980-6048218,,FireWrap Grip Kit - Red (New),4,24.95  ,99.80  ,"27,350.40  "
FireWrap® Grip Kit Red,05/02/2020,Sales Receipt,3719,,FireWrap® Grip Kit - Red,1,24.95  ,24.95  ,"27,375.35  "
FireWrap® Grip Kit Red,05/04/2020,Sales Receipt,112-0674845-6599449,,FireWrap Grip Kit - Red (New),2,24.95  ,49.90  ,"27,425.25  "
FireWrap® Grip Kit Red,05/07/2020,Sales Receipt,3737,,FireWrap® Grip Kit - Red,1,24.95  ,24.95  ,"27,450.20  "
FireWrap® Grip Kit Red,05/07/2020,Sales Receipt,3740,,FireWrap® Grip Kit - Red,2,24.95  ,49.90  ,"27,500.10  "
FireWrap® Grip Kit Red,05/07/2020,Sales Receipt,3733,,FireWrap® Grip Kit - Red,1,24.95  ,24.95  ,"27,525.05  "
FireWrap® Grip Kit Red,05/08/2020,Sales Receipt,3742,,FireWrap® Grip Kit - Red,1,24.95  ,24.95  ,"27,550.00  "
FireWrap® Grip Kit Red,05/12/2020,Sales Receipt,3755,,FireWrap® Grip Kit - Red,3,24.95  ,74.85  ,"27,624.85  "
FireWrap® Grip Kit Red,05/13/2020,Sales Receipt,3758,,FireWrap® Grip Kit - Red,1,24.95  ,24.95  ,"27,649.80  "
FireWrap® Grip Kit Red,06/01/2020,Sales Receipt,3817,,FireWrap® Grip Kit - Red,2,24.95  ,49.90  ,"27,699.70  "
FireWrap® Grip Kit Red,06/04/2020,Sales Receipt,3823,,FireWrap® Grip Kit - Red,6,24.95  ,149.70  ,"27,849.40  "
FireWrap® Grip Kit Red,06/06/2020,Sales Receipt,3828,,FireWrap® Grip Kit - Red,1,24.95  ,24.95  ,"27,874.35  "
FireWrap® Grip Kit Red,06/08/2020,Sales Receipt,3833,,FireWrap® Grip Kit - Red,3,24.95  ,74.85  ,"27,949.20  "
FireWrap® Grip Kit Red,06/09/2020,Sales Receipt,3836,,FireWrap® Grip Kit - Red,1,24.95  ,24.95  ,"27,974.15  "
FireWrap® Grip Kit Red,06/10/2020,Sales Receipt,3844,,FireWrap® Grip Kit - Red,1,24.95  ,24.95  ,"27,999.10  "
FireWrap® Grip Kit Red,06/10/2020,Sales Receipt,3843,,FireWrap® Grip Kit - Red,1,24.95  ,24.95  ,"28,024.05  "
FireWrap® Grip Kit Red,06/11/2020,Sales Receipt,3845,,FireWrap® Grip Kit - Red,7,24.95  ,174.65  ,"28,198.70  "
FireWrap® Grip Kit Red,06/11/2020,Sales Receipt,3846,,FireWrap® Grip Kit - Red,1,24.95  ,24.95  ,"28,223.65  "
FireWrap® Grip Kit Red,06/11/2020,Sales Receipt,3849,,FireWrap® Grip Kit - Red,1,24.95  ,24.95  ,"28,248.60  "
FireWrap® Grip Kit Red,06/12/2020,Sales Receipt,3853,,FireWrap® Grip Kit - Red,1,24.95  ,24.95  ,"28,273.55  "
FireWrap® Grip Kit Red,06/17/2020,Sales Receipt,3872,,FireWrap® Grip Kit - Red,2,24.95  ,49.90  ,"28,323.45  "
FireWrap® Grip Kit Red,06/23/2020,Sales Receipt,3943,,FireWrap® Grip Kit - Red,1,24.95  ,24.95  ,"28,348.40  "
FireWrap® Grip Kit Red,06/25/2020,Sales Receipt,3950,,FireWrap® Grip Kit - Red,4,24.95  ,99.80  ,"28,448.20  "
FireWrap® Grip Kit Red,06/28/2020,Sales Receipt,3967,,FireWrap® Grip Kit - Red,1,24.95  ,24.95  ,"28,473.15  "
FireWrap® Grip Kit Red,06/29/2020,Sales Receipt,3973,,FireWrap® Grip Kit - Red,6,24.95  ,149.70  ,"28,622.85  "
FireWrap® Grip Kit Red,06/30/2020,Sales Receipt,3978,,FireWrap® Grip Kit - Red,1,24.95  ,24.95  ,"28,647.80  "
FireWrap® Grip Kit Red,07/06/2020,Sales Receipt,3994,,FireWrap® Grip Kit - Red,10,24.95  ,249.50  ,"28,897.30  "
FireWrap® Grip Kit Red,07/11/2020,Sales Receipt,4013,,FireWrap® Grip Kit - Red,1,24.95  ,24.95  ,"28,922.25  "
FireWrap® Grip Kit Red,07/13/2020,Sales Receipt,4015,,FireWrap® Grip Kit - Red,1,24.95  ,24.95  ,"28,947.20  "
FireWrap® Grip Kit Red,07/13/2020,Sales Receipt,4018,,FireWrap® Grip Kit - Red,1,24.95  ,24.95  ,"28,972.15  "
FireWrap® Grip Kit Red,07/24/2020,Sales Receipt,4050,,FireWrap® Grip Kit - Red,1,24.95  ,24.95  ,"28,997.10  "
FireWrap® Grip Kit Red,07/30/2020,Sales Receipt,4067,,FireWrap® Grip Kit - Red,2,24.95  ,49.90  ,"29,047.00  "
FireWrap® Grip Kit Red,07/30/2020,Sales Receipt,4066,,FireWrap® Grip Kit - Red,1,24.95  ,24.95  ,"29,071.95  "
FireWrap® Grip Kit Red,08/06/2020,Sales Receipt,4081,,FireWrap® Grip Kit - Red,1,24.95  ,24.95  ,"29,096.90  "
FireWrap® Grip Kit Red,08/10/2020,Sales Receipt,4095,,FireWrap® Grip Kit - Red,1,24.95  ,24.95  ,"29,121.85  "
FireWrap® Grip Kit Red,08/13/2020,Sales Receipt,4102,,FireWrap® Grip Kit - Red,1,24.95  ,24.95  ,"29,146.80  "
FireWrap® Grip Kit Red,08/17/2020,Sales Receipt,4115,,FireWrap® Grip Kit - Red,2,24.95  ,49.90  ,"29,196.70  "
FireWrap® Grip Kit Red,08/18/2020,Sales Receipt,4120,,FireWrap® Grip Kit - Red,1,24.95  ,24.95  ,"29,221.65  "
FireWrap® Grip Kit Red,08/19/2020,Sales Receipt,4124,,FireWrap® Grip Kit - Red,2,24.95  ,49.90  ,"29,271.55  "
FireWrap® Grip Kit Red,08/20/2020,Sales Receipt,4128,,FireWrap® Grip Kit - Red,3,24.95  ,74.85  ,"29,346.40  "
FireWrap® Grip Kit Red,08/21/2020,Sales Receipt,4136,,FireWrap® Grip Kit - Red,1,24.95  ,24.95  ,"29,371.35  "
FireWrap® Grip Kit Red,08/22/2020,Sales Receipt,4139,,FireWrap® Grip Kit - Red,1,24.95  ,24.95  ,"29,396.30  "
FireWrap® Grip Kit Red,08/23/2020,Sales Receipt,4144,,FireWrap® Grip Kit - Red,1,24.95  ,24.95  ,"29,421.25  "
FireWrap® Grip Kit Red,08/24/2020,Sales Receipt,4147,,FireWrap® Grip Kit - Red,1,24.95  ,24.95  ,"29,446.20  "
FireWrap® Grip Kit Red,08/28/2020,Sales Receipt,4162,,FireWrap® Grip Kit - Red,1,24.95  ,24.95  ,"29,471.15  "
FireWrap® Grip Kit Red,09/01/2020,Sales Receipt,4174,,FireWrap® Grip Kit - Red,1,24.95  ,24.95  ,"29,496.10  "
FireWrap® Grip Kit Red,09/05/2020,Sales Receipt,4195,,FireWrap® Grip Kit - Red,1,24.95  ,24.95  ,"29,521.05  "
FireWrap® Grip Kit Red,09/07/2020,Sales Receipt,4199,,FireWrap® Grip Kit - Red,1,24.95  ,24.95  ,"29,546.00  "
FireWrap® Grip Kit Red,09/11/2020,Sales Receipt,4204,,FireWrap® Grip Kit - Red,1,24.95  ,24.95  ,"29,570.95  "
FireWrap® Grip Kit Red,09/12/2020,Sales Receipt,4209,,FireWrap® Grip Kit - Red,1,24.95  ,24.95  ,"29,595.90  "
FireWrap® Grip Kit Red,09/15/2020,Sales Receipt,4216,,FireWrap® Grip Kit - Red,1,24.95  ,24.95  ,"29,620.85  "
FireWrap® Grip Kit Red,09/16/2020,Sales Receipt,4220,,FireWrap® Grip Kit - Red,1,24.95  ,24.95  ,"29,645.80  "
FireWrap® Grip Kit Red,09/21/2020,Sales Receipt,4250,,FireWrap® Grip Kit - Red,1,24.95  ,24.95  ,"29,670.75  "
FireWrap® Grip Kit Red,09/21/2020,Sales Receipt,4247,,FireWrap® Grip Kit - Red,4,24.95  ,99.80  ,"29,770.55  "
FireWrap® Grip Kit Red,09/22/2020,Sales Receipt,4255,,FireWrap® Grip Kit - Red,2,24.95  ,49.90  ,"29,820.45  "
FireWrap® Grip Kit Red,09/24/2020,Sales Receipt,4269,,FireWrap® Grip Kit - Red,1,24.95  ,24.95  ,"29,845.40  "
FireWrap® Grip Kit Red,09/24/2020,Sales Receipt,4271,,FireWrap® Grip Kit - Red,1,24.95  ,24.95  ,"29,870.35  "
FireWrap® Grip Kit Red,09/30/2020,Sales Receipt,4282,,FireWrap® Grip Kit - Red,3,24.95  ,74.85  ,"29,945.20  "
FireWrap® Grip Kit Red,10/02/2020,Sales Receipt,4291,,FireWrap® Grip Kit - Red,1,24.95  ,24.95  ,"29,970.15  "
FireWrap® Grip Kit Red,10/03/2020,Sales Receipt,4295,,FireWrap® Grip Kit - Red,5,24.95  ,124.75  ,"30,094.90  "
FireWrap® Grip Kit Red,10/06/2020,Sales Receipt,4309,,FireWrap® Grip Kit - Red,3,24.95  ,74.85  ,"30,169.75  "
FireWrap® Grip Kit Red,10/06/2020,Sales Receipt,4312,,FireWrap® Grip Kit - Red,1,24.95  ,24.95  ,"30,194.70  "
FireWrap® Grip Kit Red,10/07/2020,Sales Receipt,4319,,FireWrap® Grip Kit - Red,2,24.95  ,49.90  ,"30,244.60  "
FireWrap® Grip Kit Red,10/08/2020,Sales Receipt,4322,,FireWrap® Grip Kit - Red,1,24.95  ,24.95  ,"30,269.55  "
FireWrap® Grip Kit Red,10/09/2020,Sales Receipt,4332,,FireWrap® Grip Kit - Red,1,24.95  ,24.95  ,"30,294.50  "
FireWrap® Grip Kit Red,10/09/2020,Sales Receipt,4330,,FireWrap® Grip Kit - Red,1,24.95  ,24.95  ,"30,319.45  "
FireWrap® Grip Kit Red,10/13/2020,Sales Receipt,4347,,FireWrap® Grip Kit - Red,1,24.95  ,24.95  ,"30,344.40  "
FireWrap® Grip Kit Red,10/16/2020,Sales Receipt,4358,,FireWrap® Grip Kit - Red,1,24.95  ,24.95  ,"30,369.35  "
FireWrap® Grip Kit Red,10/19/2020,Sales Receipt,4373,,FireWrap® Grip Kit - Red,1,24.95  ,24.95  ,"30,394.30  "
FireWrap® Grip Kit Red,10/21/2020,Sales Receipt,4387,,FireWrap® Grip Kit - Red,2,24.95  ,49.90  ,"30,444.20  "
FireWrap® Grip Kit Red,10/21/2020,Sales Receipt,4384,,FireWrap® Grip Kit - Red,2,24.95  ,49.90  ,"30,494.10  "
FireWrap® Grip Kit Red,10/21/2020,Sales Receipt,4386,,FireWrap® Grip Kit - Red,1,24.95  ,24.95  ,"30,519.05  "
FireWrap® Grip Kit Red,10/21/2020,Sales Receipt,4390,,FireWrap® Grip Kit - Red,1,24.95  ,24.95  ,"30,544.00  "
FireWrap® Grip Kit Red,10/24/2020,Sales Receipt,4403,,FireWrap® Grip Kit - Red,1,24.95  ,24.95  ,"30,568.95  "
FireWrap® Grip Kit Red,10/26/2020,Sales Receipt,4412,,FireWrap® Grip Kit - Red,2,24.95  ,49.90  ,"30,618.85  "
FireWrap® Grip Kit Red,10/27/2020,Sales Receipt,4424,,FireWrap® Grip Kit - Red,1,24.95  ,24.95  ,"30,643.80  "
FireWrap® Grip Kit Red,10/27/2020,Sales Receipt,4421,,FireWrap® Grip Kit - Red,1,24.95  ,24.95  ,"30,668.75  "
FireWrap® Grip Kit Red,10/27/2020,Sales Receipt,4426,,FireWrap® Grip Kit - Red,1,24.95  ,24.95  ,"30,693.70  "
FireWrap® Grip Kit Red,10/29/2020,Sales Receipt,4434,,FireWrap® Grip Kit - Red,1,24.95  ,24.95  ,"30,718.65  "
FireWrap® Grip Kit Red,10/29/2020,Sales Receipt,4431,,FireWrap® Grip Kit - Red,2,24.95  ,49.90  ,"30,768.55  "
FireWrap® Grip Kit Red,10/29/2020,Sales Receipt,4433,,FireWrap® Grip Kit - Red,2,24.95  ,49.90  ,"30,818.45  "
FireWrap® Grip Kit Red,10/31/2020,Sales Receipt,4446,,FireWrap® Grip Kit - Red,1,24.95  ,24.95  ,"30,843.40  "
FireWrap® Grip Kit Red,11/02/2020,Sales Receipt,4454,,FireWrap® Grip Kit - Red,1,24.95  ,24.95  ,"30,868.35  "
FireWrap® Grip Kit Red,11/02/2020,Sales Receipt,4453,,FireWrap® Grip Kit - Red,4,24.95  ,99.80  ,"30,968.15  "
FireWrap® Grip Kit Red,11/04/2020,Sales Receipt,4462,,FireWrap® Grip Kit - Red,1,24.95  ,24.95  ,"30,993.10  "
FireWrap® Grip Kit Red,11/06/2020,Sales Receipt,4469,,FireWrap® Grip Kit - Red,2,24.95  ,49.90  ,"31,043.00  "
FireWrap® Grip Kit Red,11/10/2020,Sales Receipt,4483,,FireWrap® Grip Kit - Red,1,24.95  ,24.95  ,"31,067.95  "
FireWrap® Grip Kit Red,11/12/2020,Sales Receipt,4495,,FireWrap® Grip Kit - Red,1,24.95  ,24.95  ,"31,092.90  "
FireWrap® Grip Kit Red,11/13/2020,Sales Receipt,4506,,FireWrap® Grip Kit - Red,1,24.95  ,24.95  ,"31,117.85  "
FireWrap® Grip Kit Red,11/13/2020,Sales Receipt,4503,,FireWrap® Grip Kit - Red,1,24.95  ,24.95  ,"31,142.80  "
FireWrap® Grip Kit Red,11/17/2020,Sales Receipt,4522,,FireWrap® Grip Kit - Red,1,24.95  ,24.95  ,"31,167.75  "
FireWrap® Grip Kit Red,11/17/2020,Sales Receipt,4519,,FireWrap® Grip Kit - Red,4,24.95  ,99.80  ,"31,267.55  "
FireWrap® Grip Kit Red,11/25/2020,Sales Receipt,4554,,FireWrap® Grip Kit - Red,1,24.95  ,24.95  ,"31,292.50  "
FireWrap® Grip Kit Red,11/25/2020,Sales Receipt,4555,,FireWrap® Grip Kit - Red,1,24.95  ,24.95  ,"31,317.45  "
FireWrap® Grip Kit Red,11/26/2020,Sales Receipt,4566,,FireWrap® Grip Kit - Red,1,24.95  ,24.95  ,"31,342.40  "
FireWrap® Grip Kit Red,11/26/2020,Sales Receipt,4568,,FireWrap® Grip Kit - Red,1,24.95  ,24.95  ,"31,367.35  "
FireWrap® Grip Kit Red,11/27/2020,Sales Receipt,4570,,FireWrap® Grip Kit - Red,1,24.95  ,24.95  ,"31,392.30  "
FireWrap® Grip Kit Red,11/28/2020,Sales Receipt,4585,,FireWrap® Grip Kit - Red,1,24.95  ,24.95  ,"31,417.25  "
FireWrap® Grip Kit Red,11/29/2020,Sales Receipt,4594,,FireWrap® Grip Kit - Red,1,24.95  ,24.95  ,"31,442.20  "
FireWrap® Grip Kit Red,11/30/2020,Sales Receipt,4599,,FireWrap® Grip Kit - Red,1,24.95  ,24.95  ,"31,467.15  "
FireWrap® Grip Kit Red,11/30/2020,Sales Receipt,4608,,FireWrap® Grip Kit - Red,1,24.95  ,24.95  ,"31,492.10  "
FireWrap® Grip Kit Red,11/30/2020,Sales Receipt,4601,,FireWrap® Grip Kit - Red,1,24.95  ,24.95  ,"31,517.05  "
FireWrap® Grip Kit Red,12/05/2020,Sales Receipt,4630,,FireWrap® Grip Kit - Red,1,24.95  ,24.95  ,"31,542.00  "
FireWrap® Grip Kit Red,12/06/2020,Sales Receipt,4633,,FireWrap® Grip Kit - Red,1,24.95  ,24.95  ,"31,566.95  "
FireWrap® Grip Kit Red,12/07/2020,Sales Receipt,4637,,FireWrap® Grip Kit - Red,1,24.95  ,24.95  ,"31,591.90  "
FireWrap® Grip Kit Red,12/07/2020,Sales Receipt,4638,,FireWrap® Grip Kit - Red,1,24.95  ,24.95  ,"31,616.85  "
FireWrap® Grip Kit Red,12/07/2020,Sales Receipt,4645,,FireWrap® Grip Kit - Red,1,24.95  ,24.95  ,"31,641.80  "
FireWrap® Grip Kit Red,12/09/2020,Sales Receipt,4650,,FireWrap® Grip Kit - Red,1,24.95  ,24.95  ,"31,666.75  "
FireWrap® Grip Kit Red,12/10/2020,Sales Receipt,4660,,FireWrap® Grip Kit - Red,5,24.95  ,124.75  ,"31,791.50  "
FireWrap® Grip Kit Red,12/10/2020,Sales Receipt,4662,,FireWrap® Grip Kit - Red,1,24.95  ,24.95  ,"31,816.45  "
FireWrap® Grip Kit Red,12/11/2020,Sales Receipt,4666,,FireWrap® Grip Kit - Red,1,24.95  ,24.95  ,"31,841.40  "
FireWrap® Grip Kit Red,12/13/2020,Sales Receipt,4678,,FireWrap® Grip Kit - Red,1,24.95  ,24.95  ,"31,866.35  "
FireWrap® Grip Kit Red,12/14/2020,Sales Receipt,4679,,FireWrap® Grip Kit - Red,2,24.95  ,49.90  ,"31,916.25  "
FireWrap® Grip Kit Red,12/15/2020,Sales Receipt,4682,,FireWrap® Grip Kit - Red,4,24.95  ,99.80  ,"32,016.05  "
FireWrap® Grip Kit Red,12/16/2020,Sales Receipt,4688,,FireWrap® Grip Kit - Red,1,24.95  ,24.95  ,"32,041.00  "
FireWrap® Grip Kit Red,12/18/2020,Invoice,M-121820-005,,FireWrap® Grip Kit Red,4,18.75  ,75.00  ,"32,116.00  "
FireWrap® Grip Kit Red,12/18/2020,Sales Receipt,4697,,FireWrap® Grip Kit - Red,1,24.95  ,24.95  ,"32,140.95  "
FireWrap® Grip Kit Red,12/19/2020,Sales Receipt,4700,,FireWrap® Grip Kit - Red,1,24.95  ,24.95  ,"32,165.90  "
FireWrap® Grip Kit Red,12/20/2020,Sales Receipt,4708,,FireWrap® Grip Kit - Red,1,24.95  ,24.95  ,"32,190.85  "
FireWrap® Grip Kit Red,12/20/2020,Sales Receipt,4707,,FireWrap® Grip Kit - Red,1,24.95  ,24.95  ,"32,215.80  "
FireWrap® Grip Kit Red,12/23/2020,Sales Receipt,4724,,FireWrap® Grip Kit - Red,2,24.95  ,49.90  ,"32,265.70  "
FireWrap® Grip Kit Red,12/25/2020,Sales Receipt,4734,,FireWrap® Grip Kit - Red,2,24.95  ,49.90  ,"32,315.60  "
FireWrap® Grip Kit Red,12/27/2020,Sales Receipt,4746,,FireWrap® Grip Kit - Red,1,24.95  ,24.95  ,"32,340.55  "
FireWrap® Grip Kit Red,12/28/2020,Sales Receipt,4753,,FireWrap® Grip Kit - Red,1,24.95  ,24.95  ,"32,365.50  "
FireWrap® Grip Kit Red,12/29/2020,Invoice,M-122920-003,,FireWrap® Grip Kit Red,8,24.95  ,199.60  ,"32,565.10  "
FireWrap® Grip Kit Red,12/29/2020,Sales Receipt,4758,,FireWrap® Grip Kit - Red,1,24.95  ,24.95  ,"32,590.05  "
FireWrap® Grip Kit Red,01/01/2021,Sales Receipt,4775,,FireWrap® Grip Kit - Red,1,24.95  ,24.95  ,"32,615.00  "
FireWrap® Grip Kit Red,01/08/2021,Sales Receipt,4808,,FireWrap® Grip Kit - Red,1,24.95  ,24.95  ,"32,639.95  "
FireWrap® Grip Kit Red,01/08/2021,Sales Receipt,4813,,FireWrap® Grip Kit - Red,1,24.95  ,24.95  ,"32,664.90  "
FireWrap® Grip Kit Red,01/08/2021,Sales Receipt,4803,,FireWrap® Grip Kit - Red,3,24.95  ,74.85  ,"32,739.75  "
FireWrap® Grip Kit Red,01/09/2021,Sales Receipt,4814,,FireWrap® Grip Kit - Red,1,24.95  ,24.95  ,"32,764.70  "
FireWrap® Grip Kit Red,01/10/2021,Sales Receipt,4820,,FireWrap® Grip Kit - Red,1,24.95  ,24.95  ,"32,789.65  "
FireWrap® Grip Kit Red,01/13/2021,Sales Receipt,4833,,FireWrap® Grip Kit - Red,1,24.95  ,24.95  ,"32,814.60  "
FireWrap® Grip Kit Red,01/13/2021,Sales Receipt,4834,,FireWrap® Grip Kit - Red,1,24.95  ,24.95  ,"32,839.55  "
FireWrap® Grip Kit Red,01/15/2021,Sales Receipt,4849,,FireWrap® Grip Kit - Red,1,24.95  ,24.95  ,"32,864.50  "
FireWrap® Grip Kit Red,01/15/2021,Sales Receipt,4848,,FireWrap® Grip Kit - Red,3,24.95  ,74.85  ,"32,939.35  "
FireWrap® Grip Kit Red,01/16/2021,Sales Receipt,4857,,FireWrap® Grip Kit - Red,2,24.95  ,49.90  ,"32,989.25  "
FireWrap® Grip Kit Red,01/17/2021,Sales Receipt,4864,,FireWrap® Grip Kit - Red,1,24.95  ,24.95  ,"33,014.20  "
FireWrap® Grip Kit Red,01/17/2021,Sales Receipt,4862,,FireWrap® Grip Kit - Red,7,24.95  ,174.65  ,"33,188.85  "
FireWrap® Grip Kit Red,01/19/2021,Invoice,M-122920-002,,FireWrap® Grip Kit Red,0,,0.00  ,"33,188.85  "
FireWrap® Grip Kit Red,01/19/2021,Invoice,M-011921-014,,FireWrap® Grip Kit Red,1,18.75  ,18.75  ,"33,207.60  "
FireWrap® Grip Kit Red,01/19/2021,Invoice,M-011921-010,,FireWrap® Grip Kit Red,2,18.75  ,37.50  ,"33,245.10  "
FireWrap® Grip Kit Red,01/19/2021,Invoice,M-011921-020,,FireWrap® Grip Kit Red,1,18.75  ,18.75  ,"33,263.85  "
FireWrap® Grip Kit Red,01/19/2021,Invoice,M-011921-023,,FireWrap® Grip Kit Red,4,24.95  ,99.80  ,"33,363.65  "
FireWrap® Grip Kit Red,01/19/2021,Invoice,M-011921-005,,FireWrap® Grip Kit Red,6,18.75  ,112.50  ,"33,476.15  "
FireWrap® Grip Kit Red,01/19/2021,Invoice,M-011921-019,,FireWrap® Grip Kit Red,1,18.75  ,18.75  ,"33,494.90  "
FireWrap® Grip Kit Red,01/19/2021,Invoice,M-011921-007,,FireWrap® Grip Kit Red,3,18.75  ,56.25  ,"33,551.15  "
FireWrap® Grip Kit Red,01/20/2021,Sales Receipt,4875,,FireWrap® Grip Kit - Red,1,24.95  ,24.95  ,"33,576.10  "
FireWrap® Grip Kit Red,01/20/2021,Sales Receipt,4876,,FireWrap® Grip Kit - Red,3,24.95  ,74.85  ,"33,650.95  "
FireWrap® Grip Kit Red,01/20/2021,Sales Receipt,4870,,FireWrap® Grip Kit - Red,1,24.95  ,24.95  ,"33,675.90  "
FireWrap® Grip Kit Red,01/21/2021,Invoice,M-012121-002,,FireWrap® Grip Kit Red,1,18.75  ,18.75  ,"33,694.65  "
FireWrap® Grip Kit Red,01/26/2021,Invoice,M-012621-003,,FireWrap® Grip Kit Red,1,18.75  ,18.75  ,"33,713.40  "
FireWrap® Grip Kit Red,01/26/2021,Invoice,M-012621-005,,FireWrap® Grip Kit Red,1,18.75  ,18.75  ,"33,732.15  "
FireWrap® Grip Kit Red,01/26/2021,Invoice,M-012621-010,,FireWrap® Grip Kit Red,4,18.75  ,75.00  ,"33,807.15  "
FireWrap® Grip Kit Red,01/26/2021,Sales Receipt,4894,,FireWrap® Grip Kit - Red,6,24.95  ,149.70  ,"33,956.85  "
FireWrap® Grip Kit Red,01/30/2021,Sales Receipt,4900,,FireWrap® Grip Kit - Red,1,24.95  ,24.95  ,"33,981.80  "
FireWrap® Grip Kit Red,01/31/2021,Sales Receipt,4907,,FireWrap® Grip Kit - Red,1,24.95  ,24.95  ,"34,006.75  "
FireWrap® Grip Kit Red,02/03/2021,Invoice,M-020321-002,,FireWrap® Grip Kit Red,3,18.75  ,56.25  ,"34,063.00  "
FireWrap® Grip Kit Red,02/05/2021,Sales Receipt,4925,,FireWrap® Grip Kit - Red,2,24.95  ,49.90  ,"34,112.90  "
FireWrap® Grip Kit Red,02/07/2021,Sales Receipt,4933,,FireWrap® Grip Kit - Red,1,24.95  ,24.95  ,"34,137.85  "
FireWrap® Grip Kit Red,02/10/2021,Sales Receipt,4944,,FireWrap® Grip Kit - Red,2,24.95  ,49.90  ,"34,187.75  "
FireWrap® Grip Kit Red,02/11/2021,Sales Receipt,4950,,FireWrap® Grip Kit - Red,4,24.95  ,99.80  ,"34,287.55  "
FireWrap® Grip Kit Red,02/12/2021,Sales Receipt,4951,,"FIREWRAP® GRIP KIT
Color: Red",1,24.99  ,24.99  ,"34,312.54  "
FireWrap® Grip Kit Red,02/13/2021,Sales Receipt,4955,,"FIREWRAP® GRIP KIT
Color: Red",1,24.99  ,24.99  ,"34,337.53  "
FireWrap® Grip Kit Red,02/13/2021,Sales Receipt,4958,,"FIREWRAP® GRIP KIT
Color: Red",2,24.99  ,49.98  ,"34,387.51  "
FireWrap® Grip Kit Red,02/14/2021,Sales Receipt,4968,,"FIREWRAP® GRIP KIT
Color: Red",2,24.99  ,49.98  ,"34,437.49  "
FireWrap® Grip Kit Red,02/16/2021,Invoice,M-021621-004,,FireWrap® Grip Kit Red,10,18.75  ,187.50  ,"34,624.99  "
FireWrap® Grip Kit Red,02/16/2021,Invoice,M-021621-010,,FireWrap® Grip Kit Red,1,18.75  ,18.75  ,"34,643.74  "
FireWrap® Grip Kit Red,02/16/2021,Invoice,M-021621-020,,FireWrap® Grip Kit Red,9,18.75  ,168.75  ,"34,812.49  "
FireWrap® Grip Kit Red,02/16/2021,Sales Receipt,4977,,"FIREWRAP® GRIP KIT
Color: Red",1,24.99  ,24.99  ,"34,837.48  "
FireWrap® Grip Kit Red,02/16/2021,Invoice,M-021621-021,,FireWrap® Grip Kit Red,2,18.75  ,37.50  ,"34,874.98  "
FireWrap® Grip Kit Red,02/16/2021,Invoice,M-021621-002,,FireWrap® Grip Kit Red,10,18.75  ,187.50  ,"35,062.48  "
FireWrap® Grip Kit Red,02/16/2021,Invoice,M-021621-016,,FireWrap® Grip Kit Red,1,18.75  ,18.75  ,"35,081.23  "
FireWrap® Grip Kit Red,02/17/2021,Sales Receipt,4981,,"FIREWRAP® GRIP KIT
Color: Red",1,24.99  ,24.99  ,"35,106.22  "
FireWrap® Grip Kit Red,02/18/2021,Invoice,M-021821-006,,FireWrap® Grip Kit Red,1,18.75  ,18.75  ,"35,124.97  "
FireWrap® Grip Kit Red,02/19/2021,Sales Receipt,4989,,"FIREWRAP® GRIP KIT
Color: Red",1,24.99  ,24.99  ,"35,149.96  "
FireWrap® Grip Kit Red,02/22/2021,Sales Receipt,5008,,"FIREWRAP® GRIP KIT
Color: Red",1,24.99  ,24.99  ,"35,174.95  "
FireWrap® Grip Kit Red,02/22/2021,Sales Receipt,5006,,"FIREWRAP® GRIP KIT
Color: Red",1,24.99  ,24.99  ,"35,199.94  "
FireWrap® Grip Kit Red,02/24/2021,Invoice,M-022421-009,,FireWrap® Grip Kit Red,6,18.75  ,112.50  ,"35,312.44  "
FireWrap® Grip Kit Red,02/24/2021,Sales Receipt,5017,,"FIREWRAP® GRIP KIT
Color: Red",1,24.99  ,24.99  ,"35,337.43  "
FireWrap® Grip Kit Red,02/24/2021,Sales Receipt,5023,,"FIREWRAP® GRIP KIT
Color: Red",1,24.99  ,24.99  ,"35,362.42  "
FireWrap® Grip Kit Red,02/24/2021,Sales Receipt,5016,,"FIREWRAP® GRIP KIT
Color: Red",1,24.99  ,24.99  ,"35,387.41  "
FireWrap® Grip Kit Red,02/24/2021,Sales Receipt,5018,,"FIREWRAP® GRIP KIT
Color: Red",2,24.99  ,49.98  ,"35,437.39  "
FireWrap® Grip Kit Red,02/25/2021,Sales Receipt,5025,,"FIREWRAP® GRIP KIT
Color: Red",2,24.99  ,49.98  ,"35,487.37  "
FireWrap® Grip Kit Red,02/25/2021,Sales Receipt,5026,,"FIREWRAP® GRIP KIT
Color: Red",5,24.99  ,124.95  ,"35,612.32  "
FireWrap® Grip Kit Red,02/25/2021,Sales Receipt,5028,,"FIREWRAP® GRIP KIT - Yes, I understand.
Color: Red",1,24.99  ,24.99  ,"35,637.31  "
FireWrap® Grip Kit Red,03/02/2021,Sales Receipt,5037,,"FIREWRAP® GRIP KIT - Yes, I understand.
Color: Red",6,24.99  ,149.94  ,"35,787.25  "
FireWrap® Grip Kit Red,03/04/2021,Sales Receipt,5047,,"FIREWRAP® GRIP KIT - Yes, I understand.
Color: Red",1,24.99  ,24.99  ,"35,812.24  "
FireWrap® Grip Kit Red,03/06/2021,Sales Receipt,5051,,"FIREWRAP® GRIP KIT
Color: Red",10,24.99  ,249.90  ,"36,062.14  "
FireWrap® Grip Kit Red,03/08/2021,Sales Receipt,5058,,"FIREWRAP® GRIP KIT - Yes, I understand.
Color: Red",1,24.99  ,24.99  ,"36,087.13  "
FireWrap® Grip Kit Red,03/10/2021,Sales Receipt,5074,,"FIREWRAP® GRIP KIT - Yes, I understand.
Color: Red",3,24.99  ,74.97  ,"36,162.10  "
FireWrap® Grip Kit Red,03/11/2021,Sales Receipt,5086,,"FIREWRAP® GRIP KIT - Yes, I understand.
Color: Red",1,24.99  ,24.99  ,"36,187.09  "
FireWrap® Grip Kit Red,03/12/2021,Sales Receipt,5095,,"FIREWRAP® GRIP KIT - Yes, I understand.
Color: Red",1,24.99  ,24.99  ,"36,212.08  "
FireWrap® Grip Kit Red,03/12/2021,Sales Receipt,5093,,"FIREWRAP® GRIP KIT - Yes, I understand.
Color: Red",4,24.99  ,99.96  ,"36,312.04  "
FireWrap® Grip Kit Red,03/12/2021,Invoice,M-031221-008,,FireWrap® Grip Kit Red,6,24.95  ,149.70  ,"36,461.74  "
FireWrap® Grip Kit Red,03/12/2021,Sales Receipt,5099,,"FIREWRAP® GRIP KIT - Yes, I understand.
Color: Red",8,24.99  ,199.92  ,"36,661.66  "
FireWrap® Grip Kit Red,03/12/2021,Sales Receipt,5097,,"FIREWRAP® GRIP KIT - Yes, I understand.
Color: Red",1,24.99  ,24.99  ,"36,686.65  "
FireWrap® Grip Kit Red,03/15/2021,Sales Receipt,5116,,"FIREWRAP® GRIP KIT - Yes, I understand.
Color: Red",1,24.99  ,24.99  ,"36,711.64  "
FireWrap® Grip Kit Red,03/15/2021,Sales Receipt,5119,,"FIREWRAP® GRIP KIT - Yes, I understand.
Color: Red",1,24.99  ,24.99  ,"36,736.63  "
FireWrap® Grip Kit Red,03/15/2021,Sales Receipt,5114,,"FIREWRAP® GRIP KIT - Yes, I understand.
Color: Red",1,24.99  ,24.99  ,"36,761.62  "
FireWrap® Grip Kit Red,03/18/2021,Sales Receipt,5133,,"FIREWRAP® GRIP KIT - Yes, I understand.
Color: Red",1,24.99  ,24.99  ,"36,786.61  "
FireWrap® Grip Kit Red,03/18/2021,Sales Receipt,5134,,"FIREWRAP® GRIP KIT - Yes, I understand.
Color: Red",2,24.99  ,49.98  ,"36,836.59  "
FireWrap® Grip Kit Red,03/20/2021,Sales Receipt,5150,,"FIREWRAP® GRIP KIT - Yes, I understand.
Color: Red",1,24.99  ,24.99  ,"36,861.58  "
FireWrap® Grip Kit Red,03/20/2021,Sales Receipt,5149,,"FIREWRAP® GRIP KIT - Yes, I understand.
Color: Red",1,24.99  ,24.99  ,"36,886.57  "
FireWrap® Grip Kit Red,03/21/2021,Sales Receipt,5157,,"FIREWRAP® GRIP KIT - Yes, I understand.
Color: Red",1,24.99  ,24.99  ,"36,911.56  "
FireWrap® Grip Kit Red,03/22/2021,Sales Receipt,5164,,"FIREWRAP® GRIP KIT - Yes, I understand.
Color: Red",1,24.99  ,24.99  ,"36,936.55  "
FireWrap® Grip Kit Red,03/22/2021,Sales Receipt,5160,,"FIREWRAP® GRIP KIT - Yes, I understand.
Color: Red",4,24.99  ,99.96  ,"37,036.51  "
FireWrap® Grip Kit Red,03/22/2021,Sales Receipt,5162,,"FIREWRAP® GRIP KIT - Yes, I understand.
Color: Red",4,24.99  ,99.96  ,"37,136.47  "
FireWrap® Grip Kit Red,03/24/2021,Sales Receipt,5170,,"FIREWRAP® GRIP KIT - Yes, I understand.
Color: Red",1,24.99  ,24.99  ,"37,161.46  "
FireWrap® Grip Kit Red,03/27/2021,Sales Receipt,5181,,"FIREWRAP® GRIP KIT - Yes, I understand.
Color: Red",1,24.99  ,24.99  ,"37,186.45  "
FireWrap® Grip Kit Red,03/27/2021,Invoice,M-032721-006,,FireWrap® Grip Kit Red,4,18.75  ,75.00  ,"37,261.45  "
FireWrap® Grip Kit Red,03/27/2021,Invoice,M-032721-006,,FireWrap® Grip Kit Red,4,18.75  ,75.00  ,"37,336.45  "
FireWrap® Grip Kit Red,03/27/2021,Invoice,M-021921-001,,FireWrap® Grip Kit Red,4,18.75  ,75.00  ,"37,411.45  "
FireWrap® Grip Kit Red,03/27/2021,Invoice,M-021921-001,,FireWrap® Grip Kit Red,2,18.75  ,37.50  ,"37,448.95  "
FireWrap® Grip Kit Red,03/27/2021,Invoice,M-032721-001,,FireWrap® Grip Kit Red,12,18.75  ,225.00  ,"37,673.95  "
FireWrap® Grip Kit Red,03/28/2021,Sales Receipt,5196,,"FIREWRAP® GRIP KIT - Yes, I understand.
Color: Red",1,24.99  ,24.99  ,"37,698.94  "
FireWrap® Grip Kit Red,03/28/2021,Sales Receipt,5187,,"FIREWRAP® GRIP KIT - Yes, I understand.
Color: Red",1,24.99  ,24.99  ,"37,723.93  "
FireWrap® Grip Kit Red,03/28/2021,Sales Receipt,5191,,"FIREWRAP® GRIP KIT - Yes, I understand.
Color: Red",2,24.99  ,49.98  ,"37,773.91  "
FireWrap® Grip Kit Red,03/29/2021,Sales Receipt,5201,,"FIREWRAP® GRIP KIT - Yes, I understand.
Color: Red",1,24.99  ,24.99  ,"37,798.90  "
FireWrap® Grip Kit Red,03/29/2021,Sales Receipt,5203,,"FIREWRAP® GRIP KIT - Yes, I understand.
Color: Red",2,24.99  ,49.98  ,"37,848.88  "
FireWrap® Grip Kit Red,03/30/2021,Invoice,M-033021-008,,FireWrap® Grip Kit Red,4,18.75  ,75.00  ,"37,923.88  "
FireWrap® Grip Kit Red,03/30/2021,Invoice,M-033021-008,,FireWrap® Grip Kit Red,8,18.75  ,150.00  ,"38,073.88  "
FireWrap® Grip Kit Red,03/30/2021,Invoice,M-033021-009,,FireWrap® Grip Kit Red,1,18.75  ,18.75  ,"38,092.63  "
FireWrap® Grip Kit Red,03/30/2021,Invoice,M-033021-007,,FireWrap® Grip Kit Red,1,18.75  ,18.75  ,"38,111.38  "
FireWrap® Grip Kit Red,03/31/2021,Sales Receipt,5220,,"FIREWRAP® GRIP KIT - Yes, I understand.
Color: Red",1,24.99  ,24.99  ,"38,136.37  "
FireWrap® Grip Kit Red,03/31/2021,Sales Receipt,5214,,"FIREWRAP® GRIP KIT - Yes, I understand.
Color: Red",1,24.99  ,24.99  ,"38,161.36  "
FireWrap® Grip Kit Red,03/31/2021,Sales Receipt,5216,,"FIREWRAP® GRIP KIT - Yes, I understand.
Color: Red",1,24.99  ,24.99  ,"38,186.35  "
FireWrap® Grip Kit Red,04/01/2021,Sales Receipt,5223,,"FIREWRAP® GRIP KIT - Yes, I understand.
Color: Red",1,24.99  ,24.99  ,"38,211.34  "
FireWrap® Grip Kit Red,04/01/2021,Sales Receipt,5224,,"FIREWRAP® GRIP KIT - Yes, I understand.
Color: Red",1,24.99  ,24.99  ,"38,236.33  "
FireWrap® Grip Kit Red,04/02/2021,Sales Receipt,5226,,"FIREWRAP® GRIP KIT - Yes, I understand.
Color: Red",4,24.99  ,99.96  ,"38,336.29  "
FireWrap® Grip Kit Red,04/03/2021,Sales Receipt,5233,,"FIREWRAP® GRIP KIT - Yes, I understand.
Color: Red",1,24.99  ,24.99  ,"38,361.28  "
FireWrap® Grip Kit Red,04/04/2021,Sales Receipt,5238,,"FIREWRAP® GRIP KIT - Yes, I understand.
Color: Red",1,24.99  ,24.99  ,"38,386.27  "
FireWrap® Grip Kit Red,04/05/2021,Sales Receipt,5244,,"FIREWRAP® GRIP KIT - Yes, I understand.
Color: Red",1,24.99  ,24.99  ,"38,411.26  "
FireWrap® Grip Kit Red,04/06/2021,Sales Receipt,5254,,"FIREWRAP® GRIP KIT - Yes, I understand.
Color: Red",1,24.99  ,24.99  ,"38,436.25  "
FireWrap® Grip Kit Red,04/06/2021,Sales Receipt,5251,,"FIREWRAP® GRIP KIT - Yes, I understand.
Color: Red",1,24.99  ,24.99  ,"38,461.24  "
FireWrap® Grip Kit Red,04/06/2021,Sales Receipt,5246,,"FIREWRAP® GRIP KIT - Yes, I understand.
Color: Red",1,24.99  ,24.99  ,"38,486.23  "
FireWrap® Grip Kit Red,04/07/2021,Invoice,M-040721-003,,FireWrap® Grip Kit Red,6,18.75  ,112.50  ,"38,598.73  "
FireWrap® Grip Kit Red,04/08/2021,Sales Receipt,5263,,"FIREWRAP® GRIP KIT - Yes, I understand.
Color: Red",21,24.99  ,524.79  ,"39,123.52  "
FireWrap® Grip Kit Red,04/10/2021,Sales Receipt,5280,,"FIREWRAP® GRIP KIT - Yes, I understand.
Color: Red",1,24.99  ,24.99  ,"39,148.51  "
FireWrap® Grip Kit Red,04/12/2021,Invoice,M-041221-003,,FireWrap® Grip Kit Red,1,18.75  ,18.75  ,"39,167.26  "
FireWrap® Grip Kit Red,04/13/2021,Sales Receipt,5286,,"FIREWRAP® GRIP KIT - Yes, I understand.
Color: Red",1,24.99  ,24.99  ,"39,192.25  "
FireWrap® Grip Kit Red,04/13/2021,Sales Receipt,5290,,"FIREWRAP® GRIP KIT - Yes, I understand.
Color: Red",1,24.99  ,24.99  ,"39,217.24  "
FireWrap® Grip Kit Red,04/13/2021,Sales Receipt,5288,,"FIREWRAP® GRIP KIT - Yes, I understand.
Color: Red",10,24.99  ,249.90  ,"39,467.14  "
FireWrap® Grip Kit Red,04/13/2021,Sales Receipt,5287,,"FIREWRAP® GRIP KIT - Yes, I understand.
Color: Red",3,24.99  ,74.97  ,"39,542.11  "
FireWrap® Grip Kit Red,04/14/2021,Sales Receipt,5298,,"FIREWRAP® GRIP KIT - Yes, I understand.
Color: Red",1,24.99  ,24.99  ,"39,567.10  "
FireWrap® Grip Kit Red,04/16/2021,Sales Receipt,5307,,"FIREWRAP® GRIP KIT - Yes, I understand.
Color: Red",1,24.99  ,24.99  ,"39,592.09  "
FireWrap® Grip Kit Red,04/16/2021,Sales Receipt,5309,,"FIREWRAP® GRIP KIT
Color: Red",1,24.99  ,24.99  ,"39,617.08  "
FireWrap® Grip Kit Red,04/16/2021,Sales Receipt,5308,,"FIREWRAP® GRIP KIT - Yes, I understand.
Color: Red",2,24.99  ,49.98  ,"39,667.06  "
FireWrap® Grip Kit Red,04/17/2021,Invoice,M-041721-004,,FireWrap® Grip Kit Red,1,18.75  ,18.75  ,"39,685.81  "
FireWrap® Grip Kit Red,04/17/2021,Sales Receipt,5315,,"FIREWRAP® GRIP KIT
Color: Red",4,24.99  ,99.96  ,"39,785.77  "
FireWrap® Grip Kit Red,04/18/2021,Sales Receipt,5322,,"FIREWRAP® GRIP KIT
Color: Red",1,24.99  ,24.99  ,"39,810.76  "
FireWrap® Grip Kit Red,04/19/2021,Sales Receipt,5327,,"FIREWRAP® GRIP KIT
Color: Red",1,24.99  ,24.99  ,"39,835.75  "
FireWrap® Grip Kit Red,04/21/2021,Sales Receipt,5340,,"FIREWRAP® GRIP KIT
Color: Red",3,24.99  ,74.97  ,"39,910.72  "
FireWrap® Grip Kit Red,04/22/2021,Sales Receipt,5350,,"FIREWRAP® GRIP KIT
Color: Red",1,24.99  ,24.99  ,"39,935.71  "
FireWrap® Grip Kit Red,04/22/2021,Sales Receipt,5353,,"FIREWRAP® GRIP KIT
Color: Red",2,24.99  ,49.98  ,"39,985.69  "
FireWrap® Grip Kit Red,04/23/2021,Sales Receipt,5360,,"FIREWRAP® GRIP KIT
Color: Red",1,24.99  ,24.99  ,"40,010.68  "
FireWrap® Grip Kit Red,04/23/2021,Sales Receipt,5361,,"FIREWRAP® GRIP KIT
Color: Red",1,24.99  ,24.99  ,"40,035.67  "
FireWrap® Grip Kit Red,04/23/2021,Sales Receipt,5364,,"FIREWRAP® GRIP KIT
Color: Red",3,24.99  ,74.97  ,"40,110.64  "
FireWrap® Grip Kit Red,04/23/2021,Invoice,M-042321-005,,FireWrap® Grip Kit Red,2,24.95  ,49.90  ,"40,160.54  "
FireWrap® Grip Kit Red,04/23/2021,Sales Receipt,5359,,"FIREWRAP® GRIP KIT
Color: Red",1,24.99  ,24.99  ,"40,185.53  "
FireWrap® Grip Kit Red,04/25/2021,Sales Receipt,5387,,"FIREWRAP® GRIP KIT
Color: Red",1,24.99  ,24.99  ,"40,210.52  "
FireWrap® Grip Kit Red,04/26/2021,Sales Receipt,5391,,"FIREWRAP® GRIP KIT
Color: Red",1,24.99  ,24.99  ,"40,235.51  "
FireWrap® Grip Kit Red,04/27/2021,Sales Receipt,5398,,"FIREWRAP® GRIP KIT
Color: Red",1,24.99  ,24.99  ,"40,260.50  "
FireWrap® Grip Kit Red,04/28/2021,Sales Receipt,5405,,"FIREWRAP® GRIP KIT
Color: Red",8,24.99  ,199.92  ,"40,460.42  "
FireWrap® Grip Kit Red,04/30/2021,Sales Receipt,5419,,"FIREWRAP® GRIP KIT
Color: Red",1,24.99  ,24.99  ,"40,485.41  "
FireWrap® Grip Kit Red,04/30/2021,Invoice,M-043021-003,,FireWrap® Grip Kit Red,14,18.75  ,262.50  ,"40,747.91  "
FireWrap® Grip Kit Red,04/30/2021,Invoice,M-043021-002,,FireWrap® Grip Kit Red,6,24.99  ,149.94  ,"40,897.85  "
FireWrap® Grip Kit Red,05/01/2021,Sales Receipt,5433,,"FIREWRAP® GRIP KIT
Color: Red",1,24.99  ,24.99  ,"40,922.84  "
FireWrap® Grip Kit Red,05/02/2021,Sales Receipt,5441,,"FIREWRAP® GRIP KIT
Color: Red",1,24.99  ,24.99  ,"40,947.83  "
FireWrap® Grip Kit Red,05/03/2021,Invoice,M-050321-003,,FireWrap® Grip Kit Red,8,18.75  ,150.00  ,"41,097.83  "
FireWrap® Grip Kit Red,05/06/2021,Sales Receipt,5456,,"FIREWRAP® GRIP KIT
Color: Red",1,24.99  ,24.99  ,"41,122.82  "
FireWrap® Grip Kit Red,05/07/2021,Sales Receipt,5462,,"FIREWRAP® GRIP KIT
Color: Red",2,24.99  ,49.98  ,"41,172.80  "
FireWrap® Grip Kit Red,05/08/2021,Sales Receipt,5467,,"FIREWRAP® GRIP KIT
Color: Red",1,24.99  ,24.99  ,"41,197.79  "
FireWrap® Grip Kit Red,05/11/2021,Sales Receipt,5483,,"FIREWRAP® GRIP KIT
Color: Red",1,24.99  ,24.99  ,"41,222.78  "
FireWrap® Grip Kit Red,05/11/2021,Sales Receipt,5489,,"FIREWRAP® GRIP KIT
Color: Red",1,24.99  ,24.99  ,"41,247.77  "
FireWrap® Grip Kit Red,05/11/2021,Sales Receipt,5484,,"FIREWRAP® GRIP KIT
Color: Red",1,24.99  ,24.99  ,"41,272.76  "
FireWrap® Grip Kit Red,05/11/2021,Sales Receipt,5486,,"FIREWRAP® GRIP KIT
Color: Red",1,24.99  ,24.99  ,"41,297.75  "
FireWrap® Grip Kit Red,05/11/2021,Sales Receipt,5481,,"FIREWRAP® GRIP KIT
Color: Red",2,24.99  ,49.98  ,"41,347.73  "
FireWrap® Grip Kit Red,05/12/2021,Sales Receipt,5491,,"FIREWRAP® GRIP KIT
Color: Red",1,24.99  ,24.99  ,"41,372.72  "
FireWrap® Grip Kit Red,05/16/2021,Sales Receipt,5521,,"FIREWRAP® GRIP KIT
Color: Red",2,24.99  ,49.98  ,"41,422.70  "
FireWrap® Grip Kit Red,05/16/2021,Sales Receipt,5519,,"FIREWRAP® GRIP KIT
Color: Red",2,24.99  ,49.98  ,"41,472.68  "
FireWrap® Grip Kit Red,05/20/2021,Sales Receipt,5544,,"FIREWRAP® GRIP KIT
Color: Red",1,24.99  ,24.99  ,"41,497.67  "
FireWrap® Grip Kit Red,05/20/2021,Invoice,M-052021-001,,FireWrap® Grip Kit Red,12,18.75  ,225.00  ,"41,722.67  "
FireWrap® Grip Kit Red,05/21/2021,Sales Receipt,5554,,"FIREWRAP® GRIP KIT
Color: Red",1,24.99  ,24.99  ,"41,747.66  "
FireWrap® Grip Kit Red,05/21/2021,Sales Receipt,5548,,"FIREWRAP® GRIP KIT
Color: Red",1,24.99  ,24.99  ,"41,772.65  "
FireWrap® Grip Kit Red,05/21/2021,Sales Receipt,5552,,"FIREWRAP® GRIP KIT
Color: Red",1,24.99  ,24.99  ,"41,797.64  "
FireWrap® Grip Kit Red,05/21/2021,Sales Receipt,5550,,"FIREWRAP® GRIP KIT
Color: Red",2,24.99  ,49.98  ,"41,847.62  "
FireWrap® Grip Kit Red,05/23/2021,Sales Receipt,5563,,"FIREWRAP® GRIP KIT
Color: Red",1,24.99  ,24.99  ,"41,872.61  "
FireWrap® Grip Kit Red,05/24/2021,Sales Receipt,5566,,"FIREWRAP® GRIP KIT
Color: Red",1,24.99  ,24.99  ,"41,897.60  "
FireWrap® Grip Kit Red,05/24/2021,Sales Receipt,5567,,"FIREWRAP® GRIP KIT
Color: Red",1,24.99  ,24.99  ,"41,922.59  "
FireWrap® Grip Kit Red,05/26/2021,Sales Receipt,5583,,"FIREWRAP® GRIP KIT
Color: Red",4,24.99  ,99.96  ,"42,022.55  "
FireWrap® Grip Kit Red,05/27/2021,Sales Receipt,5586,,"FIREWRAP® GRIP KIT
Color: Red",1,24.99  ,24.99  ,"42,047.54  "
FireWrap® Grip Kit Red,05/29/2021,Sales Receipt,5595,,"FIREWRAP® GRIP KIT
Color: Red",1,24.99  ,24.99  ,"42,072.53  "
FireWrap® Grip Kit Red,05/30/2021,Sales Receipt,5600,,"FIREWRAP® GRIP KIT
Color: Red",1,24.99  ,24.99  ,"42,097.52  "
FireWrap® Grip Kit Red,05/30/2021,Sales Receipt,5602,,"FIREWRAP® GRIP KIT
Color: Red",4,24.99  ,99.96  ,"42,197.48  "
FireWrap® Grip Kit Red,06/02/2021,Sales Receipt,5611,,"FIREWRAP® GRIP KIT
Color: Red",2,24.99  ,49.98  ,"42,247.46  "
FireWrap® Grip Kit Red,06/03/2021,Invoice,M-060321-002,,FireWrap® Grip Kit Red,6,18.75  ,112.50  ,"42,359.96  "
FireWrap® Grip Kit Red,06/03/2021,Sales Receipt,5618,,"FIREWRAP® GRIP KIT
Color: Red",1,24.99  ,24.99  ,"42,384.95  "
FireWrap® Grip Kit Red,06/03/2021,Sales Receipt,5620,,"FIREWRAP® GRIP KIT
Color: Red",1,24.99  ,24.99  ,"42,409.94  "
FireWrap® Grip Kit Red,06/05/2021,Sales Receipt,5628,,"FIREWRAP® GRIP KIT
Color: Red",1,24.99  ,24.99  ,"42,434.93  "
FireWrap® Grip Kit Red,06/05/2021,Sales Receipt,5627,,"FIREWRAP® GRIP KIT
Color: Red",1,24.99  ,24.99  ,"42,459.92  "
FireWrap® Grip Kit Red,06/06/2021,Sales Receipt,5633,,"FIREWRAP® GRIP KIT
Color: Red",1,24.99  ,24.99  ,"42,484.91  "
FireWrap® Grip Kit Red,06/09/2021,Sales Receipt,5645,,"FIREWRAP® GRIP KIT
Color: Red",2,24.99  ,49.98  ,"42,534.89  "
FireWrap® Grip Kit Red,06/14/2021,Sales Receipt,5665,,"FIREWRAP® GRIP KIT
Color: Red",1,24.99  ,24.99  ,"42,559.88  "
FireWrap® Grip Kit Red,06/16/2021,Sales Receipt,5675,,"FIREWRAP® GRIP KIT
Color: Red",2,24.99  ,49.98  ,"42,609.86  "
FireWrap® Grip Kit Red,06/16/2021,Invoice,M-061621-003,,FireWrap® Grip Kit Red,14,18.75  ,262.50  ,"42,872.36  "
FireWrap® Grip Kit Red,06/16/2021,Invoice,M-061621-001,,FireWrap® Grip Kit Red,15,18.75  ,281.25  ,"43,153.61  "
FireWrap® Grip Kit Red,06/21/2021,Invoice,M-062121-001,,FireWrap® Grip Kit Red,3,24.99  ,74.97  ,"43,228.58  "
FireWrap® Grip Kit Red,06/22/2021,Sales Receipt,5696,,"FIREWRAP® GRIP KIT
Color: Red",6,24.99  ,149.94  ,"43,378.52  "
FireWrap® Grip Kit Red,06/29/2021,Sales Receipt,5721,,"FIREWRAP® GRIP KIT
Color: Red",20,24.99  ,499.80  ,"43,878.32  "
FireWrap® Grip Kit Red,06/29/2021,Sales Receipt,5722,,"FIREWRAP® GRIP KIT
Color: Red",1,24.99  ,24.99  ,"43,903.31  "
FireWrap® Grip Kit Red,07/04/2021,Sales Receipt,5743,,"FIREWRAP® GRIP KIT
Color: Red",1,24.99  ,24.99  ,"43,928.30  "
FireWrap® Grip Kit Red,07/05/2021,Sales Receipt,5750,,"FIREWRAP® GRIP KIT
Color: Red",1,24.99  ,24.99  ,"43,953.29  "
FireWrap® Grip Kit Red,07/07/2021,Sales Receipt,5755,,"FIREWRAP® GRIP KIT
Color: Red",1,24.99  ,24.99  ,"43,978.28  "
FireWrap® Grip Kit Red,07/10/2021,Sales Receipt,5767,,"FIREWRAP® GRIP KIT
Color: Red",1,24.99  ,24.99  ,"44,003.27  "
FireWrap® Grip Kit Red,07/11/2021,Sales Receipt,5770,,"FIREWRAP® GRIP KIT
Color: Red",1,24.99  ,24.99  ,"44,028.26  "
FireWrap® Grip Kit Red,07/13/2021,Invoice,M-071321-006,,FireWrap® Grip Kit Red,1,18.75  ,18.75  ,"44,047.01  "
FireWrap® Grip Kit Red,07/14/2021,Sales Receipt,5778,,"FIREWRAP® GRIP KIT
Color: Red",2,24.99  ,49.98  ,"44,096.99  "
FireWrap® Grip Kit Red,07/15/2021,Sales Receipt,5785,,"FIREWRAP® GRIP KIT
Color: Red",1,24.99  ,24.99  ,"44,121.98  "
FireWrap® Grip Kit Red,07/15/2021,Sales Receipt,5784,,"FIREWRAP® GRIP KIT
Color: Red",6,24.99  ,149.94  ,"44,271.92  "
FireWrap® Grip Kit Red,07/18/2021,Sales Receipt,5795,,"FIREWRAP® GRIP KIT
Color: Red",1,24.99  ,24.99  ,"44,296.91  "
FireWrap® Grip Kit Red,07/20/2021,Sales Receipt,5802,,"FIREWRAP® GRIP KIT
Color: Red",1,24.99  ,24.99  ,"44,321.90  "
FireWrap® Grip Kit Red,07/21/2021,Sales Receipt,5807,,"FIREWRAP® GRIP KIT
Color: Red",1,24.99  ,24.99  ,"44,346.89  "
FireWrap® Grip Kit Red,07/24/2021,Sales Receipt,5817,,"FIREWRAP® GRIP KIT
Color: Red",1,24.99  ,24.99  ,"44,371.88  "
FireWrap® Grip Kit Red,07/26/2021,Sales Receipt,5826,,"FIREWRAP® GRIP KIT
Color: Red",1,24.99  ,24.99  ,"44,396.87  "
FireWrap® Grip Kit Red,07/27/2021,Sales Receipt,5829,,"FIREWRAP® GRIP KIT
Color: Red",1,24.99  ,24.99  ,"44,421.86  "
FireWrap® Grip Kit Red,07/28/2021,Sales Receipt,5832,,"FIREWRAP® GRIP KIT
Color: Red",1,24.99  ,24.99  ,"44,446.85  "
FireWrap® Grip Kit Red,07/30/2021,Sales Receipt,5838,,"FIREWRAP® GRIP KIT
Color: Red",2,24.99  ,49.98  ,"44,496.83  "
FireWrap® Grip Kit Red,08/01/2021,Sales Receipt,5847,,"FIREWRAP® GRIP KIT
Color: Red",2,24.99  ,49.98  ,"44,546.81  "
FireWrap® Grip Kit Red,08/02/2021,Sales Receipt,5851,,"FIREWRAP® GRIP KIT
Color: Red",2,24.99  ,49.98  ,"44,596.79  "
FireWrap® Grip Kit Red,08/04/2021,Sales Receipt,5856,,"FIREWRAP® GRIP KIT
Color: Red",10,24.99  ,249.90  ,"44,846.69  "
FireWrap® Grip Kit Red,08/06/2021,Sales Receipt,5872,,"FIREWRAP® GRIP KIT
Color: Red",1,24.99  ,24.99  ,"44,871.68  "
FireWrap® Grip Kit Red,08/06/2021,Sales Receipt,5871,,"FIREWRAP® GRIP KIT
Color: Red",4,24.99  ,99.96  ,"44,971.64  "
FireWrap® Grip Kit Red,08/07/2021,Sales Receipt,5878,,"FIREWRAP® GRIP KIT
Color: Red",1,24.99  ,24.99  ,"44,996.63  "
FireWrap® Grip Kit Red,08/07/2021,Sales Receipt,5875,,"FIREWRAP® GRIP KIT
Color: Red",1,24.99  ,24.99  ,"45,021.62  "
FireWrap® Grip Kit Red,08/09/2021,Sales Receipt,5886,,"FIREWRAP® GRIP KIT
Color: Red",4,24.99  ,99.96  ,"45,121.58  "
FireWrap® Grip Kit Red,08/09/2021,Sales Receipt,5889,,"FIREWRAP® GRIP KIT
Color: Red",2,24.99  ,49.98  ,"45,171.56  "
FireWrap® Grip Kit Red,08/10/2021,Sales Receipt,5894,,"FIREWRAP® GRIP KIT
Color: Red",1,24.99  ,24.99  ,"45,196.55  "
FireWrap® Grip Kit Red,08/11/2021,Sales Receipt,5898,,"FIREWRAP® GRIP KIT
Color: Red",3,24.99  ,74.97  ,"45,271.52  "
FireWrap® Grip Kit Red,08/11/2021,Sales Receipt,5896,,"FIREWRAP® GRIP KIT
Color: Red",2,24.99  ,49.98  ,"45,321.50  "
FireWrap® Grip Kit Red,08/14/2021,Sales Receipt,5912,,"FIREWRAP® GRIP KIT
Color: Red",1,24.99  ,24.99  ,"45,346.49  "
FireWrap® Grip Kit Red,08/16/2021,Sales Receipt,5928,,"FIREWRAP® GRIP KIT
Color: Red",3,24.99  ,74.97  ,"45,421.46  "
FireWrap® Grip Kit Red,08/16/2021,Sales Receipt,5925,,"FIREWRAP® GRIP KIT
Color: Red",8,24.99  ,199.92  ,"45,621.38  "
FireWrap® Grip Kit Red,08/17/2021,Invoice,M-081221-001,,FireWrap® Grip Kit Red,2,18.75  ,37.50  ,"45,658.88  "
FireWrap® Grip Kit Red,08/18/2021,Sales Receipt,5935,,"FIREWRAP® GRIP KIT
Color: Red",1,24.99  ,24.99  ,"45,683.87  "
FireWrap® Grip Kit Red,08/18/2021,Sales Receipt,5938,,"FIREWRAP® GRIP KIT
Color: Red",1,24.99  ,24.99  ,"45,708.86  "
FireWrap® Grip Kit Red,08/23/2021,Sales Receipt,5964,,"FIREWRAP® GRIP KIT
Color: Red",1,24.99  ,24.99  ,"45,733.85  "
FireWrap® Grip Kit Red,08/24/2021,Sales Receipt,5970,,"FIREWRAP® GRIP KIT
Color: Red",1,24.99  ,24.99  ,"45,758.84  "
FireWrap® Grip Kit Red,08/26/2021,Sales Receipt,5979,,"FIREWRAP® GRIP KIT
Color: Red",1,24.99  ,24.99  ,"45,783.83  "
FireWrap® Grip Kit Red,08/27/2021,Sales Receipt,5990,,"FIREWRAP® GRIP KIT
Color: Red",1,24.99  ,24.99  ,"45,808.82  "
FireWrap® Grip Kit Red,08/30/2021,Sales Receipt,6005,,"FIREWRAP® GRIP KIT
Color: Red",1,24.99  ,24.99  ,"45,833.81  "
FireWrap® Grip Kit Red,08/30/2021,Sales Receipt,6004,,"FIREWRAP® GRIP KIT
Color: Red",2,24.99  ,49.98  ,"45,883.79  "
FireWrap® Grip Kit Red,08/31/2021,Sales Receipt,6010,,"FIREWRAP® GRIP KIT
Color: Red",2,24.99  ,49.98  ,"45,933.77  "
FireWrap® Grip Kit Red,08/31/2021,Sales Receipt,6022,,"FIREWRAP® GRIP KIT
Color: Red",1,24.99  ,24.99  ,"45,958.76  "
FireWrap® Grip Kit Red,09/01/2021,Sales Receipt,6027,,"FIREWRAP® GRIP KIT
Color: Red",2,24.99  ,49.98  ,"46,008.74  "
FireWrap® Grip Kit Red,09/05/2021,Sales Receipt,6045,,"FIREWRAP® GRIP KIT
Color: Red",2,24.99  ,49.98  ,"46,058.72  "
FireWrap® Grip Kit Red,09/06/2021,Sales Receipt,6048,,"FIREWRAP® GRIP KIT
Color: Red",1,24.99  ,24.99  ,"46,083.71  "
FireWrap® Grip Kit Red,09/07/2021,Sales Receipt,6052,,"FIREWRAP® GRIP KIT
Color: Red",3,24.99  ,74.97  ,"46,158.68  "
FireWrap® Grip Kit Red,09/07/2021,Sales Receipt,6049,,"FIREWRAP® GRIP KIT
Color: Red",3,24.99  ,74.97  ,"46,233.65  "
FireWrap® Grip Kit Red,09/08/2021,Sales Receipt,6054,,"FIREWRAP® GRIP KIT
Color: Red",1,24.99  ,24.99  ,"46,258.64  "
FireWrap® Grip Kit Red,09/10/2021,Sales Receipt,6066,,"FIREWRAP® GRIP KIT
Color: Red",1,24.99  ,24.99  ,"46,283.63  "
FireWrap® Grip Kit Red,09/12/2021,Sales Receipt,6073,,"FIREWRAP® GRIP KIT
Color: Red",1,24.99  ,24.99  ,"46,308.62  "
FireWrap® Grip Kit Red,09/15/2021,Sales Receipt,6085,,"FIREWRAP® GRIP KIT
Color: Red",2,24.99  ,49.98  ,"46,358.60  "
FireWrap® Grip Kit Red,09/15/2021,Sales Receipt,6081,,"FIREWRAP® GRIP KIT
Color: Red",1,24.99  ,24.99  ,"46,383.59  "
FireWrap® Grip Kit Red,09/16/2021,Sales Receipt,6095,,"FIREWRAP® GRIP KIT
Color: Red",5,24.99  ,124.95  ,"46,508.54  "
FireWrap® Grip Kit Red,09/17/2021,Sales Receipt,6100,,"FIREWRAP® GRIP KIT
Color: Red",1,24.99  ,24.99  ,"46,533.53  "
FireWrap® Grip Kit Red,09/18/2021,Sales Receipt,6103,,"FIREWRAP® GRIP KIT
Color: Red",1,24.99  ,24.99  ,"46,558.52  "
FireWrap® Grip Kit Red,09/18/2021,Sales Receipt,6105,,"FIREWRAP® GRIP KIT
Color: Red",1,24.99  ,24.99  ,"46,583.51  "
FireWrap® Grip Kit Red,09/19/2021,Sales Receipt,6109,,"FIREWRAP® GRIP KIT
Color: Red",1,24.99  ,24.99  ,"46,608.50  "
FireWrap® Grip Kit Red,09/19/2021,Sales Receipt,6113,,"FIREWRAP® GRIP KIT
Color: Red",1,24.99  ,24.99  ,"46,633.49  "
FireWrap® Grip Kit Red,09/20/2021,Sales Receipt,6118,,"FIREWRAP® GRIP KIT
Color: Red",1,24.99  ,24.99  ,"46,658.48  "
FireWrap® Grip Kit Red,09/20/2021,Sales Receipt,6119,,"FIREWRAP® GRIP KIT
Color: Red",1,24.99  ,24.99  ,"46,683.47  "
FireWrap® Grip Kit Red,09/20/2021,Sales Receipt,6120,,"FIREWRAP® GRIP KIT
Color: Red",1,24.99  ,24.99  ,"46,708.46  "
FireWrap® Grip Kit Red,09/24/2021,Sales Receipt,6157,,"FIREWRAP® GRIP KIT
Color: Red",1,19.99  ,19.99  ,"46,728.45  "
FireWrap® Grip Kit Red,09/25/2021,Sales Receipt,6161,,"FIREWRAP® GRIP KIT
Color: Red",1,19.99  ,19.99  ,"46,748.44  "
FireWrap® Grip Kit Red,09/25/2021,Sales Receipt,6159,,"FIREWRAP® GRIP KIT
Color: Red",1,19.99  ,19.99  ,"46,768.43  "
FireWrap® Grip Kit Red,09/26/2021,Sales Receipt,6173,,"FIREWRAP® GRIP KIT
Color: Red",1,19.99  ,19.99  ,"46,788.42  "
FireWrap® Grip Kit Red,09/26/2021,Sales Receipt,6169,,"FIREWRAP® GRIP KIT
Color: Red",1,19.99  ,19.99  ,"46,808.41  "
FireWrap® Grip Kit Red,09/26/2021,Sales Receipt,6168,,"FIREWRAP® GRIP KIT
Color: Red",1,19.99  ,19.99  ,"46,828.40  "
FireWrap® Grip Kit Red,09/27/2021,Sales Receipt,6182,,"FIREWRAP® GRIP KIT
Color: Red",1,19.99  ,19.99  ,"46,848.39  "
FireWrap® Grip Kit Red,09/28/2021,Sales Receipt,6185,,"FIREWRAP® GRIP KIT
Color: Red",1,19.99  ,19.99  ,"46,868.38  "
FireWrap® Grip Kit Red,09/28/2021,Sales Receipt,6187,,"FIREWRAP® GRIP KIT
Color: Red",1,19.99  ,19.99  ,"46,888.37  "
FireWrap® Grip Kit Red,09/28/2021,Sales Receipt,6188,,"FIREWRAP® GRIP KIT
Color: Red",5,19.99  ,99.95  ,"46,988.32  "
FireWrap® Grip Kit Red,09/30/2021,Sales Receipt,6200,,"FIREWRAP® GRIP KIT
Color: Red",1,24.95  ,24.95  ,"47,013.27  "
FireWrap® Grip Kit Red,09/30/2021,Sales Receipt,6207,,"FIREWRAP® GRIP KIT
Color: Red",6,24.95  ,149.70  ,"47,162.97  "
FireWrap® Grip Kit Red,10/04/2021,Sales Receipt,6228,,"FIREWRAP® GRIP KIT
Color: Red",2,24.95  ,49.90  ,"47,212.87  "
FireWrap® Grip Kit Red,10/06/2021,Sales Receipt,6252,,"FIREWRAP® GRIP KIT
Color: Red",1,24.95  ,24.95  ,"47,237.82  "
FireWrap® Grip Kit Red,10/12/2021,Sales Receipt,6286,,"FIREWRAP® GRIP KIT
Color: Red",1,24.95  ,24.95  ,"47,262.77  "
FireWrap® Grip Kit Red,10/12/2021,Sales Receipt,6285,,"FIREWRAP® GRIP KIT
Color: Red",2,24.95  ,49.90  ,"47,312.67  "
FireWrap® Grip Kit Red,10/15/2021,Sales Receipt,6304,,"FIREWRAP® GRIP KIT
Color: Red",1,24.95  ,24.95  ,"47,337.62  "
FireWrap® Grip Kit Red,10/15/2021,Sales Receipt,6310,,"FIREWRAP® GRIP KIT
Color: Red",1,24.95  ,24.95  ,"47,362.57  "
FireWrap® Grip Kit Red,10/15/2021,Sales Receipt,6306,,"FIREWRAP® GRIP KIT
Color: Red",1,24.95  ,24.95  ,"47,387.52  "
FireWrap® Grip Kit Red,10/15/2021,Sales Receipt,6309,,"FIREWRAP® GRIP KIT
Color: Red",1,24.95  ,24.95  ,"47,412.47  "
FireWrap® Grip Kit Red,10/16/2021,Sales Receipt,6313,,"FIREWRAP® GRIP KIT
Color: Red",1,24.95  ,24.95  ,"47,437.42  "
FireWrap® Grip Kit Red,10/16/2021,Sales Receipt,6317,,"FIREWRAP® GRIP KIT
Color: Red",1,24.95  ,24.95  ,"47,462.37  "
FireWrap® Grip Kit Red,10/16/2021,Sales Receipt,6314,,"FIREWRAP® GRIP KIT
Color: Red",1,24.95  ,24.95  ,"47,487.32  "
FireWrap® Grip Kit Red,10/22/2021,Sales Receipt,6353,,"FIREWRAP® GRIP KIT
Color: Red",2,24.95  ,49.90  ,"47,537.22  "
FireWrap® Grip Kit Red,10/25/2021,Sales Receipt,6364,,"FIREWRAP® GRIP KIT
Color: Red",1,24.95  ,24.95  ,"47,562.17  "
FireWrap® Grip Kit Red,10/30/2021,Sales Receipt,6396,,"FIREWRAP® GRIP KIT
Color: Red",1,24.95  ,24.95  ,"47,587.12  "
FireWrap® Grip Kit Red,10/31/2021,Sales Receipt,6400,,"FIREWRAP® GRIP KIT
Color: Red",1,24.95  ,24.95  ,"47,612.07  "
FireWrap® Grip Kit Red,11/01/2021,Sales Receipt,6415,,"FIREWRAP® GRIP KIT
Color: Red",1,24.95  ,24.95  ,"47,637.02  "
FireWrap® Grip Kit Red,11/01/2021,Sales Receipt,6416,,"FIREWRAP® GRIP KIT
Color: Red",1,24.95  ,24.95  ,"47,661.97  "
FireWrap® Grip Kit Red,11/01/2021,Sales Receipt,6414,,"FIREWRAP® GRIP KIT
Color: Red",1,24.95  ,24.95  ,"47,686.92  "
FireWrap® Grip Kit Red,11/02/2021,Sales Receipt,6421,,"FIREWRAP® GRIP KIT
Color: Red",4,24.95  ,99.80  ,"47,786.72  "
FireWrap® Grip Kit Red,11/03/2021,Sales Receipt,6425,,"FIREWRAP® GRIP KIT
Color: Red",1,24.95  ,24.95  ,"47,811.67  "
FireWrap® Grip Kit Red,11/03/2021,Sales Receipt,6427,,"FIREWRAP® GRIP KIT
Color: Red",2,24.95  ,49.90  ,"47,861.57  "
FireWrap® Grip Kit Red,11/04/2021,Sales Receipt,6429,,"FIREWRAP® GRIP KIT
Color: Red",2,24.95  ,49.90  ,"47,911.47  "
FireWrap® Grip Kit Red,11/09/2021,Sales Receipt,6457,,"FIREWRAP® GRIP KIT
Color: Red",2,24.95  ,49.90  ,"47,961.37  "
FireWrap® Grip Kit Red,11/09/2021,Sales Receipt,6452,,"FIREWRAP® GRIP KIT
Color: Red",1,24.95  ,24.95  ,"47,986.32  "
FireWrap® Grip Kit Red,11/10/2021,Sales Receipt,6474,,"FIREWRAP® GRIP KIT
Color: Red",5,24.95  ,124.75  ,"48,111.07  "
FireWrap® Grip Kit Red,11/10/2021,Sales Receipt,6469,,"FIREWRAP® GRIP KIT
Color: Red",1,24.95  ,24.95  ,"48,136.02  "
FireWrap® Grip Kit Red,11/10/2021,Sales Receipt,6467,,"FIREWRAP® GRIP KIT
Color: Red",1,24.95  ,24.95  ,"48,160.97  "
FireWrap® Grip Kit Red,11/12/2021,Sales Receipt,6483,,"FIREWRAP® GRIP KIT
Color: Red",1,24.95  ,24.95  ,"48,185.92  "
FireWrap® Grip Kit Red,11/13/2021,Sales Receipt,6494,,"FIREWRAP® GRIP KIT
Color: Red",4,24.95  ,99.80  ,"48,285.72  "
FireWrap® Grip Kit Red,11/13/2021,Sales Receipt,6493,,"FIREWRAP® GRIP KIT
Color: Red",3,24.95  ,74.85  ,"48,360.57  "
FireWrap® Grip Kit Red,11/14/2021,Sales Receipt,6501,,"FIREWRAP® GRIP KIT
Color: Red",1,24.95  ,24.95  ,"48,385.52  "
FireWrap® Grip Kit Red,11/14/2021,Sales Receipt,6509,,"FIREWRAP® GRIP KIT
Color: Red",3,24.95  ,74.85  ,"48,460.37  "
FireWrap® Grip Kit Red,11/15/2021,Sales Receipt,6515,,"FIREWRAP® GRIP KIT
Color: Red",1,24.95  ,24.95  ,"48,485.32  "
FireWrap® Grip Kit Red,11/19/2021,Sales Receipt,6539,,"FIREWRAP® GRIP KIT
Color: Red",1,24.95  ,24.95  ,"48,510.27  "
FireWrap® Grip Kit Red,11/25/2021,Sales Receipt,6588,,"FIREWRAP® GRIP KIT
Color: Red",1,19.99  ,19.99  ,"48,530.26  "
FireWrap® Grip Kit Red,11/25/2021,Sales Receipt,6587,,"FIREWRAP® GRIP KIT
Color: Red",1,19.99  ,19.99  ,"48,550.25  "
FireWrap® Grip Kit Red,11/26/2021,Sales Receipt,6604,,"FIREWRAP® GRIP KIT
Color: Red",1,19.99  ,19.99  ,"48,570.24  "
FireWrap® Grip Kit Red,11/27/2021,Sales Receipt,6606,,"FIREWRAP® GRIP KIT
Color: Red",1,19.99  ,19.99  ,"48,590.23  "
FireWrap® Grip Kit Red,11/28/2021,Sales Receipt,6614,,"FIREWRAP® GRIP KIT
Color: Red",1,19.99  ,19.99  ,"48,610.22  "
FireWrap® Grip Kit Red,11/28/2021,Sales Receipt,6618,,"FIREWRAP® GRIP KIT
Color: Red",1,19.99  ,19.99  ,"48,630.21  "
FireWrap® Grip Kit Red,11/29/2021,Sales Receipt,6625,,"FIREWRAP® GRIP KIT
Color: Red",1,19.99  ,19.99  ,"48,650.20  "
FireWrap® Grip Kit Red,12/01/2021,Sales Receipt,6640,,"FIREWRAP® GRIP KIT
Color: Red",2,19.99  ,39.98  ,"48,690.18  "
FireWrap® Grip Kit Red,12/02/2021,Sales Receipt,6648,,"FIREWRAP® GRIP KIT
Color: Red",1,19.99  ,19.99  ,"48,710.17  "
FireWrap® Grip Kit Red,12/02/2021,Sales Receipt,6644,,"FIREWRAP® GRIP KIT
Color: Red",10,19.99  ,199.90  ,"48,910.07  "
FireWrap® Grip Kit Red,12/02/2021,Sales Receipt,6651,,"FIREWRAP® GRIP KIT
Color: Red",1,19.99  ,19.99  ,"48,930.06  "
FireWrap® Grip Kit Red,12/02/2021,Sales Receipt,6645,,"FIREWRAP® GRIP KIT
Color: Red",1,19.99  ,19.99  ,"48,950.05  "
FireWrap® Grip Kit Red,12/02/2021,Sales Receipt,6650,,"FIREWRAP® GRIP KIT
Color: Red",2,19.99  ,39.98  ,"48,990.03  "
FireWrap® Grip Kit Red,12/05/2021,Sales Receipt,6675,,"FIREWRAP® GRIP KIT
Color: Red",2,19.99  ,39.98  ,"49,030.01  "
FireWrap® Grip Kit Red,12/06/2021,Sales Receipt,6678,,"FIREWRAP® GRIP KIT
Color: Red",1,19.99  ,19.99  ,"49,050.00  "
FireWrap® Grip Kit Red,12/13/2021,Sales Receipt,6735,,"FIREWRAP® GRIP KIT
Color: Red",1,24.95  ,24.95  ,"49,074.95  "
FireWrap® Grip Kit Red,12/14/2021,Sales Receipt,6741,,"FIREWRAP® GRIP KIT
Color: Red",1,24.95  ,24.95  ,"49,099.90  "
FireWrap® Grip Kit Red,12/14/2021,Sales Receipt,6739,,"FIREWRAP® GRIP KIT
Color: Red",6,24.95  ,149.70  ,"49,249.60  "
FireWrap® Grip Kit Red,12/15/2021,Sales Receipt,6749,,"FIREWRAP® GRIP KIT
Color: Red",1,24.95  ,24.95  ,"49,274.55  "
FireWrap® Grip Kit Red,12/15/2021,Sales Receipt,6744,,"FIREWRAP® GRIP KIT
Color: Red",3,24.95  ,74.85  ,"49,349.40  "
FireWrap® Grip Kit Red,12/15/2021,Sales Receipt,6747,,"FIREWRAP® GRIP KIT
Color: Red",1,24.95  ,24.95  ,"49,374.35  "
FireWrap® Grip Kit Red,12/16/2021,Sales Receipt,6753,,"FIREWRAP® GRIP KIT
Color: Red",8,24.95  ,199.60  ,"49,573.95  "
FireWrap® Grip Kit Red,12/16/2021,Sales Receipt,6757,,"FIREWRAP® GRIP KIT
Color: Red",1,24.95  ,24.95  ,"49,598.90  "
FireWrap® Grip Kit Red,12/17/2021,Sales Receipt,6766,,"FIREWRAP® GRIP KIT
Color: Red",1,24.95  ,24.95  ,"49,623.85  "
FireWrap® Grip Kit Red,12/17/2021,Sales Receipt,6767,,"FIREWRAP® GRIP KIT
Color: Red",1,24.95  ,24.95  ,"49,648.80  "
FireWrap® Grip Kit Red,12/17/2021,Sales Receipt,6763,,"FIREWRAP® GRIP KIT
Color: Red",1,24.95  ,24.95  ,"49,673.75  "
FireWrap® Grip Kit Red,12/19/2021,Sales Receipt,6784,,"FIREWRAP® GRIP KIT
Color: Red",2,24.95  ,49.90  ,"49,723.65  "
FireWrap® Grip Kit Red,12/21/2021,Sales Receipt,6795,,"FIREWRAP® GRIP KIT
Color: Red",2,24.95  ,49.90  ,"49,773.55  "
FireWrap® Grip Kit Red,12/22/2021,Sales Receipt,6800,,"FIREWRAP® GRIP KIT
Color: Red",1,24.95  ,24.95  ,"49,798.50  "
FireWrap® Grip Kit Red,12/24/2021,Sales Receipt,6813,,"FIREWRAP® GRIP KIT
Color: Red",7,24.95  ,174.65  ,"49,973.15  "
FireWrap® Grip Kit Red,12/24/2021,Sales Receipt,6814,,"FIREWRAP® GRIP KIT
Color: Red",1,24.95  ,24.95  ,"49,998.10  "
FireWrap® Grip Kit Red,12/24/2021,Sales Receipt,6811,,"FIREWRAP® GRIP KIT
Color: Red",1,24.95  ,24.95  ,"50,023.05  "
FireWrap® Grip Kit Red,12/27/2021,Sales Receipt,6841,,"FIREWRAP® GRIP KIT
Color: Red",1,24.95  ,24.95  ,"50,048.00  "
FireWrap® Grip Kit Red,12/27/2021,Sales Receipt,6845,,"FIREWRAP® GRIP KIT
Color: Red",1,24.95  ,24.95  ,"50,072.95  "
FireWrap® Grip Kit Red,12/27/2021,Sales Receipt,6843,,"FIREWRAP® GRIP KIT
Color: Red",1,24.95  ,24.95  ,"50,097.90  "
FireWrap® Grip Kit Red,12/28/2021,Sales Receipt,6850,,"FIREWRAP® GRIP KIT
Color: Red",8,24.95  ,199.60  ,"50,297.50  "
FireWrap® Grip Kit Red,12/30/2021,Sales Receipt,6862,,"FIREWRAP® GRIP KIT
Color: Red",1,24.95  ,24.95  ,"50,322.45  "
FireWrap® Grip Kit Red,12/30/2021,Sales Receipt,6873,,"FIREWRAP® GRIP KIT
Color: Red",1,24.95  ,24.95  ,"50,347.40  "
FireWrap® Grip Kit Red,12/30/2021,Sales Receipt,6872,,"FIREWRAP® GRIP KIT
Color: Red",1,24.95  ,24.95  ,"50,372.35  "
FireWrap® Grip Kit Red,12/30/2021,Sales Receipt,6863,,"FIREWRAP® GRIP KIT
Color: Red",3,24.95  ,74.85  ,"50,447.20  "
FireWrap® Grip Kit Red,12/31/2021,Sales Receipt,6882,,"FIREWRAP® GRIP KIT
Color: Red",1,24.95  ,24.95  ,"50,472.15  "
FireWrap® Grip Kit Red,01/02/2022,Sales Receipt,6894,,"FIREWRAP® GRIP KIT
Color: Red",1,24.95  ,24.95  ,"50,497.10  "
FireWrap® Grip Kit Red,01/03/2022,Sales Receipt,6900,,"FIREWRAP® GRIP KIT
Color: Red",10,24.95  ,249.50  ,"50,746.60  "
FireWrap® Grip Kit Red,01/05/2022,Sales Receipt,6919,,"FIREWRAP® GRIP KIT
Color: Red",8,24.95  ,199.60  ,"50,946.20  "
FireWrap® Grip Kit Red,01/06/2022,Sales Receipt,6930,,"FIREWRAP® GRIP KIT
Color: Red",1,24.95  ,24.95  ,"50,971.15  "
FireWrap® Grip Kit Red,01/07/2022,Sales Receipt,6942,,"FIREWRAP® GRIP KIT
Color: Red",1,24.95  ,24.95  ,"50,996.10  "
FireWrap® Grip Kit Red,01/07/2022,Sales Receipt,6944,,"FIREWRAP® GRIP KIT
Color: Red",2,24.95  ,49.90  ,"51,046.00  "
FireWrap® Grip Kit Red,01/08/2022,Sales Receipt,6952,,"FIREWRAP® GRIP KIT
Color: Red",1,24.95  ,24.95  ,"51,070.95  "
FireWrap® Grip Kit Red,01/08/2022,Sales Receipt,6956,,"FIREWRAP® GRIP KIT
Color: Red",1,24.95  ,24.95  ,"51,095.90  "
FireWrap® Grip Kit Red,01/09/2022,Sales Receipt,6966,,"FIREWRAP® GRIP KIT
Color: Red",1,24.95  ,24.95  ,"51,120.85  "
FireWrap® Grip Kit Red,01/10/2022,Sales Receipt,6970,,"FIREWRAP® GRIP KIT
Color: Red",2,24.95  ,49.90  ,"51,170.75  "
FireWrap® Grip Kit Red,01/11/2022,Sales Receipt,6982,,"FIREWRAP® GRIP KIT
Color: Red",5,24.95  ,124.75  ,"51,295.50  "
FireWrap® Grip Kit Red,01/13/2022,Sales Receipt,6996,,"FIREWRAP® GRIP KIT
Color: Red",1,24.95  ,24.95  ,"51,320.45  "
FireWrap® Grip Kit Red,01/13/2022,Sales Receipt,6999,,"FIREWRAP® GRIP KIT
Color: Red",1,24.95  ,24.95  ,"51,345.40  "
FireWrap® Grip Kit Red,01/15/2022,Sales Receipt,7011,,"FIREWRAP® GRIP KIT
Color: Red",1,24.95  ,24.95  ,"51,370.35  "
FireWrap® Grip Kit Red,01/15/2022,Sales Receipt,7012,,"FIREWRAP® GRIP KIT
Color: Red",1,24.95  ,24.95  ,"51,395.30  "
FireWrap® Grip Kit Red,01/17/2022,Sales Receipt,7023,,"FIREWRAP® GRIP KIT
Color: Red",1,24.95  ,24.95  ,"51,420.25  "
FireWrap® Grip Kit Red,01/19/2022,Sales Receipt,7038,,"FIREWRAP® GRIP KIT
Color: Red",1,24.95  ,24.95  ,"51,445.20  "
FireWrap® Grip Kit Red,01/19/2022,Sales Receipt,7037,,"FIREWRAP® GRIP KIT
Color: Red",4,24.95  ,99.80  ,"51,545.00  "
FireWrap® Grip Kit Red,01/19/2022,Sales Receipt,7047,,"FIREWRAP® GRIP KIT
Color: Red",2,24.95  ,49.90  ,"51,594.90  "
FireWrap® Grip Kit Red,01/21/2022,Sales Receipt,7060,,"FIREWRAP® GRIP KIT
Color: Red",2,24.95  ,49.90  ,"51,644.80  "
FireWrap® Grip Kit Red,01/21/2022,Sales Receipt,7064,,"FIREWRAP® GRIP KIT
Color: Red",1,24.95  ,24.95  ,"51,669.75  "
FireWrap® Grip Kit Red,01/21/2022,Sales Receipt,7058,,"FIREWRAP® GRIP KIT
Color: Red",1,24.95  ,24.95  ,"51,694.70  "
FireWrap® Grip Kit Red,01/21/2022,Sales Receipt,7061,,"FIREWRAP® GRIP KIT
Color: Red",1,24.95  ,24.95  ,"51,719.65  "
FireWrap® Grip Kit Red,01/23/2022,Sales Receipt,7072,,"FIREWRAP® GRIP KIT
Color: Red",1,24.95  ,24.95  ,"51,744.60  "
FireWrap® Grip Kit Red,01/25/2022,Sales Receipt,7087,,"FIREWRAP® GRIP KIT
Color: Red",2,24.95  ,49.90  ,"51,794.50  "
FireWrap® Grip Kit Red,01/25/2022,Sales Receipt,7097,,"FIREWRAP® GRIP KIT
Color: Red",1,24.95  ,24.95  ,"51,819.45  "
FireWrap® Grip Kit Red,01/27/2022,Sales Receipt,7120,,"FIREWRAP® GRIP KIT
Color: Red",2,24.95  ,49.90  ,"51,869.35  "
FireWrap® Grip Kit Red,01/28/2022,Sales Receipt,7135,,"FIREWRAP® GRIP KIT
Color: Red",5,24.95  ,124.75  ,"51,994.10  "
FireWrap® Grip Kit Red,01/28/2022,Sales Receipt,7134,,"FIREWRAP® GRIP KIT
Color: Red",1,24.95  ,24.95  ,"52,019.05  "
FireWrap® Grip Kit Red,01/28/2022,Sales Receipt,7138,,"FIREWRAP® GRIP KIT
Color: Red",1,24.95  ,24.95  ,"52,044.00  "
FireWrap® Grip Kit Red,01/30/2022,Sales Receipt,7154,,"FIREWRAP® GRIP KIT
Color: Red",1,24.95  ,24.95  ,"52,068.95  "
FireWrap® Grip Kit Red,01/31/2022,Sales Receipt,7165,,"FIREWRAP® GRIP KIT
Color: Red",1,24.95  ,24.95  ,"52,093.90  "
FireWrap® Grip Kit Red,02/02/2022,Sales Receipt,7182,,"FIREWRAP® GRIP KIT
Color: Red",1,27.95  ,27.95  ,"52,121.85  "
FireWrap® Grip Kit Red,02/03/2022,Sales Receipt,7192,,"FIREWRAP® GRIP KIT
Color: Red",1,27.95  ,27.95  ,"52,149.80  "
FireWrap® Grip Kit Red,02/03/2022,Sales Receipt,7188,,"FIREWRAP® GRIP KIT
Color: Red",1,27.95  ,27.95  ,"52,177.75  "
FireWrap® Grip Kit Red,02/05/2022,Sales Receipt,7202,,"FIREWRAP® GRIP KIT
Color: Red",1,27.95  ,27.95  ,"52,205.70  "
FireWrap® Grip Kit Red,02/05/2022,Sales Receipt,7198,,"FIREWRAP® GRIP KIT
Color: Red",1,27.95  ,27.95  ,"52,233.65  "
FireWrap® Grip Kit Red,02/06/2022,Sales Receipt,7210,,"FIREWRAP® GRIP KIT
Color: Red",1,27.95  ,27.95  ,"52,261.60  "
FireWrap® Grip Kit Red,02/07/2022,Sales Receipt,7222,,"FIREWRAP® GRIP KIT
Color: Red",1,27.95  ,27.95  ,"52,289.55  "
FireWrap® Grip Kit Red,02/07/2022,Sales Receipt,7217,,"FIREWRAP® GRIP KIT
Color: Red",12,27.95  ,335.40  ,"52,624.95  "
FireWrap® Grip Kit Red,02/07/2022,Sales Receipt,7219,,"FIREWRAP® GRIP KIT
Color: Red",2,27.95  ,55.90  ,"52,680.85  "
FireWrap® Grip Kit Red,02/07/2022,Sales Receipt,7218,,"FIREWRAP® GRIP KIT
Color: Red",1,27.95  ,27.95  ,"52,708.80  "
FireWrap® Grip Kit Red,02/09/2022,Sales Receipt,7245,,"FIREWRAP® GRIP KIT
Color: Red",1,27.95  ,27.95  ,"52,736.75  "
FireWrap® Grip Kit Red,02/09/2022,Sales Receipt,7241,,"FIREWRAP® GRIP KIT
Color: Red",1,27.95  ,27.95  ,"52,764.70  "
FireWrap® Grip Kit Red,02/09/2022,Sales Receipt,7247,,"FIREWRAP® GRIP KIT
Color: Red",5,27.95  ,139.75  ,"52,904.45  "
FireWrap® Grip Kit Red,02/09/2022,Sales Receipt,7238,,"FIREWRAP® GRIP KIT
Color: Red",1,27.95  ,27.95  ,"52,932.40  "
FireWrap® Grip Kit Red,02/10/2022,Sales Receipt,7258,,"FIREWRAP® GRIP KIT
Color: Red",1,27.95  ,27.95  ,"52,960.35  "
FireWrap® Grip Kit Red,02/11/2022,Sales Receipt,7268,,"FIREWRAP® GRIP KIT
Color: Red",1,27.95  ,27.95  ,"52,988.30  "
FireWrap® Grip Kit Red,02/11/2022,Sales Receipt,7266,,"FIREWRAP® GRIP KIT
Color: Red",1,27.95  ,27.95  ,"53,016.25  "
FireWrap® Grip Kit Red,02/11/2022,Sales Receipt,7265,,"FIREWRAP® GRIP KIT
Color: Red",1,27.95  ,27.95  ,"53,044.20  "
FireWrap® Grip Kit Red,02/18/2022,Sales Receipt,7311,,"FIREWRAP® GRIP KIT
Color: Red",1,27.95  ,27.95  ,"53,072.15  "
FireWrap® Grip Kit Red,02/19/2022,Sales Receipt,7324,,"FIREWRAP® GRIP KIT
Color: Red",1,27.95  ,27.95  ,"53,100.10  "
FireWrap® Grip Kit Red,02/19/2022,Sales Receipt,7325,,"FIREWRAP® GRIP KIT
Color: Red",2,27.95  ,55.90  ,"53,156.00  "
FireWrap® Grip Kit Red,02/20/2022,Sales Receipt,7331,,"FIREWRAP® GRIP KIT
Color: Red",1,27.95  ,27.95  ,"53,183.95  "
FireWrap® Grip Kit Red,02/21/2022,Sales Receipt,7342,,"FIREWRAP® GRIP KIT
Color: Red",1,27.95  ,27.95  ,"53,211.90  "
FireWrap® Grip Kit Red,02/21/2022,Sales Receipt,7344,,"FIREWRAP® GRIP KIT
Color: Red",1,27.95  ,27.95  ,"53,239.85  "
FireWrap® Grip Kit Red,02/21/2022,Sales Receipt,7349,,"FIREWRAP® GRIP KIT
Color: Red",1,27.95  ,27.95  ,"53,267.80  "
FireWrap® Grip Kit Red,02/22/2022,Sales Receipt,7360,,"FIREWRAP® GRIP KIT
Color: Red",1,27.95  ,27.95  ,"53,295.75  "
FireWrap® Grip Kit Red,02/23/2022,Sales Receipt,7369,,"FIREWRAP® GRIP KIT
Color: Red",1,27.95  ,27.95  ,"53,323.70  "
FireWrap® Grip Kit Red,02/23/2022,Sales Receipt,7371,,"FIREWRAP® GRIP KIT
Color: Red",1,27.95  ,27.95  ,"53,351.65  "
FireWrap® Grip Kit Red,02/23/2022,Sales Receipt,7372,,"FIREWRAP® GRIP KIT
Color: Red",4,27.95  ,111.80  ,"53,463.45  "
FireWrap® Grip Kit Red,02/24/2022,Sales Receipt,7382,,"FIREWRAP® GRIP KIT
Color: Red",1,27.95  ,27.95  ,"53,491.40  "
FireWrap® Grip Kit Red,02/24/2022,Sales Receipt,7384,,"FIREWRAP® GRIP KIT
Color: Red",1,27.95  ,27.95  ,"53,519.35  "
FireWrap® Grip Kit Red,02/24/2022,Sales Receipt,7373,,"FIREWRAP® GRIP KIT
Color: Red",2,27.95  ,55.90  ,"53,575.25  "
FireWrap® Grip Kit Red,02/26/2022,Sales Receipt,7398,,"FIREWRAP® GRIP KIT
Color: Red",2,27.95  ,55.90  ,"53,631.15  "
FireWrap® Grip Kit Red,02/27/2022,Sales Receipt,7403,,"FIREWRAP® GRIP KIT
Color: Red",1,27.95  ,27.95  ,"53,659.10  "
FireWrap® Grip Kit Red,02/27/2022,Sales Receipt,7412,,"FIREWRAP® GRIP KIT
Color: Red",1,27.95  ,27.95  ,"53,687.05  "
FireWrap® Grip Kit Red,02/27/2022,Sales Receipt,7411,,"FIREWRAP® GRIP KIT
Color: Red",3,27.95  ,83.85  ,"53,770.90  "
FireWrap® Grip Kit Red,02/28/2022,Sales Receipt,7419,,"FIREWRAP® GRIP KIT
Color: Red",1,27.95  ,27.95  ,"53,798.85  "
FireWrap® Grip Kit Red,02/28/2022,Sales Receipt,7428,,"FIREWRAP® GRIP KIT
Color: Red",1,27.95  ,27.95  ,"53,826.80  "
FireWrap® Grip Kit Red,03/01/2022,Sales Receipt,7434,,"FIREWRAP® GRIP KIT
Color: Red",1,27.95  ,27.95  ,"53,854.75  "
FireWrap® Grip Kit Red,03/02/2022,Sales Receipt,7451,,"FIREWRAP® GRIP KIT
Color: Red",1,27.95  ,27.95  ,"53,882.70  "
FireWrap® Grip Kit Red,03/02/2022,Sales Receipt,7447,,"FIREWRAP® GRIP KIT
Color: Red",1,27.95  ,27.95  ,"53,910.65  "
FireWrap® Grip Kit Red,03/03/2022,Sales Receipt,7461,,"FIREWRAP® GRIP KIT
Color: Red",1,27.95  ,27.95  ,"53,938.60  "
FireWrap® Grip Kit Red,03/03/2022,Sales Receipt,7458,,"FIREWRAP® GRIP KIT
Color: Red",1,27.95  ,27.95  ,"53,966.55  "
FireWrap® Grip Kit Red,03/04/2022,Sales Receipt,7469,,"FIREWRAP® GRIP KIT
Color: Red",1,27.95  ,27.95  ,"53,994.50  "
FireWrap® Grip Kit Red,03/04/2022,Sales Receipt,7466,,"FIREWRAP® GRIP KIT
Color: Red",2,27.95  ,55.90  ,"54,050.40  "
FireWrap® Grip Kit Red,03/05/2022,Sales Receipt,7474,,"FIREWRAP® GRIP KIT
Color: Red",1,27.95  ,27.95  ,"54,078.35  "
FireWrap® Grip Kit Red,03/05/2022,Sales Receipt,7473,,"FIREWRAP® GRIP KIT
Color: Red",8,27.95  ,223.60  ,"54,301.95  "
FireWrap® Grip Kit Red,03/07/2022,Sales Receipt,7489,,"FIREWRAP® GRIP KIT
Color: Red",1,27.95  ,27.95  ,"54,329.90  "
FireWrap® Grip Kit Red,03/07/2022,Sales Receipt,7492,,"FIREWRAP® GRIP KIT
Color: Red",1,27.95  ,27.95  ,"54,357.85  "
FireWrap® Grip Kit Red,03/07/2022,Sales Receipt,7499,,"FIREWRAP® GRIP KIT
Color: Red",4,27.95  ,111.80  ,"54,469.65  "
FireWrap® Grip Kit Red,03/08/2022,Sales Receipt,7504,,"FIREWRAP® GRIP KIT
Color: Red",1,27.95  ,27.95  ,"54,497.60  "
FireWrap® Grip Kit Red,03/08/2022,Sales Receipt,7505,,"FIREWRAP® GRIP KIT
Color: Red",1,27.95  ,27.95  ,"54,525.55  "
FireWrap® Grip Kit Red,03/09/2022,Sales Receipt,7507,,"FIREWRAP® GRIP KIT
Color: Red",1,27.95  ,27.95  ,"54,553.50  "
FireWrap® Grip Kit Red,03/10/2022,Sales Receipt,7510,,"FIREWRAP® GRIP KIT
Color: Red",6,27.95  ,167.70  ,"54,721.20  "
FireWrap® Grip Kit Red,03/10/2022,Sales Receipt,7509,,"FIREWRAP® GRIP KIT
Color: Red",1,27.95  ,27.95  ,"54,749.15  "
FireWrap® Grip Kit Red,03/11/2022,Sales Receipt,7514,,"FIREWRAP® GRIP KIT
Color: Red",1,27.95  ,27.95  ,"54,777.10  "
FireWrap® Grip Kit Red,03/12/2022,Sales Receipt,7524,,"FIREWRAP® GRIP KIT
Color: Red",1,27.95  ,27.95  ,"54,805.05  "
FireWrap® Grip Kit Red,03/15/2022,Sales Receipt,7546,,"FIREWRAP® GRIP KIT
Color: Red",1,27.95  ,27.95  ,"54,833.00  "
FireWrap® Grip Kit Red,03/17/2022,Sales Receipt,7553,,"FIREWRAP® GRIP KIT
Color: Red",2,27.95  ,55.90  ,"54,888.90  "
FireWrap® Grip Kit Red,03/18/2022,Sales Receipt,7561,,"FIREWRAP® GRIP KIT
Color: Red",1,27.95  ,27.95  ,"54,916.85  "
FireWrap® Grip Kit Red,03/21/2022,Sales Receipt,7594,,"FIREWRAP® GRIP KIT
Color: Red",1,27.95  ,27.95  ,"54,944.80  "
FireWrap® Grip Kit Red,03/23/2022,Sales Receipt,7607,,"FIREWRAP® GRIP KIT
Color: Red",1,27.95  ,27.95  ,"54,972.75  "
FireWrap® Grip Kit Red,03/24/2022,Sales Receipt,7610,,"FIREWRAP® GRIP KIT
Color: Red",1,27.95  ,27.95  ,"55,000.70  "
FireWrap® Grip Kit Red,03/29/2022,Sales Receipt,7650,,"FIREWRAP® GRIP KIT
Color: Red",6,27.95  ,167.70  ,"55,168.40  "
FireWrap® Grip Kit Red,03/30/2022,Sales Receipt,7657,,"FIREWRAP® GRIP KIT
Color: Red",1,27.95  ,27.95  ,"55,196.35  "
FireWrap® Grip Kit Red,04/01/2022,Sales Receipt,7671,,"FIREWRAP® GRIP KIT
Color: Red",1,27.95  ,27.95  ,"55,224.30  "
FireWrap® Grip Kit Red,04/02/2022,Sales Receipt,7674,,"FIREWRAP® GRIP KIT
Color: Red",1,27.95  ,27.95  ,"55,252.25  "
FireWrap® Grip Kit Red,04/04/2022,Sales Receipt,7688,,"FIREWRAP® GRIP KIT
Color: Red",8,27.95  ,223.60  ,"55,475.85  "
FireWrap® Grip Kit Red,04/06/2022,Sales Receipt,7697,,"FIREWRAP® GRIP KIT
Color: Red",4,27.95  ,111.80  ,"55,587.65  "
FireWrap® Grip Kit Red,04/07/2022,Sales Receipt,7712,,"FIREWRAP® GRIP KIT
Color: Red",1,27.95  ,27.95  ,"55,615.60  "
FireWrap® Grip Kit Red,04/09/2022,Sales Receipt,7724,,"FIREWRAP® GRIP KIT
Color: Red",1,27.95  ,27.95  ,"55,643.55  "
FireWrap® Grip Kit Red,04/10/2022,Sales Receipt,7728,,"FIREWRAP® GRIP KIT
Color: Red",1,27.95  ,27.95  ,"55,671.50  "
FireWrap® Grip Kit Red,04/11/2022,Sales Receipt,7735,,"FIREWRAP® GRIP KIT
Color: Red",2,27.95  ,55.90  ,"55,727.40  "
FireWrap® Grip Kit Red,04/11/2022,Sales Receipt,7739,,"FIREWRAP® GRIP KIT
Color: Red",1,27.95  ,27.95  ,"55,755.35  "
FireWrap® Grip Kit Red,04/11/2022,Sales Receipt,7734,,"FIREWRAP® GRIP KIT
Color: Red",1,27.95  ,27.95  ,"55,783.30  "
FireWrap® Grip Kit Red,04/18/2022,Sales Receipt,7772,,"FIREWRAP® GRIP KIT
Color: Red",1,27.95  ,27.95  ,"55,811.25  "
FireWrap® Grip Kit Red,04/20/2022,Sales Receipt,7788,,"FIREWRAP® GRIP KIT
Color: Red",1,27.95  ,27.95  ,"55,839.20  "
FireWrap® Grip Kit Red,04/20/2022,Sales Receipt,7785,,"FIREWRAP® GRIP KIT
Color: Red",2,27.95  ,55.90  ,"55,895.10  "
FireWrap® Grip Kit Red,04/23/2022,Sales Receipt,7801,,"FIREWRAP® GRIP KIT
Color: Red",1,27.95  ,27.95  ,"55,923.05  "
FireWrap® Grip Kit Red,04/25/2022,Sales Receipt,7812,,"FIREWRAP® GRIP KIT
Color: Red",1,27.95  ,27.95  ,"55,951.00  "
FireWrap® Grip Kit Red,04/26/2022,Sales Receipt,7818,,"FIREWRAP® GRIP KIT
Color: Red",20,27.95  ,559.00  ,"56,510.00  "
FireWrap® Grip Kit Red,04/27/2022,Sales Receipt,7821,,"FIREWRAP® GRIP KIT
Color: Red",1,27.95  ,27.95  ,"56,537.95  "
FireWrap® Grip Kit Red,04/28/2022,Sales Receipt,7837,,"FIREWRAP® GRIP KIT
Color: Red",1,22.95  ,22.95  ,"56,560.90  "
FireWrap® Grip Kit Red,04/29/2022,Sales Receipt,7842,,"FIREWRAP® GRIP KIT
Color: Red",2,22.95  ,45.90  ,"56,606.80  "
FireWrap® Grip Kit Red,04/29/2022,Sales Receipt,7839,,"FIREWRAP® GRIP KIT
Color: Red",4,22.95  ,91.80  ,"56,698.60  "
FireWrap® Grip Kit Red,05/01/2022,Sales Receipt,7865,,"FIREWRAP® GRIP KIT
Color: Red",1,22.95  ,22.95  ,"56,721.55  "
FireWrap® Grip Kit Red,05/02/2022,Sales Receipt,7877,,"FIREWRAP® GRIP KIT
Color: Red",1,22.95  ,22.95  ,"56,744.50  "
FireWrap® Grip Kit Red,05/02/2022,Sales Receipt,7871,,"FIREWRAP® GRIP KIT
Color: Red",1,22.95  ,22.95  ,"56,767.45  "
FireWrap® Grip Kit Red,05/03/2022,Sales Receipt,7888,,"FIREWRAP® GRIP KIT
Color: Red",2,22.95  ,45.90  ,"56,813.35  "
FireWrap® Grip Kit Red,05/03/2022,Sales Receipt,7892,,"FIREWRAP® GRIP KIT
Color: Red",2,22.95  ,45.90  ,"56,859.25  "
FireWrap® Grip Kit Red,05/03/2022,Sales Receipt,7891,,"FIREWRAP® GRIP KIT
Color: Red",1,22.95  ,22.95  ,"56,882.20  "
FireWrap® Grip Kit Red,05/10/2022,Sales Receipt,7927,,"FIREWRAP® GRIP KIT
Color: Red",1,27.95  ,27.95  ,"56,910.15  "
FireWrap® Grip Kit Red,05/12/2022,Sales Receipt,7936,,"FIREWRAP® GRIP KIT
Color: Red",1,27.95  ,27.95  ,"56,938.10  "
FireWrap® Grip Kit Red,05/17/2022,Sales Receipt,7968,,"FIREWRAP® GRIP KIT
Color: Red",1,27.95  ,27.95  ,"56,966.05  "
FireWrap® Grip Kit Red,05/17/2022,Sales Receipt,7965,,"FIREWRAP® GRIP KIT
Color: Red",1,27.95  ,27.95  ,"56,994.00  "
FireWrap® Grip Kit Red,05/23/2022,Sales Receipt,7991,,"FIREWRAP® GRIP KIT
Color: Red",1,27.95  ,27.95  ,"57,021.95  "
FireWrap® Grip Kit Red,05/24/2022,Sales Receipt,7995,,"FIREWRAP® GRIP KIT
Color: Red",4,27.95  ,111.80  ,"57,133.75  "
FireWrap® Grip Kit Red,05/25/2022,Sales Receipt,8002,,"FIREWRAP® GRIP KIT
Color: Red",1,27.95  ,27.95  ,"57,161.70  "
FireWrap® Grip Kit Red,05/27/2022,Sales Receipt,8007,,"FIREWRAP® GRIP KIT
Color: Red",1,27.95  ,27.95  ,"57,189.65  "
FireWrap® Grip Kit Red,06/02/2022,Sales Receipt,8037,,"FIREWRAP® GRIP KIT
Color: Red",1,27.95  ,27.95  ,"57,217.60  "
FireWrap® Grip Kit Red,06/02/2022,Sales Receipt,8043,,"FIREWRAP® GRIP KIT
Color: Red",1,27.95  ,27.95  ,"57,245.55  "
FireWrap® Grip Kit Red,06/02/2022,Sales Receipt,8040,,"FIREWRAP® GRIP KIT
Color: Red",1,27.95  ,27.95  ,"57,273.50  "
FireWrap® Grip Kit Red,06/03/2022,Sales Receipt,8049,,"FIREWRAP® GRIP KIT
Color: Red",2,27.95  ,55.90  ,"57,329.40  "
FireWrap® Grip Kit Red,06/04/2022,Sales Receipt,8053,,"FIREWRAP® GRIP KIT
Color: Red",1,27.95  ,27.95  ,"57,357.35  "
FireWrap® Grip Kit Red,06/08/2022,Sales Receipt,8073,,"FIREWRAP® GRIP KIT
Color: Red",1,27.95  ,27.95  ,"57,385.30  "
FireWrap® Grip Kit Red,06/08/2022,Sales Receipt,8071,,"FIREWRAP® GRIP KIT
Color: Red",1,27.95  ,27.95  ,"57,413.25  "
FireWrap® Grip Kit Red,06/08/2022,Sales Receipt,8072,,"FIREWRAP® GRIP KIT
Color: Red",1,27.95  ,27.95  ,"57,441.20  "
FireWrap® Grip Kit Red,06/08/2022,Sales Receipt,8075,,"FIREWRAP® GRIP KIT
Color: Red",1,27.95  ,27.95  ,"57,469.15  "
FireWrap® Grip Kit Red,06/09/2022,Sales Receipt,8084,,"FIREWRAP® GRIP KIT
Color: Red",1,27.95  ,27.95  ,"57,497.10  "
FireWrap® Grip Kit Red,06/10/2022,Sales Receipt,8092,,"FIREWRAP® GRIP KIT
Color: Red",1,27.95  ,27.95  ,"57,525.05  "
FireWrap® Grip Kit Red,06/10/2022,Sales Receipt,8099,,"FIREWRAP® GRIP KIT
Color: Red",1,27.95  ,27.95  ,"57,553.00  "
FireWrap® Grip Kit Red,06/13/2022,Sales Receipt,8114,,"FIREWRAP® GRIP KIT
Color: Red",2,27.95  ,55.90  ,"57,608.90  "
FireWrap® Grip Kit Red,06/13/2022,Sales Receipt,8118,,"FIREWRAP® GRIP KIT
Color: Red",8,27.95  ,223.60  ,"57,832.50  "
FireWrap® Grip Kit Red,06/13/2022,Sales Receipt,8116,,"FIREWRAP® GRIP KIT
Color: Red",1,27.95  ,27.95  ,"57,860.45  "
FireWrap® Grip Kit Red,06/14/2022,Sales Receipt,8125,,"FIREWRAP® GRIP KIT
Color: Red",2,27.95  ,55.90  ,"57,916.35  "
FireWrap® Grip Kit Red,06/15/2022,Sales Receipt,8131,,"FIREWRAP® GRIP KIT
Color: Red",1,27.95  ,27.95  ,"57,944.30  "
FireWrap® Grip Kit Red,06/16/2022,Sales Receipt,8134,,"FIREWRAP® GRIP KIT
Color: Red",1,27.95  ,27.95  ,"57,972.25  "
FireWrap® Grip Kit Red,06/16/2022,Sales Receipt,8135,,"FIREWRAP® GRIP KIT
Color: Red",1,27.95  ,27.95  ,"58,000.20  "
FireWrap® Grip Kit Red,06/17/2022,Sales Receipt,8143,,"FIREWRAP® GRIP KIT
Color: Red",6,27.95  ,167.70  ,"58,167.90  "
FireWrap® Grip Kit Red,06/18/2022,Sales Receipt,8150,,"FIREWRAP® GRIP KIT
Color: Red",1,27.95  ,27.95  ,"58,195.85  "
FireWrap® Grip Kit Red,06/21/2022,Sales Receipt,8161,,"FIREWRAP® GRIP KIT
Color: Red",1,27.95  ,27.95  ,"58,223.80  "
FireWrap® Grip Kit Red,06/22/2022,Sales Receipt,8166,,"FIREWRAP® GRIP KIT
Color: Red",1,27.95  ,27.95  ,"58,251.75  "
FireWrap® Grip Kit Red,06/24/2022,Sales Receipt,8175,,"FIREWRAP® GRIP KIT
Color: Red",1,27.95  ,27.95  ,"58,279.70  "
FireWrap® Grip Kit Red,06/27/2022,Sales Receipt,8184,,"FIREWRAP® GRIP KIT
Color: Red",2,27.95  ,55.90  ,"58,335.60  "
FireWrap® Grip Kit Red,06/28/2022,Sales Receipt,8196,,"FIREWRAP® GRIP KIT
Color: Red",1,27.95  ,27.95  ,"58,363.55  "
FireWrap® Grip Kit Red,06/28/2022,Sales Receipt,8191,,"FIREWRAP® GRIP KIT
Color: Red",1,27.95  ,27.95  ,"58,391.50  "
FireWrap® Grip Kit Red,06/29/2022,Sales Receipt,8206,,"FIREWRAP® GRIP KIT
Color: Red",1,27.95  ,27.95  ,"58,419.45  "
FireWrap® Grip Kit Red,06/30/2022,Sales Receipt,8210,,"FIREWRAP® GRIP KIT
Color: Red",1,27.95  ,27.95  ,"58,447.40  "
FireWrap® Grip Kit Red,06/30/2022,Sales Receipt,8209,,"FIREWRAP® GRIP KIT
Color: Red",1,27.95  ,27.95  ,"58,475.35  "
FireWrap® Grip Kit Red,06/30/2022,Sales Receipt,8213,,"FIREWRAP® GRIP KIT
Color: Red",1,27.95  ,27.95  ,"58,503.30  "
FireWrap® Grip Kit Red,07/01/2022,Sales Receipt,8223,,"FIREWRAP® GRIP KIT
Color: Red",1,27.95  ,27.95  ,"58,531.25  "
FireWrap® Grip Kit Red,07/02/2022,Sales Receipt,8230,,"FIREWRAP® GRIP KIT
Color: Red",2,27.95  ,55.90  ,"58,587.15  "
FireWrap® Grip Kit Red,07/03/2022,Sales Receipt,8236,,"FIREWRAP® GRIP KIT
Color: Red",1,27.95  ,27.95  ,"58,615.10  "
FireWrap® Grip Kit Red,07/06/2022,Sales Receipt,8248,,"FIREWRAP® GRIP KIT
Color: Red",1,27.95  ,27.95  ,"58,643.05  "
FireWrap® Grip Kit Red,07/06/2022,Sales Receipt,8251,,"FIREWRAP® GRIP KIT
Color: Red",4,27.95  ,111.80  ,"58,754.85  "
FireWrap® Grip Kit Red,07/08/2022,Sales Receipt,8266,,"FIREWRAP® GRIP KIT
Color: Red",3,27.95  ,83.85  ,"58,838.70  "
FireWrap® Grip Kit Red,07/09/2022,Sales Receipt,8276,,"FIREWRAP® GRIP KIT
Color: Red",1,27.95  ,27.95  ,"58,866.65  "
FireWrap® Grip Kit Red,07/10/2022,Sales Receipt,8279,,"FIREWRAP® GRIP KIT
Color: Red",2,27.95  ,55.90  ,"58,922.55  "
FireWrap® Grip Kit Red,07/14/2022,Sales Receipt,8300,,"FIREWRAP® GRIP KIT
Color: Red",1,27.95  ,27.95  ,"58,950.50  "
FireWrap® Grip Kit Red,07/14/2022,Sales Receipt,8302,,"FIREWRAP® GRIP KIT
Color: Red",1,27.95  ,27.95  ,"58,978.45  "
FireWrap® Grip Kit Red,07/14/2022,Sales Receipt,8299,,"FIREWRAP® GRIP KIT
Color: Red",1,27.95  ,27.95  ,"59,006.40  "
FireWrap® Grip Kit Red,07/14/2022,Sales Receipt,8297,,"FIREWRAP® GRIP KIT
Color: Red",3,27.95  ,83.85  ,"59,090.25  "
FireWrap® Grip Kit Red,07/16/2022,Sales Receipt,8314,,"FIREWRAP® GRIP KIT
Color: Red",1,27.95  ,27.95  ,"59,118.20  "
FireWrap® Grip Kit Red,07/17/2022,Sales Receipt,8316,,"FIREWRAP® GRIP KIT
Color: Red",1,27.95  ,27.95  ,"59,146.15  "
FireWrap® Grip Kit Red,07/17/2022,Sales Receipt,8319,,"FIREWRAP® GRIP KIT
Color: Red",1,27.95  ,27.95  ,"59,174.10  "
FireWrap® Grip Kit Red,07/17/2022,Sales Receipt,8318,,"FIREWRAP® GRIP KIT
Color: Red",1,27.95  ,27.95  ,"59,202.05  "
FireWrap® Grip Kit Red,07/18/2022,Sales Receipt,8321,,"FIREWRAP® GRIP KIT
Color: Red",1,27.95  ,27.95  ,"59,230.00  "
FireWrap® Grip Kit Red,07/19/2022,Sales Receipt,8323,,"FIREWRAP® GRIP KIT
Color: Red",4,27.95  ,111.80  ,"59,341.80  "
FireWrap® Grip Kit Red,07/19/2022,Sales Receipt,8333,,"FIREWRAP® GRIP KIT
Color: Red",1,27.95  ,27.95  ,"59,369.75  "
FireWrap® Grip Kit Red,07/19/2022,Sales Receipt,8322,,"FIREWRAP® GRIP KIT
Color: Red",1,27.95  ,27.95  ,"59,397.70  "
FireWrap® Grip Kit Red,07/19/2022,Sales Receipt,8326,,"FIREWRAP® GRIP KIT
Color: Red",2,27.95  ,55.90  ,"59,453.60  "
FireWrap® Grip Kit Red,07/20/2022,Sales Receipt,8336,,"FIREWRAP® GRIP KIT
Color: Red",5,27.95  ,139.75  ,"59,593.35  "
FireWrap® Grip Kit Red,07/20/2022,Sales Receipt,8337,,"FIREWRAP® GRIP KIT
Color: Red",1,27.95  ,27.95  ,"59,621.30  "
FireWrap® Grip Kit Red,07/24/2022,Sales Receipt,8353,,"FIREWRAP® GRIP KIT
Color: Red",1,27.95  ,27.95  ,"59,649.25  "
FireWrap® Grip Kit Red,07/24/2022,Sales Receipt,8349,,"FIREWRAP® GRIP KIT
Color: Red",1,27.95  ,27.95  ,"59,677.20  "
FireWrap® Grip Kit Red,07/24/2022,Sales Receipt,8356,,"FIREWRAP® GRIP KIT
Color: Red",1,27.95  ,27.95  ,"59,705.15  "
FireWrap® Grip Kit Red,07/25/2022,Sales Receipt,8362,,"FIREWRAP® GRIP KIT
Color: Red",1,27.95  ,27.95  ,"59,733.10  "
FireWrap® Grip Kit Red,07/25/2022,Sales Receipt,8359,,"FIREWRAP® GRIP KIT
Color: Red",1,27.95  ,27.95  ,"59,761.05  "
FireWrap® Grip Kit Red,07/25/2022,Sales Receipt,8361,,"FIREWRAP® GRIP KIT
Color: Red",2,27.95  ,55.90  ,"59,816.95  "
FireWrap® Grip Kit Red,07/25/2022,Sales Receipt,8357,,"FIREWRAP® GRIP KIT
Color: Red",4,27.95  ,111.80  ,"59,928.75  "
FireWrap® Grip Kit Red,07/27/2022,Sales Receipt,8371,,"FIREWRAP® GRIP KIT
Color: Red",1,27.95  ,27.95  ,"59,956.70  "
FireWrap® Grip Kit Red,07/28/2022,Sales Receipt,8380,,"FIREWRAP® GRIP KIT
Color: Red",1,27.95  ,27.95  ,"59,984.65  "
FireWrap® Grip Kit Red,07/28/2022,Sales Receipt,8377,,"FIREWRAP® GRIP KIT
Color: Red",1,27.95  ,27.95  ,"60,012.60  "
FireWrap® Grip Kit Red,07/30/2022,Sales Receipt,8395,,"FIREWRAP® GRIP KIT
Color: Red",1,27.95  ,27.95  ,"60,040.55  "
FireWrap® Grip Kit Red,07/30/2022,Sales Receipt,8399,,"FIREWRAP® GRIP KIT
Color: Red",2,27.95  ,55.90  ,"60,096.45  "
FireWrap® Grip Kit Red,08/01/2022,Sales Receipt,8407,,"FIREWRAP® GRIP KIT
Color: Red",1,27.95  ,27.95  ,"60,124.40  "
FireWrap® Grip Kit Red,08/03/2022,Sales Receipt,8423,,"FIREWRAP® GRIP KIT
Color: Red",2,27.95  ,55.90  ,"60,180.30  "
FireWrap® Grip Kit Red,08/03/2022,Sales Receipt,8426,,"FIREWRAP® GRIP KIT
Color: Red",1,27.95  ,27.95  ,"60,208.25  "
FireWrap® Grip Kit Red,08/04/2022,Sales Receipt,8430,,"FIREWRAP® GRIP KIT
Color: Red",8,27.95  ,223.60  ,"60,431.85  "
FireWrap® Grip Kit Red,08/05/2022,Sales Receipt,8436,,"FIREWRAP® GRIP KIT
Color: Red",1,27.95  ,27.95  ,"60,459.80  "
FireWrap® Grip Kit Red,08/08/2022,Sales Receipt,8446,,"FIREWRAP® GRIP KIT
Color: Red",2,27.95  ,55.90  ,"60,515.70  "
FireWrap® Grip Kit Red,08/08/2022,Sales Receipt,8449,,"FIREWRAP® GRIP KIT
Color: Red",1,27.95  ,27.95  ,"60,543.65  "
FireWrap® Grip Kit Red,08/09/2022,Sales Receipt,8450,,"FIREWRAP® GRIP KIT
Color: Red",1,27.95  ,27.95  ,"60,571.60  "
FireWrap® Grip Kit Red,08/10/2022,Sales Receipt,8461,,"FIREWRAP® GRIP KIT
Color: Red",1,27.95  ,27.95  ,"60,599.55  "
FireWrap® Grip Kit Red,08/10/2022,Sales Receipt,8467,,"FIREWRAP® GRIP KIT
Color: Red",2,27.95  ,55.90  ,"60,655.45  "
FireWrap® Grip Kit Red,08/12/2022,Sales Receipt,8472,,"FIREWRAP® GRIP KIT
Color: Red",1,27.95  ,27.95  ,"60,683.40  "
FireWrap® Grip Kit Red,08/12/2022,Sales Receipt,8471,,"FIREWRAP® GRIP KIT
Color: Red",2,27.95  ,55.90  ,"60,739.30  "
FireWrap® Grip Kit Red,08/14/2022,Sales Receipt,8484,,"FIREWRAP® GRIP KIT
Color: Red",1,27.95  ,27.95  ,"60,767.25  "
FireWrap® Grip Kit Red,08/14/2022,Sales Receipt,8485,,"FIREWRAP® GRIP KIT
Color: Red",2,27.95  ,55.90  ,"60,823.15  "
FireWrap® Grip Kit Red,08/17/2022,Sales Receipt,8500,,"FIREWRAP® GRIP KIT
Color: Red",2,27.95  ,55.90  ,"60,879.05  "
FireWrap® Grip Kit Red,08/18/2022,Sales Receipt,8512,,"FIREWRAP® GRIP KIT
Color: Red",4,27.95  ,111.80  ,"60,990.85  "
FireWrap® Grip Kit Red,08/18/2022,Sales Receipt,8508,,"FIREWRAP® GRIP KIT
Color: Red",1,27.95  ,27.95  ,"61,018.80  "
FireWrap® Grip Kit Red,08/18/2022,Sales Receipt,8505,,"FIREWRAP® GRIP KIT
Color: Red",1,27.95  ,27.95  ,"61,046.75  "
FireWrap® Grip Kit Red,08/21/2022,Sales Receipt,8534,,"FIREWRAP® GRIP KIT
Color: Red",2,27.95  ,55.90  ,"61,102.65  "
FireWrap® Grip Kit Red,08/21/2022,Sales Receipt,8532,,"FIREWRAP® GRIP KIT
Color: Red",1,27.95  ,27.95  ,"61,130.60  "
FireWrap® Grip Kit Red,08/21/2022,Sales Receipt,8531,,"FIREWRAP® GRIP KIT
Color: Red",1,27.95  ,27.95  ,"61,158.55  "
FireWrap® Grip Kit Red,08/22/2022,Sales Receipt,8536,,"FIREWRAP® GRIP KIT
Color: Red",2,27.95  ,55.90  ,"61,214.45  "
FireWrap® Grip Kit Red,08/22/2022,Sales Receipt,8539,,"FIREWRAP® GRIP KIT
Color: Red",1,27.95  ,27.95  ,"61,242.40  "
FireWrap® Grip Kit Red,08/25/2022,Sales Receipt,8556,,"FIREWRAP® GRIP KIT
Color: Red",1,27.95  ,27.95  ,"61,270.35  "
FireWrap® Grip Kit Red,08/25/2022,Sales Receipt,8552,,"FIREWRAP® GRIP KIT
Color: Red",4,27.95  ,111.80  ,"61,382.15  "
FireWrap® Grip Kit Red,08/27/2022,Sales Receipt,8565,,"FIREWRAP® GRIP KIT
Color: Red",1,27.95  ,27.95  ,"61,410.10  "
FireWrap® Grip Kit Red,08/28/2022,Sales Receipt,8580,,"FIREWRAP® GRIP KIT
Color: Red",1,27.95  ,27.95  ,"61,438.05  "
FireWrap® Grip Kit Red,08/29/2022,Sales Receipt,8585,,"FIREWRAP® GRIP KIT
Color: Red",2,27.95  ,55.90  ,"61,493.95  "
FireWrap® Grip Kit Red,08/30/2022,Sales Receipt,8595,,"FIREWRAP® GRIP KIT
Color: Red",1,27.95  ,27.95  ,"61,521.90  "
FireWrap® Grip Kit Red,08/30/2022,Sales Receipt,8589,,"FIREWRAP® GRIP KIT
Color: Red",4,27.95  ,111.80  ,"61,633.70  "
FireWrap® Grip Kit Red,09/01/2022,Sales Receipt,8605,,"FIREWRAP® GRIP KIT
Color: Red",2,27.95  ,55.90  ,"61,689.60  "
FireWrap® Grip Kit Red,09/03/2022,Sales Receipt,8617,,"FIREWRAP® GRIP KIT
Color: Red",4,27.95  ,111.80  ,"61,801.40  "
FireWrap® Grip Kit Red,09/05/2022,Sales Receipt,8623,,"FIREWRAP® GRIP KIT
Color: Red",1,27.95  ,27.95  ,"61,829.35  "
FireWrap® Grip Kit Red,09/05/2022,Sales Receipt,8631,,"FIREWRAP® GRIP KIT
Color: Red",1,27.95  ,27.95  ,"61,857.30  "
FireWrap® Grip Kit Red,09/06/2022,Sales Receipt,8635,,"FIREWRAP® GRIP KIT
Color: Red",2,27.95  ,55.90  ,"61,913.20  "
FireWrap® Grip Kit Red,09/06/2022,Sales Receipt,8641,,"FIREWRAP® GRIP KIT
Color: Red",1,27.95  ,27.95  ,"61,941.15  "
FireWrap® Grip Kit Red,09/07/2022,Sales Receipt,8647,,"FIREWRAP® GRIP KIT
Color: Red",1,27.95  ,27.95  ,"61,969.10  "
FireWrap® Grip Kit Red,09/09/2022,Sales Receipt,8653,,"FIREWRAP® GRIP KIT
Color: Red",1,27.95  ,27.95  ,"61,997.05  "
FireWrap® Grip Kit Red,09/10/2022,Sales Receipt,8657,,"FIREWRAP® GRIP KIT
Color: Red",6,27.95  ,167.70  ,"62,164.75  "
FireWrap® Grip Kit Red,09/11/2022,Sales Receipt,8667,,"FIREWRAP® GRIP KIT
Color: Red",1,27.95  ,27.95  ,"62,192.70  "
FireWrap® Grip Kit Red,09/11/2022,Sales Receipt,8663,,"FIREWRAP® GRIP KIT
Color: Red",1,27.95  ,27.95  ,"62,220.65  "
FireWrap® Grip Kit Red,09/13/2022,Sales Receipt,8680,,"FIREWRAP® GRIP KIT
Color: Red",1,27.95  ,27.95  ,"62,248.60  "
FireWrap® Grip Kit Red,09/15/2022,Sales Receipt,8692,,"FIREWRAP® GRIP KIT
Color: Red",1,27.95  ,27.95  ,"62,276.55  "
FireWrap® Grip Kit Red,09/17/2022,Sales Receipt,8703,,"FIREWRAP® GRIP KIT
Color: Red",1,27.95  ,27.95  ,"62,304.50  "
FireWrap® Grip Kit Red,09/17/2022,Sales Receipt,8704,,"FIREWRAP® GRIP KIT
Color: Red",2,27.95  ,55.90  ,"62,360.40  "
FireWrap® Grip Kit Red,09/18/2022,Sales Receipt,8707,,"FIREWRAP® GRIP KIT
Color: Red",1,27.95  ,27.95  ,"62,388.35  "
FireWrap® Grip Kit Red,09/19/2022,Sales Receipt,8710,,"FIREWRAP® GRIP KIT
Color: Red",1,27.95  ,27.95  ,"62,416.30  "
FireWrap® Grip Kit Red,09/19/2022,Sales Receipt,8712,,"FIREWRAP® GRIP KIT
Color: Red",1,27.95  ,27.95  ,"62,444.25  "
FireWrap® Grip Kit Red,09/21/2022,Sales Receipt,8728,,"FIREWRAP® GRIP KIT
Color: Red",1,27.95  ,27.95  ,"62,472.20  "
FireWrap® Grip Kit Red,09/21/2022,Sales Receipt,8727,,"FIREWRAP® GRIP KIT
Color: Red",1,27.95  ,27.95  ,"62,500.15  "
FireWrap® Grip Kit Red,09/22/2022,Sales Receipt,8739,,"FIREWRAP® GRIP KIT
Color: Red",8,27.95  ,223.60  ,"62,723.75  "
FireWrap® Grip Kit Red,09/25/2022,Sales Receipt,8751,,"FIREWRAP® GRIP KIT
Color: Red",2,27.95  ,55.90  ,"62,779.65  "
FireWrap® Grip Kit Red,09/27/2022,Sales Receipt,8772,,"FIREWRAP® GRIP KIT
Color: Red",2,27.95  ,55.90  ,"62,835.55  "
FireWrap® Grip Kit Red,09/28/2022,Sales Receipt,8787,,"FIREWRAP® GRIP KIT
Color: Red",1,27.95  ,27.95  ,"62,863.50  "
FireWrap® Grip Kit Red,09/28/2022,Sales Receipt,8777,,"FIREWRAP® GRIP KIT
Color: Red",1,27.95  ,27.95  ,"62,891.45  "
FireWrap® Grip Kit Red,09/28/2022,Sales Receipt,8783,,"FIREWRAP® GRIP KIT
Color: Red",1,27.95  ,27.95  ,"62,919.40  "
FireWrap® Grip Kit Red,09/28/2022,Sales Receipt,8788,,"FIREWRAP® GRIP KIT
Color: Red",1,27.95  ,27.95  ,"62,947.35  "
FireWrap® Grip Kit Red,09/29/2022,Sales Receipt,8807,,"FIREWRAP® GRIP KIT
Color: Red",3,27.95  ,83.85  ,"63,031.20  "
FireWrap® Grip Kit Red,09/29/2022,Sales Receipt,8799,,"FIREWRAP® GRIP KIT
Color: Red",5,27.95  ,139.75  ,"63,170.95  "
FireWrap® Grip Kit Red,09/29/2022,Sales Receipt,8791,,"FIREWRAP® GRIP KIT
Color: Red",1,27.95  ,27.95  ,"63,198.90  "
FireWrap® Grip Kit Red,09/30/2022,Sales Receipt,8813,,"FIREWRAP® GRIP KIT
Color: Red",2,27.95  ,55.90  ,"63,254.80  "
FireWrap® Grip Kit Red,10/01/2022,Sales Receipt,8819,,"FIREWRAP® GRIP KIT
Color: Red",1,27.95  ,27.95  ,"63,282.75  "
FireWrap® Grip Kit Red,10/02/2022,Sales Receipt,8825,,"FIREWRAP® GRIP KIT
Color: Red",1,27.95  ,27.95  ,"63,310.70  "
FireWrap® Grip Kit Red,10/03/2022,Sales Receipt,8834,,"FIREWRAP® GRIP KIT
Color: Red",2,27.95  ,55.90  ,"63,366.60  "
FireWrap® Grip Kit Red,10/03/2022,Sales Receipt,8835,,"FIREWRAP® GRIP KIT
Color: Red",1,27.95  ,27.95  ,"63,394.55  "
FireWrap® Grip Kit Red,10/06/2022,Sales Receipt,8849,,"FIREWRAP® GRIP KIT
Color: Red",1,27.95  ,27.95  ,"63,422.50  "
FireWrap® Grip Kit Red,10/07/2022,Sales Receipt,8857,,"FIREWRAP® GRIP KIT
Color: Red",3,27.95  ,83.85  ,"63,506.35  "
FireWrap® Grip Kit Red,10/10/2022,Sales Receipt,8876,,"FIREWRAP® GRIP KIT
Color: Red",2,27.95  ,55.90  ,"63,562.25  "
FireWrap® Grip Kit Red,10/11/2022,Sales Receipt,8895,,"FIREWRAP® GRIP KIT
Color: Red",3,27.95  ,83.85  ,"63,646.10  "
FireWrap® Grip Kit Red,10/11/2022,Sales Receipt,8883,,"FIREWRAP® GRIP KIT
Color: Red",1,27.95  ,27.95  ,"63,674.05  "
FireWrap® Grip Kit Red,10/13/2022,Sales Receipt,8905,,"FIREWRAP® GRIP KIT
Color: Red",1,27.95  ,27.95  ,"63,702.00  "
FireWrap® Grip Kit Red,10/15/2022,Sales Receipt,8915,,"FIREWRAP® GRIP KIT
Color: Red",1,27.95  ,27.95  ,"63,729.95  "
FireWrap® Grip Kit Red,10/16/2022,Sales Receipt,8920,,"FIREWRAP® GRIP KIT
Color: Red",1,27.95  ,27.95  ,"63,757.90  "
FireWrap® Grip Kit Red,10/17/2022,Sales Receipt,8926,,"FIREWRAP® GRIP KIT
Color: Red",1,27.95  ,27.95  ,"63,785.85  "
FireWrap® Grip Kit Red,10/18/2022,Sales Receipt,8933,,"FIREWRAP® GRIP KIT
Color: Red",1,27.95  ,27.95  ,"63,813.80  "
FireWrap® Grip Kit Red,10/19/2022,Sales Receipt,8939,,"FIREWRAP® GRIP KIT
Color: Red",1,27.95  ,27.95  ,"63,841.75  "
FireWrap® Grip Kit Red,10/20/2022,Sales Receipt,8951,,"FIREWRAP® GRIP KIT
Color: Red",1,27.95  ,27.95  ,"63,869.70  "
FireWrap® Grip Kit Red,10/20/2022,Sales Receipt,8946,,"FIREWRAP® GRIP KIT
Color: Red",2,27.95  ,55.90  ,"63,925.60  "
FireWrap® Grip Kit Red,10/21/2022,Invoice,M-102122-004,,FireWrap® Grip Kit Red,2,28.95  ,57.90  ,"63,983.50  "
FireWrap® Grip Kit Red,10/21/2022,Sales Receipt,8959,,"FIREWRAP® GRIP KIT
Color: Red",2,27.95  ,55.90  ,"64,039.40  "
FireWrap® Grip Kit Red,10/22/2022,Sales Receipt,8964,,"FIREWRAP® GRIP KIT
Color: Red",1,27.95  ,27.95  ,"64,067.35  "
FireWrap® Grip Kit Red,10/24/2022,Sales Receipt,8974,,"FIREWRAP® GRIP KIT
Color: Red",1,27.95  ,27.95  ,"64,095.30  "
FireWrap® Grip Kit Red,10/29/2022,Sales Receipt,9001,,"FIREWRAP® GRIP KIT
Color: Red",1,27.95  ,27.95  ,"64,123.25  "
FireWrap® Grip Kit Red,10/29/2022,Sales Receipt,9003,,"FIREWRAP® GRIP KIT
Color: Red",1,27.95  ,27.95  ,"64,151.20  "
FireWrap® Grip Kit Red,10/31/2022,Sales Receipt,9010,,"FIREWRAP® GRIP KIT
Color: Red",1,27.95  ,27.95  ,"64,179.15  "
FireWrap® Grip Kit Red,11/02/2022,Sales Receipt,9017,,"FIREWRAP® GRIP KIT
Color: Red",1,27.95  ,27.95  ,"64,207.10  "
FireWrap® Grip Kit Red,11/03/2022,Sales Receipt,9022,,"FIREWRAP® GRIP KIT
Color: Red",1,27.95  ,27.95  ,"64,235.05  "
FireWrap® Grip Kit Red,11/05/2022,Sales Receipt,M-111-9874990-4382624,,FireWrap® Grip Kit - Red,1,28.95  ,28.95  ,"64,264.00  "
FireWrap® Grip Kit Red,11/06/2022,Sales Receipt,9029,,"FIREWRAP® GRIP KIT
Color: Red",1,27.95  ,27.95  ,"64,291.95  "
FireWrap® Grip Kit Red,11/08/2022,Sales Receipt,9046,,"FIREWRAP® GRIP KIT
Color: Red",1,27.95  ,27.95  ,"64,319.90  "
FireWrap® Grip Kit Red,11/08/2022,Sales Receipt,9044,,"FIREWRAP® GRIP KIT
Color: Red",6,27.95  ,167.70  ,"64,487.60  "
FireWrap® Grip Kit Red,11/09/2022,Sales Receipt,9054,,"FIREWRAP® GRIP KIT
Color: Red",1,27.95  ,27.95  ,"64,515.55  "
FireWrap® Grip Kit Red,11/09/2022,Sales Receipt,9049,,"FIREWRAP® GRIP KIT
Color: Red",1,27.95  ,27.95  ,"64,543.50  "
FireWrap® Grip Kit Red,11/11/2022,Sales Receipt,M-113-3845965-2846613,,FireWrap® Grip Kit - Red,1,28.95  ,28.95  ,"64,572.45  "
FireWrap® Grip Kit Red,11/13/2022,Sales Receipt,9076,,"FIREWRAP® GRIP KIT
Color: Red",1,27.95  ,27.95  ,"64,600.40  "
FireWrap® Grip Kit Red,11/14/2022,Sales Receipt,M-112-4240856-6866630,,FireWrap® Grip Kit - Red,5,28.95  ,144.75  ,"64,745.15  "
FireWrap® Grip Kit Red,11/14/2022,Sales Receipt,9082,,"FIREWRAP® GRIP KIT
Color: Red",3,27.95  ,83.85  ,"64,829.00  "
FireWrap® Grip Kit Red,11/14/2022,Sales Receipt,9080,,"FIREWRAP® GRIP KIT
Color: Red",1,27.95  ,27.95  ,"64,856.95  "
FireWrap® Grip Kit Red,11/15/2022,Sales Receipt,9088,,"FIREWRAP® GRIP KIT
Color: Red",1,27.95  ,27.95  ,"64,884.90  "
FireWrap® Grip Kit Red,11/15/2022,Sales Receipt,9093,,"FIREWRAP® GRIP KIT
Color: Red",5,27.95  ,139.75  ,"65,024.65  "
FireWrap® Grip Kit Red,11/16/2022,Sales Receipt,9102,,"FIREWRAP® GRIP KIT
Color: Red",1,27.95  ,27.95  ,"65,052.60  "
FireWrap® Grip Kit Red,11/16/2022,Sales Receipt,9100,,"FIREWRAP® GRIP KIT
Color: Red",1,27.95  ,27.95  ,"65,080.55  "
FireWrap® Grip Kit Red,11/18/2022,Sales Receipt,9115,,"FIREWRAP® GRIP KIT
Color: Red",5,27.95  ,139.75  ,"65,220.30  "
FireWrap® Grip Kit Red,11/20/2022,Sales Receipt,M-111-3756495-0980205,,FireWrap® Grip Kit - Red,1,28.95  ,28.95  ,"65,249.25  "
FireWrap® Grip Kit Red,11/21/2022,Sales Receipt,9131,,"FIREWRAP® GRIP KIT
Color: Red",1,27.95  ,27.95  ,"65,277.20  "
FireWrap® Grip Kit Red,11/22/2022,Sales Receipt,9139,,"FIREWRAP® GRIP KIT
Color: Red",2,27.95  ,55.90  ,"65,333.10  "
FireWrap® Grip Kit Red,11/23/2022,Sales Receipt,9144,,"FIREWRAP® GRIP KIT
Color: Red",3,27.95  ,83.85  ,"65,416.95  "
FireWrap® Grip Kit Red,11/23/2022,Sales Receipt,M-112-1629887-0297819,,FireWrap® Grip Kit - Red,1,28.95  ,28.95  ,"65,445.90  "
FireWrap® Grip Kit Red,11/24/2022,Sales Receipt,9153,,"FIREWRAP® GRIP KIT
Color: Red",3,27.95  ,83.85  ,"65,529.75  "
FireWrap® Grip Kit Red,11/28/2022,Sales Receipt,9194,,"FIREWRAP® GRIP KIT
Color: Red",1,27.95  ,27.95  ,"65,557.70  "
FireWrap® Grip Kit Red,11/28/2022,Sales Receipt,9200,,"FIREWRAP® GRIP KIT
Color: Red",6,27.95  ,167.70  ,"65,725.40  "
FireWrap® Grip Kit Red,11/28/2022,Sales Receipt,9197,,"FIREWRAP® GRIP KIT
Color: Red",5,27.95  ,139.75  ,"65,865.15  "
FireWrap® Grip Kit Red,11/29/2022,Sales Receipt,M-111-7859116-9244242,,FireWrap® Grip Kit - Red,1,28.95  ,28.95  ,"65,894.10  "
FireWrap® Grip Kit Red,11/29/2022,Sales Receipt,9203,,"FIREWRAP® GRIP KIT
Color: Red",1,27.95  ,27.95  ,"65,922.05  "
FireWrap® Grip Kit Red,11/30/2022,Sales Receipt,9219,,"FIREWRAP® GRIP KIT
Color: Red",1,27.95  ,27.95  ,"65,950.00  "
FireWrap® Grip Kit Red,12/01/2022,Sales Receipt,9227,,"FIREWRAP® GRIP KIT
Color: Red",1,27.95  ,27.95  ,"65,977.95  "
FireWrap® Grip Kit Red,12/02/2022,Sales Receipt,M-112-8147294-7234668,,FireWrap® Grip Kit - Red,1,28.95  ,28.95  ,"66,006.90  "
FireWrap® Grip Kit Red,12/02/2022,Sales Receipt,M-112-4609116-5202648,,FireWrap® Grip Kit - Red,1,28.95  ,28.95  ,"66,035.85  "
FireWrap® Grip Kit Red,12/03/2022,Sales Receipt,9243,,"FIREWRAP® GRIP KIT
Color: Red",1,27.95  ,27.95  ,"66,063.80  "
FireWrap® Grip Kit Red,12/04/2022,Sales Receipt,9248,,"FIREWRAP® GRIP KIT
Color: Red",1,27.95  ,27.95  ,"66,091.75  "
FireWrap® Grip Kit Red,12/04/2022,Sales Receipt,M-113-9853973-1383450,,FireWrap® Grip Kit - Red,1,28.95  ,28.95  ,"66,120.70  "
FireWrap® Grip Kit Red,12/06/2022,Sales Receipt,9259,,"FIREWRAP® GRIP KIT
Color: Red",1,27.95  ,27.95  ,"66,148.65  "
FireWrap® Grip Kit Red,12/07/2022,Sales Receipt,9273,,"FIREWRAP® GRIP KIT
Color: Red",1,27.95  ,27.95  ,"66,176.60  "
FireWrap® Grip Kit Red,12/07/2022,Sales Receipt,9270,,"FIREWRAP® GRIP KIT
Color: Red",20,27.95  ,559.00  ,"66,735.60  "
FireWrap® Grip Kit Red,12/07/2022,Sales Receipt,9263,,"FIREWRAP® GRIP KIT
Color: Red",3,27.95  ,83.85  ,"66,819.45  "
FireWrap® Grip Kit Red,12/07/2022,Sales Receipt,9276,,"FIREWRAP® GRIP KIT
Color: Red",1,27.95  ,27.95  ,"66,847.40  "
FireWrap® Grip Kit Red,12/08/2022,Sales Receipt,M-114-1460022-7174604,,FireWrap® Grip Kit - Red,2,28.95  ,57.90  ,"66,905.30  "
FireWrap® Grip Kit Red,12/08/2022,Sales Receipt,9277,,"FIREWRAP® GRIP KIT
Color: Red",1,27.95  ,27.95  ,"66,933.25  "
FireWrap® Grip Kit Red,12/08/2022,Sales Receipt,M-111-7851290-9710657,,FireWrap® Grip Kit - Red,1,28.95  ,28.95  ,"66,962.20  "
FireWrap® Grip Kit Red,12/09/2022,Sales Receipt,M-114-9044238-2089028,,FireWrap® Grip Kit - Red,1,28.95  ,28.95  ,"66,991.15  "
FireWrap® Grip Kit Red,12/09/2022,Sales Receipt,9289,,"FIREWRAP® GRIP KIT
Color: Red",1,27.95  ,27.95  ,"67,019.10  "
FireWrap® Grip Kit Red,12/09/2022,Sales Receipt,9284,,"FIREWRAP® GRIP KIT
Color: Red",3,27.95  ,83.85  ,"67,102.95  "
FireWrap® Grip Kit Red,12/09/2022,Sales Receipt,M-114-4445822-7277829,,FireWrap® Grip Kit - Red,1,28.95  ,28.95  ,"67,131.90  "
FireWrap® Grip Kit Red,12/10/2022,Sales Receipt,M-114-0885837-6449026,,FireWrap® Grip Kit - Red,1,28.95  ,28.95  ,"67,160.85  "
FireWrap® Grip Kit Red,12/10/2022,Sales Receipt,9293,,"FIREWRAP® GRIP KIT
Color: Red",1,27.95  ,27.95  ,"67,188.80  "
FireWrap® Grip Kit Red,12/10/2022,Sales Receipt,9297,,"FIREWRAP® GRIP KIT
Color: Red",1,27.95  ,27.95  ,"67,216.75  "
FireWrap® Grip Kit Red,12/10/2022,Sales Receipt,M-114-9021849-0849059,,FireWrap® Grip Kit - Red,1,28.95  ,28.95  ,"67,245.70  "
FireWrap® Grip Kit Red,12/11/2022,Sales Receipt,M-111-6052893-5353808,,FireWrap® Grip Kit - Red,1,28.95  ,28.95  ,"67,274.65  "
FireWrap® Grip Kit Red,12/11/2022,Sales Receipt,9306,,"FIREWRAP® GRIP KIT
Color: Red",1,27.95  ,27.95  ,"67,302.60  "
FireWrap® Grip Kit Red,12/11/2022,Sales Receipt,9309,,"FIREWRAP® GRIP KIT
Color: Red",1,27.95  ,27.95  ,"67,330.55  "
FireWrap® Grip Kit Red,12/13/2022,Sales Receipt,M-114-0237458-0381018,,FireWrap® Grip Kit - Red,1,28.95  ,28.95  ,"67,359.50  "
FireWrap® Grip Kit Red,12/13/2022,Sales Receipt,9318,,"FIREWRAP® GRIP KIT
Color: Red",1,27.95  ,27.95  ,"67,387.45  "
FireWrap® Grip Kit Red,12/14/2022,Sales Receipt,M-111-4324900-8669058,,FireWrap® Grip Kit - Red,1,28.95  ,28.95  ,"67,416.40  "
FireWrap® Grip Kit Red,12/14/2022,Sales Receipt,M-112-0517309-5888258,,FireWrap® Grip Kit - Red,1,28.95  ,28.95  ,"67,445.35  "
FireWrap® Grip Kit Red,12/15/2022,Sales Receipt,9325,,"FIREWRAP® GRIP KIT
Color: Red",2,27.95  ,55.90  ,"67,501.25  "
FireWrap® Grip Kit Red,12/15/2022,Sales Receipt,9329,,"FIREWRAP® GRIP KIT
Color: Red",1,27.95  ,27.95  ,"67,529.20  "
FireWrap® Grip Kit Red,12/15/2022,Sales Receipt,9330,,"FIREWRAP® GRIP KIT
Color: Red",1,27.95  ,27.95  ,"67,557.15  "
FireWrap® Grip Kit Red,12/16/2022,Sales Receipt,9344,,"FIREWRAP® GRIP KIT
Color: Red",1,27.95  ,27.95  ,"67,585.10  "
FireWrap® Grip Kit Red,12/18/2022,Sales Receipt,M-114-3293125-7134627,,FireWrap® Grip Kit - Red,1,28.95  ,28.95  ,"67,614.05  "
FireWrap® Grip Kit Red,12/19/2022,Sales Receipt,9363,,"FIREWRAP® GRIP KIT
Color: Red",1,27.95  ,27.95  ,"67,642.00  "
FireWrap® Grip Kit Red,12/20/2022,Sales Receipt,M-113-1019248-0417017,,FireWrap® Grip Kit - Red,2,28.95  ,57.90  ,"67,699.90  "
FireWrap® Grip Kit Red,12/22/2022,Sales Receipt,9378,,"FIREWRAP® GRIP KIT
Color: Red",1,27.95  ,27.95  ,"67,727.85  "
FireWrap® Grip Kit Red,12/24/2022,Sales Receipt,9390,,"FIREWRAP® GRIP KIT
Color: Red",1,27.95  ,27.95  ,"67,755.80  "
FireWrap® Grip Kit Red,12/25/2022,Sales Receipt,9394,,"FIREWRAP® GRIP KIT
Color: Red",1,27.95  ,27.95  ,"67,783.75  "
FireWrap® Grip Kit Red,12/26/2022,Sales Receipt,9400,,"FIREWRAP® GRIP KIT
Color: Red",2,27.95  ,55.90  ,"67,839.65  "
FireWrap® Grip Kit Red,12/26/2022,Sales Receipt,9397,,"FIREWRAP® GRIP KIT
Color: Red",1,27.95  ,27.95  ,"67,867.60  "
FireWrap® Grip Kit Red,12/27/2022,Sales Receipt,9404,,"FIREWRAP® GRIP KIT
Color: Red",1,27.95  ,27.95  ,"67,895.55  "
FireWrap® Grip Kit Red,12/27/2022,Sales Receipt,M-114-5602689-1384245,,FireWrap® Grip Kit - Red,1,28.95  ,28.95  ,"67,924.50  "
FireWrap® Grip Kit Red,12/27/2022,Sales Receipt,M-111-7820414-1853066,,FireWrap® Grip Kit - Red,1,28.95  ,28.95  ,"67,953.45  "
FireWrap® Grip Kit Red,12/28/2022,Sales Receipt,M-112-2055382-0480251,,FireWrap® Grip Kit - Red,1,28.95  ,28.95  ,"67,982.40  "
FireWrap® Grip Kit Red,12/28/2022,Sales Receipt,M-112-0540239-3916203,,FireWrap® Grip Kit - Red,1,28.95  ,28.95  ,"68,011.35  "
FireWrap® Grip Kit Red,12/29/2022,Sales Receipt,9417,,"FIREWRAP® GRIP KIT
Color: Red",1,27.95  ,27.95  ,"68,039.30  "
FireWrap® Grip Kit Red,12/30/2022,Sales Receipt,9428,,"FIREWRAP® GRIP KIT
Color: Red",1,27.95  ,27.95  ,"68,067.25  "
FireWrap® Grip Kit Red,12/31/2022,Sales Receipt,M-112-5015319-3954634,,FireWrap® Grip Kit - Red,2,28.95  ,57.90  ,"68,125.15  "
FireWrap® Grip Kit Red,01/01/2023,Sales Receipt,9440,,"FIREWRAP® GRIP KIT
Color: Red",2,27.95  ,55.90  ,"68,181.05  "
FireWrap® Grip Kit Red,01/03/2023,Sales Receipt,9454,,"FIREWRAP® GRIP KIT
Color: Red",1,27.95  ,27.95  ,"68,209.00  "
FireWrap® Grip Kit Red,01/03/2023,Sales Receipt,M-112-1914042-2163443,,FireWrap® Grip Kit - Red,3,28.95  ,86.85  ,"68,295.85  "
FireWrap® Grip Kit Red,01/05/2023,Sales Receipt,9459,,"FIREWRAP® GRIP KIT
Color: Red",2,27.95  ,55.90  ,"68,351.75  "
FireWrap® Grip Kit Red,01/06/2023,Sales Receipt,9469,,"FIREWRAP® GRIP KIT
Color: Red",1,27.95  ,27.95  ,"68,379.70  "
FireWrap® Grip Kit Red,01/06/2023,Sales Receipt,9465,,"FIREWRAP® GRIP KIT
Color: Red",1,27.95  ,27.95  ,"68,407.65  "
FireWrap® Grip Kit Red,01/10/2023,Sales Receipt,9488,,"FIREWRAP® GRIP KIT
Color: Red",2,27.95  ,55.90  ,"68,463.55  "
FireWrap® Grip Kit Red,01/11/2023,Sales Receipt,9496,,"FIREWRAP® GRIP KIT
Color: Red",7,27.95  ,195.65  ,"68,659.20  "
Total for FireWrap® Grip Kit Red,,,,,,2584,,"$	68,659.20  ",
FireWrap® Grip Kit Yellow,,,,,,,,,
FireWrap® Grip Kit Yellow,03/22/2018,Sales Receipt,#1389,,FireWrap  Grip Kit - Pre-Order,1,24.95  ,24.95  ,24.95  
FireWrap® Grip Kit Yellow,04/05/2018,Sales Receipt,#1426,,FireWrap  Grip Kit - Pre-Order,1,24.95  ,24.95  ,49.90  
FireWrap® Grip Kit Yellow,04/14/2018,Sales Receipt,#1444,,FireWrap  Grip Kit - Pre-Order,1,24.95  ,24.95  ,74.85  
FireWrap® Grip Kit Yellow,04/14/2018,Sales Receipt,#1447,,FireWrap  Grip Kit - Pre-Order,1,24.95  ,24.95  ,99.80  
FireWrap® Grip Kit Yellow,04/26/2018,Sales Receipt,#1476,,FireWrap  Grip Kit - Pre-Order,1,24.95  ,24.95  ,124.75  
FireWrap® Grip Kit Yellow,04/27/2018,Sales Receipt,#1544,,FireWrap  Grip Kit - Pre-Order,1,24.95  ,24.95  ,149.70  
FireWrap® Grip Kit Yellow,04/27/2018,Sales Receipt,#1517,,FireWrap  Grip Kit - Pre-Order,1,24.95  ,24.95  ,174.65  
FireWrap® Grip Kit Yellow,04/27/2018,Sales Receipt,#1528,,FireWrap  Grip Kit - Pre-Order,1,24.95  ,24.95  ,199.60  
FireWrap® Grip Kit Yellow,04/27/2018,Sales Receipt,#1519,,FireWrap  Grip Kit - Pre-Order,1,24.95  ,24.95  ,224.55  
FireWrap® Grip Kit Yellow,04/28/2018,Sales Receipt,#1567,,FireWrap  Grip Kit - Pre-Order,1,24.95  ,24.95  ,249.50  
FireWrap® Grip Kit Yellow,04/28/2018,Sales Receipt,#1562,,FireWrap  Grip Kit - Pre-Order,1,24.95  ,24.95  ,274.45  
FireWrap® Grip Kit Yellow,04/28/2018,Sales Receipt,#1551,,FireWrap  Grip Kit - Pre-Order,1,24.95  ,24.95  ,299.40  
FireWrap® Grip Kit Yellow,04/28/2018,Sales Receipt,#1555,,FireWrap  Grip Kit - Pre-Order,1,24.95  ,24.95  ,324.35  
FireWrap® Grip Kit Yellow,04/30/2018,Invoice,1113,,,3,20.00  ,60.00  ,384.35  
FireWrap® Grip Kit Yellow,04/30/2018,Invoice,1112,,,2,20.00  ,40.00  ,424.35  
FireWrap® Grip Kit Yellow,05/08/2018,Sales Receipt,#1608,,FireWrap  Grip Kit,1,34.95  ,34.95  ,459.30  
FireWrap® Grip Kit Yellow,06/01/2018,Invoice,1122,,"Drop Ship: Tim Day, 12774 Cooks Mill Road, Lanexa, Virginia, 23089,",1,26.00  ,26.00  ,485.30  
FireWrap® Grip Kit Yellow,06/18/2018,Sales Receipt,#1680,,FireWrap  Grip Kit,2,34.95  ,69.90  ,555.20  
FireWrap® Grip Kit Yellow,06/22/2018,Invoice,1133,,,10,26.00  ,260.00  ,815.20  
FireWrap® Grip Kit Yellow,07/19/2018,Sales Receipt,#1729,,FireWrap  Grip Kit,4,34.95  ,139.80  ,955.00  
FireWrap® Grip Kit Yellow,07/31/2018,Sales Receipt,#1744,,FireWrap  Grip Kit,2,34.95  ,69.90  ,"1,024.90  "
FireWrap® Grip Kit Yellow,08/01/2018,Sales Receipt,#1746,,FireWrap  Grip Kit,1,34.95  ,34.95  ,"1,059.85  "
FireWrap® Grip Kit Yellow,08/06/2018,Sales Receipt,#1759,,FireWrap  Grip Kit,2,34.95  ,69.90  ,"1,129.75  "
FireWrap® Grip Kit Yellow,08/08/2018,Sales Receipt,#1762,,FireWrap  Grip Kit,1,34.95  ,34.95  ,"1,164.70  "
FireWrap® Grip Kit Yellow,08/12/2018,Invoice,1157,,,3,34.95  ,104.85  ,"1,269.55  "
FireWrap® Grip Kit Yellow,08/13/2018,Sales Receipt,#1771,,FireWrap  Grip Kit,1,34.95  ,34.95  ,"1,304.50  "
FireWrap® Grip Kit Yellow,08/14/2018,Sales Receipt,#1772,,FireWrap  Grip Kit,7,34.95  ,244.65  ,"1,549.15  "
FireWrap® Grip Kit Yellow,08/20/2018,Sales Receipt,#1781,,FireWrap  Grip Kit,1,34.95  ,34.95  ,"1,584.10  "
FireWrap® Grip Kit Yellow,08/21/2018,Invoice,1163,,,5,28.00  ,140.00  ,"1,724.10  "
FireWrap® Grip Kit Yellow,08/24/2018,Sales Receipt,#1786,,FireWrap  Grip Kit,2,34.95  ,69.90  ,"1,794.00  "
FireWrap® Grip Kit Yellow,09/12/2018,Sales Receipt,#1832,,FireWrap  Grip Kit,1,34.95  ,34.95  ,"1,828.95  "
FireWrap® Grip Kit Yellow,10/19/2018,Sales Receipt,#1931,,FireWrap  Grip Kit,1,34.95  ,34.95  ,"1,863.90  "
FireWrap® Grip Kit Yellow,10/26/2018,Sales Receipt,#1963,,FireWrap  Grip Kit,1,34.95  ,34.95  ,"1,898.85  "
FireWrap® Grip Kit Yellow,10/29/2018,Invoice,1192,,,21,24.00  ,504.00  ,"2,402.85  "
FireWrap® Grip Kit Yellow,11/03/2018,Sales Receipt,#1984,,FireWrap  Grip Kit,2,34.95  ,69.90  ,"2,472.75  "
FireWrap® Grip Kit Yellow,11/13/2018,Invoice,1203,,,4,28.00  ,112.00  ,"2,584.75  "
FireWrap® Grip Kit Yellow,11/16/2018,Sales Receipt,#2003,,FireWrap  Grip Kit,1,34.95  ,34.95  ,"2,619.70  "
FireWrap® Grip Kit Yellow,11/18/2018,Sales Receipt,#2006,,FireWrap  Grip Kit,1,34.95  ,34.95  ,"2,654.65  "
FireWrap® Grip Kit Yellow,11/23/2018,Sales Receipt,#2017,,FireWrap  Grip Kit,1,34.95  ,34.95  ,"2,689.60  "
FireWrap® Grip Kit Yellow,11/30/2018,Sales Receipt,#2043,,FireWrap  Grip Kit,1,34.95  ,34.95  ,"2,724.55  "
FireWrap® Grip Kit Yellow,12/06/2018,Sales Receipt,#2066,,FireWrap  Grip Kit,3,34.95  ,104.85  ,"2,829.40  "
FireWrap® Grip Kit Yellow,12/08/2018,Sales Receipt,#2074,,FireWrap  Grip Kit,1,34.95  ,34.95  ,"2,864.35  "
FireWrap® Grip Kit Yellow,12/13/2018,Invoice,1224,,,10,34.95  ,349.50  ,"3,213.85  "
FireWrap® Grip Kit Yellow,12/26/2018,Sales Receipt,#2127,,FireWrap  Grip Kit,2,34.95  ,69.90  ,"3,283.75  "
FireWrap® Grip Kit Yellow,01/03/2019,Sales Receipt,#2161,,FireWrap  Grip Kit,2,34.95  ,69.90  ,"3,353.65  "
FireWrap® Grip Kit Yellow,01/14/2019,Sales Receipt,#2197,,FireWrap  Grip Kit,7,34.95  ,244.65  ,"3,598.30  "
FireWrap® Grip Kit Yellow,01/25/2019,Invoice,1248,,,4,26.00  ,104.00  ,"3,702.30  "
FireWrap® Grip Kit Yellow,01/30/2019,Sales Receipt,#2253,,FireWrap Grip Kit,3,34.95  ,104.85  ,"3,807.15  "
FireWrap® Grip Kit Yellow,02/01/2019,Sales Receipt,#2259,,FireWrap  Grip Kit,1,34.95  ,34.95  ,"3,842.10  "
FireWrap® Grip Kit Yellow,02/02/2019,Sales Receipt,#2265,,FireWrap Grip Kit,2,34.95  ,69.90  ,"3,912.00  "
FireWrap® Grip Kit Yellow,02/06/2019,Invoice,1268,,FireWrap Grip-Kit für Halligan-Tool - Gelb,150,25.00  ,"3,750.00  ","7,662.00  "
FireWrap® Grip Kit Yellow,02/06/2019,Invoice,1268,,FireWrap Grip-Kit für Halligan-Tool - Gelb,25,0.00  ,0.00  ,"7,662.00  "
FireWrap® Grip Kit Yellow,02/09/2019,Sales Receipt,#2280,,FireWrap  Grip Kit,1,34.95  ,34.95  ,"7,696.95  "
FireWrap® Grip Kit Yellow,02/13/2019,Sales Receipt,#2286,,FireWrap  Grip Kit,2,34.95  ,69.90  ,"7,766.85  "
FireWrap® Grip Kit Yellow,02/17/2019,Sales Receipt,#2306,,FireWrap  Grip Kit,1,34.95  ,34.95  ,"7,801.80  "
FireWrap® Grip Kit Yellow,02/20/2019,Invoice,1270,,,3,30.00  ,90.00  ,"7,891.80  "
FireWrap® Grip Kit Yellow,02/25/2019,Invoice,1279,,,2,30.00  ,60.00  ,"7,951.80  "
FireWrap® Grip Kit Yellow,03/01/2019,Sales Receipt,#2355,,FireWrap  Grip Kit,1,34.95  ,34.95  ,"7,986.75  "
FireWrap® Grip Kit Yellow,03/05/2019,Invoice,1266,,"P.O. Number: 19-0209-5 
Daniel Murray
24 Cole Street 1
East Providence, RI 02914",1,30.00  ,30.00  ,"8,016.75  "
FireWrap® Grip Kit Yellow,03/07/2019,Sales Receipt,#2380,,FireWrap  Grip Kit,1,34.95  ,34.95  ,"8,051.70  "
FireWrap® Grip Kit Yellow,03/11/2019,Invoice,1287,,,1,30.00  ,30.00  ,"8,081.70  "
FireWrap® Grip Kit Yellow,03/22/2019,Invoice,1304,,,1,29.00  ,29.00  ,"8,110.70  "
FireWrap® Grip Kit Yellow,03/27/2019,Sales Receipt,#2451,,FireWrap® Grip Kit,3,34.95  ,104.85  ,"8,215.55  "
FireWrap® Grip Kit Yellow,04/01/2019,Sales Receipt,#2473,,FireWrap Grip Kit,2,34.95  ,69.90  ,"8,285.45  "
FireWrap® Grip Kit Yellow,04/01/2019,Invoice,1303,,"P.O. Number: 19-0326-7 
Dan Murray
50 Peace Pipe Trail South
Wakefield, RI 02879",1,30.00  ,30.00  ,"8,315.45  "
FireWrap® Grip Kit Yellow,04/04/2019,Sales Receipt,#2488,,FireWrap® Grip Kit,1,34.95  ,34.95  ,"8,350.40  "
FireWrap® Grip Kit Yellow,04/05/2019,Sales Receipt,#2492,,FireWrap® Grip Kit,1,34.95  ,34.95  ,"8,385.35  "
FireWrap® Grip Kit Yellow,04/05/2019,Sales Receipt,#2490,,FireWrap Grip Kit,2,34.95  ,69.90  ,"8,455.25  "
FireWrap® Grip Kit Yellow,04/15/2019,Sales Receipt,#2590,,FireWrap® Grip Kit,1,34.95  ,34.95  ,"8,490.20  "
FireWrap® Grip Kit Yellow,04/23/2019,Sales Receipt,#2608,,FireWrap® Grip Kit,4,34.95  ,139.80  ,"8,630.00  "
FireWrap® Grip Kit Yellow,05/07/2019,Invoice,1332,,,1,30.00  ,30.00  ,"8,660.00  "
FireWrap® Grip Kit Yellow,05/24/2019,Invoice,1357,,,2,30.00  ,60.00  ,"8,720.00  "
FireWrap® Grip Kit Yellow,05/24/2019,Invoice,1341,,,11,28.00  ,308.00  ,"9,028.00  "
FireWrap® Grip Kit Yellow,05/24/2019,Invoice,1352,,,1,30.00  ,30.00  ,"9,058.00  "
FireWrap® Grip Kit Yellow,06/03/2019,Invoice,1340,,,2,30.00  ,60.00  ,"9,118.00  "
FireWrap® Grip Kit Yellow,06/05/2019,Invoice,1360,,,1,30.00  ,30.00  ,"9,148.00  "
FireWrap® Grip Kit Yellow,06/15/2019,Sales Receipt,#2695,,FireWrap® Grip Kit,6,34.95  ,209.70  ,"9,357.70  "
FireWrap® Grip Kit Yellow,07/02/2019,Invoice,1361,,P.O. Number: 19-0612-5,2,30.00  ,60.00  ,"9,417.70  "
FireWrap® Grip Kit Yellow,07/02/2019,Sales Receipt,#2746,,FireWrap Grip Kit,1,34.95  ,34.95  ,"9,452.65  "
FireWrap® Grip Kit Yellow,07/02/2019,Sales Receipt,#2743,,FireWrap Grip Kit,1,34.95  ,34.95  ,"9,487.60  "
FireWrap® Grip Kit Yellow,07/22/2019,Sales Receipt,112-7553840-6768258,,FireWrap Grip Kit,1,34.95  ,34.95  ,"9,522.55  "
FireWrap® Grip Kit Yellow,08/01/2019,Sales Receipt,113-3091463-9277033,,FireWrap Grip Kit,2,34.95  ,69.90  ,"9,592.45  "
FireWrap® Grip Kit Yellow,08/14/2019,Sales Receipt,114-7412556-1933044,,FireWrap Grip Kit,1,34.95  ,34.95  ,"9,627.40  "
FireWrap® Grip Kit Yellow,10/03/2019,Invoice,M-100319-001,,,10,34.95  ,349.50  ,"9,976.90  "
FireWrap® Grip Kit Yellow,10/07/2019,Sales Receipt,112-9755134-8700205,,FireWrap Grip Kit (New),2,34.95  ,69.90  ,"10,046.80  "
FireWrap® Grip Kit Yellow,10/21/2019,Sales Receipt,112-6188773-4680233,,FireWrap Grip Kit (New),1,34.95  ,34.95  ,"10,081.75  "
FireWrap® Grip Kit Yellow,10/24/2019,Sales Receipt,112-4425511-2756209,,FireWrap Grip Kit (New),1,34.95  ,34.95  ,"10,116.70  "
FireWrap® Grip Kit Yellow,11/01/2019,Sales Receipt,113-2910762-4056248,,FireWrap Grip Kit,1,34.95  ,34.95  ,"10,151.65  "
FireWrap® Grip Kit Yellow,11/07/2019,Sales Receipt,112-0931707-0468240,,FireWrap Grip Kit - Yellow (New),1,34.95  ,34.95  ,"10,186.60  "
FireWrap® Grip Kit Yellow,11/11/2019,Sales Receipt,111-7325600-8596228,,FireWrap Grip Kit - Yellow (New),1,34.95  ,34.95  ,"10,221.55  "
FireWrap® Grip Kit Yellow,02/10/2020,Sales Receipt,114-4970473-3696238,,FireWrap Grip Kit - Yellow (New),1,24.95  ,24.95  ,"10,246.50  "
FireWrap® Grip Kit Yellow,02/12/2020,Sales Receipt,111-0917327-3573805,,FireWrap Grip Kit - Yellow (New),1,24.95  ,24.95  ,"10,271.45  "
FireWrap® Grip Kit Yellow,02/18/2020,Sales Receipt,113-3023751-7940255,,FireWrap Grip Kit - Yellow (New),1,24.95  ,24.95  ,"10,296.40  "
FireWrap® Grip Kit Yellow,02/20/2020,Sales Receipt,112-7583972-2189861,,FireWrap Grip Kit - Yellow (New),1,24.95  ,24.95  ,"10,321.35  "
FireWrap® Grip Kit Yellow,04/01/2020,Sales Receipt,111-9163564-3893846,,FireWrap Grip Kit - Yellow (New),1,24.95  ,24.95  ,"10,346.30  "
FireWrap® Grip Kit Yellow,04/09/2020,Sales Receipt,3620,,FireWrap® Grip Kit - Yellow,2,24.95  ,49.90  ,"10,396.20  "
FireWrap® Grip Kit Yellow,04/20/2020,Sales Receipt,3669,,FireWrap® Grip Kit - Yellow,4,24.95  ,99.80  ,"10,496.00  "
FireWrap® Grip Kit Yellow,04/21/2020,Sales Receipt,3675,,FireWrap® Grip Kit - Yellow,5,24.95  ,124.75  ,"10,620.75  "
FireWrap® Grip Kit Yellow,04/30/2020,Sales Receipt,3710,,FireWrap® Grip Kit - Yellow,3,24.95  ,74.85  ,"10,695.60  "
FireWrap® Grip Kit Yellow,05/14/2020,Sales Receipt,3766,,FireWrap® Grip Kit - Yellow,1,24.95  ,24.95  ,"10,720.55  "
FireWrap® Grip Kit Yellow,06/04/2020,Sales Receipt,3823,,FireWrap® Grip Kit - Yellow,5,24.95  ,124.75  ,"10,845.30  "
FireWrap® Grip Kit Yellow,06/23/2020,Sales Receipt,3943,,FireWrap® Grip Kit - Yellow,1,24.95  ,24.95  ,"10,870.25  "
FireWrap® Grip Kit Yellow,06/27/2020,Sales Receipt,3962,,FireWrap® Grip Kit - Yellow,20,24.95  ,499.00  ,"11,369.25  "
FireWrap® Grip Kit Yellow,06/30/2020,Sales Receipt,3978,,FireWrap® Grip Kit - Yellow,1,24.95  ,24.95  ,"11,394.20  "
FireWrap® Grip Kit Yellow,07/10/2020,Sales Receipt,4007,,FireWrap® Grip Kit - Yellow,1,24.95  ,24.95  ,"11,419.15  "
FireWrap® Grip Kit Yellow,08/19/2020,Sales Receipt,4124,,FireWrap® Grip Kit - Yellow,2,24.95  ,49.90  ,"11,469.05  "
FireWrap® Grip Kit Yellow,08/20/2020,Sales Receipt,4129,,FireWrap® Grip Kit - Yellow,2,24.95  ,49.90  ,"11,518.95  "
FireWrap® Grip Kit Yellow,08/21/2020,Sales Receipt,4133,,FireWrap® Grip Kit - Yellow,5,24.95  ,124.75  ,"11,643.70  "
FireWrap® Grip Kit Yellow,08/22/2020,Sales Receipt,4142,,FireWrap® Grip Kit - Yellow,1,24.95  ,24.95  ,"11,668.65  "
FireWrap® Grip Kit Yellow,09/01/2020,Sales Receipt,4176,,FireWrap® Grip Kit - Yellow,1,24.95  ,24.95  ,"11,693.60  "
FireWrap® Grip Kit Yellow,09/03/2020,Sales Receipt,4187,,FireWrap® Grip Kit - Yellow,1,24.95  ,24.95  ,"11,718.55  "
FireWrap® Grip Kit Yellow,09/03/2020,Sales Receipt,4185,,FireWrap® Grip Kit - Yellow,1,24.95  ,24.95  ,"11,743.50  "
FireWrap® Grip Kit Yellow,09/18/2020,Sales Receipt,4232,,FireWrap® Grip Kit - Yellow,1,24.95  ,24.95  ,"11,768.45  "
FireWrap® Grip Kit Yellow,09/21/2020,Sales Receipt,4249,,FireWrap® Grip Kit - Yellow,1,24.95  ,24.95  ,"11,793.40  "
FireWrap® Grip Kit Yellow,10/12/2020,Sales Receipt,4343,,FireWrap® Grip Kit - Yellow,7,24.95  ,174.65  ,"11,968.05  "
FireWrap® Grip Kit Yellow,10/22/2020,Sales Receipt,4393,,FireWrap® Grip Kit - Yellow,8,24.95  ,199.60  ,"12,167.65  "
FireWrap® Grip Kit Yellow,10/27/2020,Sales Receipt,4421,,FireWrap® Grip Kit - Yellow,1,24.95  ,24.95  ,"12,192.60  "
FireWrap® Grip Kit Yellow,11/02/2020,Sales Receipt,4457,,FireWrap® Grip Kit - Yellow,1,24.95  ,24.95  ,"12,217.55  "
FireWrap® Grip Kit Yellow,11/16/2020,Sales Receipt,4514,,FireWrap® Grip Kit - Yellow,1,24.95  ,24.95  ,"12,242.50  "
FireWrap® Grip Kit Yellow,11/17/2020,Sales Receipt,4519,,FireWrap® Grip Kit - Yellow,2,24.95  ,49.90  ,"12,292.40  "
FireWrap® Grip Kit Yellow,11/27/2020,Sales Receipt,4579,,FireWrap® Grip Kit - Yellow,2,24.95  ,49.90  ,"12,342.30  "
FireWrap® Grip Kit Yellow,12/07/2020,Sales Receipt,4637,,FireWrap® Grip Kit - Yellow,1,24.95  ,24.95  ,"12,367.25  "
FireWrap® Grip Kit Yellow,12/08/2020,Sales Receipt,4649,,FireWrap® Grip Kit - Yellow,10,24.95  ,249.50  ,"12,616.75  "
FireWrap® Grip Kit Yellow,12/18/2020,Invoice,M-121820-006,,FireWrap® Grip Kit Yellow,5,18.75  ,93.75  ,"12,710.50  "
FireWrap® Grip Kit Yellow,01/17/2021,Sales Receipt,4862,,FireWrap® Grip Kit - Yellow,4,24.95  ,99.80  ,"12,810.30  "
FireWrap® Grip Kit Yellow,01/19/2021,Invoice,M-011921-002,,FireWrap® Grip Kit Yellow,1,18.75  ,18.75  ,"12,829.05  "
FireWrap® Grip Kit Yellow,01/19/2021,Invoice,M-011921-023,,FireWrap® Grip Kit Yellow,4,24.95  ,99.80  ,"12,928.85  "
FireWrap® Grip Kit Yellow,01/19/2021,Invoice,M-011921-022,,FireWrap® Grip Kit Yellow,1,18.75  ,18.75  ,"12,947.60  "
FireWrap® Grip Kit Yellow,01/26/2021,Invoice,M-012621-006,,FireWrap® Grip Kit Yellow,1,18.75  ,18.75  ,"12,966.35  "
FireWrap® Grip Kit Yellow,01/26/2021,Sales Receipt,4894,,FireWrap® Grip Kit - Yellow,6,24.95  ,149.70  ,"13,116.05  "
FireWrap® Grip Kit Yellow,02/01/2021,Sales Receipt,4910,,FireWrap® Grip Kit - Yellow,1,24.95  ,24.95  ,"13,141.00  "
FireWrap® Grip Kit Yellow,02/11/2021,Sales Receipt,4947,,FireWrap® Grip Kit - Yellow,1,24.95  ,24.95  ,"13,165.95  "
FireWrap® Grip Kit Yellow,02/12/2021,Sales Receipt,4953,,"FIREWRAP® GRIP KIT
Color: Yellow",1,24.99  ,24.99  ,"13,190.94  "
FireWrap® Grip Kit Yellow,02/14/2021,Sales Receipt,4965,,"FIREWRAP® GRIP KIT
Color: Yellow",1,24.99  ,24.99  ,"13,215.93  "
FireWrap® Grip Kit Yellow,02/16/2021,Invoice,M-021621-012,,FireWrap® Grip Kit Yellow,1,18.75  ,18.75  ,"13,234.68  "
FireWrap® Grip Kit Yellow,02/16/2021,Invoice,M-021621-010,,FireWrap® Grip Kit Yellow,1,18.75  ,18.75  ,"13,253.43  "
FireWrap® Grip Kit Yellow,02/16/2021,Invoice,M-021621-002,,FireWrap® Grip Kit Yellow,6,18.75  ,112.50  ,"13,365.93  "
FireWrap® Grip Kit Yellow,02/23/2021,Sales Receipt,5009,,"FIREWRAP® GRIP KIT
Color: Yellow",1,24.99  ,24.99  ,"13,390.92  "
FireWrap® Grip Kit Yellow,02/24/2021,Invoice,M-022421-009,,FireWrap® Grip Kit Yellow,1,18.75  ,18.75  ,"13,409.67  "
FireWrap® Grip Kit Yellow,03/12/2021,Invoice,M-031221-008,,FireWrap® Grip Kit Yellow,15,24.95  ,374.25  ,"13,783.92  "
FireWrap® Grip Kit Yellow,03/14/2021,Sales Receipt,5108,,"FIREWRAP® GRIP KIT - Yes, I understand.
Color: Yellow",1,24.99  ,24.99  ,"13,808.91  "
FireWrap® Grip Kit Yellow,03/22/2021,Sales Receipt,5160,,"FIREWRAP® GRIP KIT - Yes, I understand.
Color: Yellow",8,24.99  ,199.92  ,"14,008.83  "
FireWrap® Grip Kit Yellow,03/22/2021,Sales Receipt,5162,,"FIREWRAP® GRIP KIT - Yes, I understand.
Color: Yellow",4,24.99  ,99.96  ,"14,108.79  "
FireWrap® Grip Kit Yellow,03/23/2021,Sales Receipt,5165,,"FIREWRAP® GRIP KIT - Yes, I understand.
Color: Yellow",2,24.99  ,49.98  ,"14,158.77  "
FireWrap® Grip Kit Yellow,03/27/2021,Invoice,M-032721-001,,FireWrap® Grip Kit Yellow,2,18.75  ,37.50  ,"14,196.27  "
FireWrap® Grip Kit Yellow,03/27/2021,Invoice,M-032721-001,,FireWrap® Grip Kit Yellow,3,18.75  ,56.25  ,"14,252.52  "
FireWrap® Grip Kit Yellow,03/27/2021,Invoice,M-032721-001,,FireWrap® Grip Kit Yellow,1,18.75  ,18.75  ,"14,271.27  "
FireWrap® Grip Kit Yellow,03/27/2021,Invoice,M-032721-006,,FireWrap® Grip Kit Yellow,2,18.75  ,37.50  ,"14,308.77  "
FireWrap® Grip Kit Yellow,03/27/2021,Invoice,M-032721-006,,FireWrap® Grip Kit Yellow,2,18.75  ,37.50  ,"14,346.27  "
FireWrap® Grip Kit Yellow,03/27/2021,Sales Receipt,5183,,"FIREWRAP® GRIP KIT - Yes, I understand.
Color: Yellow",5,24.99  ,124.95  ,"14,471.22  "
FireWrap® Grip Kit Yellow,03/27/2021,Sales Receipt,5181,,"FIREWRAP® GRIP KIT - Yes, I understand.
Color: Yellow",1,24.99  ,24.99  ,"14,496.21  "
FireWrap® Grip Kit Yellow,03/30/2021,Invoice,M-033021-008,,FireWrap® Grip Kit Yellow,2,18.75  ,37.50  ,"14,533.71  "
FireWrap® Grip Kit Yellow,03/30/2021,Invoice,M-033021-008,,FireWrap® Grip Kit Yellow,4,18.75  ,75.00  ,"14,608.71  "
FireWrap® Grip Kit Yellow,04/02/2021,Sales Receipt,5226,,"FIREWRAP® GRIP KIT - Yes, I understand.
Color: Yellow",3,24.99  ,74.97  ,"14,683.68  "
FireWrap® Grip Kit Yellow,04/03/2021,Sales Receipt,5234,,"FIREWRAP® GRIP KIT - Yes, I understand.
Color: Yellow",4,24.99  ,99.96  ,"14,783.64  "
FireWrap® Grip Kit Yellow,04/13/2021,Sales Receipt,5293,,"FIREWRAP® GRIP KIT - Yes, I understand.
Color: Yellow",6,24.99  ,149.94  ,"14,933.58  "
FireWrap® Grip Kit Yellow,04/20/2021,Sales Receipt,5336,,"FIREWRAP® GRIP KIT
Color: Yellow",4,24.99  ,99.96  ,"15,033.54  "
FireWrap® Grip Kit Yellow,04/21/2021,Sales Receipt,5340,,"FIREWRAP® GRIP KIT
Color: Yellow",2,24.99  ,49.98  ,"15,083.52  "
FireWrap® Grip Kit Yellow,04/21/2021,Sales Receipt,5345,,"FIREWRAP® GRIP KIT
Color: Yellow",2,24.99  ,49.98  ,"15,133.50  "
FireWrap® Grip Kit Yellow,04/21/2021,Sales Receipt,5348,,"FIREWRAP® GRIP KIT
Color: Yellow",2,24.99  ,49.98  ,"15,183.48  "
FireWrap® Grip Kit Yellow,04/23/2021,Sales Receipt,5362,,"FIREWRAP® GRIP KIT - Yes, I understand.
Color: Yellow",1,24.99  ,24.99  ,"15,208.47  "
FireWrap® Grip Kit Yellow,04/27/2021,Sales Receipt,5401,,"FIREWRAP® GRIP KIT
Color: Yellow",2,24.99  ,49.98  ,"15,258.45  "
FireWrap® Grip Kit Yellow,04/28/2021,Sales Receipt,5408,,"FIREWRAP® GRIP KIT
Color: Yellow",1,24.99  ,24.99  ,"15,283.44  "
FireWrap® Grip Kit Yellow,04/30/2021,Invoice,M-043021-002,,FireWrap® Grip Kit Yellow,2,24.99  ,49.98  ,"15,333.42  "
FireWrap® Grip Kit Yellow,05/01/2021,Sales Receipt,5431,,"FIREWRAP® GRIP KIT
Color: Yellow",1,24.99  ,24.99  ,"15,358.41  "
FireWrap® Grip Kit Yellow,05/03/2021,Invoice,M-050321-003,,FireWrap® Grip Kit Yellow,7,18.75  ,131.25  ,"15,489.66  "
FireWrap® Grip Kit Yellow,05/10/2021,Invoice,M-050421-003,,FireWrap® Grip Kit Yellow,1,18.75  ,18.75  ,"15,508.41  "
FireWrap® Grip Kit Yellow,05/11/2021,Sales Receipt,5481,,"FIREWRAP® GRIP KIT
Color: Yellow",2,24.99  ,49.98  ,"15,558.39  "
FireWrap® Grip Kit Yellow,05/14/2021,Sales Receipt,5510,,"FIREWRAP® GRIP KIT
Color: Yellow",1,24.99  ,24.99  ,"15,583.38  "
FireWrap® Grip Kit Yellow,05/20/2021,Invoice,M-052021-001,,FireWrap® Grip Kit Yellow,8,18.75  ,150.00  ,"15,733.38  "
FireWrap® Grip Kit Yellow,05/25/2021,Invoice,M-052521-001,,FireWrap® Grip Kit Yellow,2,18.75  ,37.50  ,"15,770.88  "
FireWrap® Grip Kit Yellow,05/26/2021,Sales Receipt,5582,,"FIREWRAP® GRIP KIT
Color: Yellow",2,24.99  ,49.98  ,"15,820.86  "
FireWrap® Grip Kit Yellow,05/30/2021,Sales Receipt,5599,,"FIREWRAP® GRIP KIT
Color: Yellow",2,24.99  ,49.98  ,"15,870.84  "
FireWrap® Grip Kit Yellow,05/30/2021,Sales Receipt,5602,,"FIREWRAP® GRIP KIT
Color: Yellow",4,24.99  ,99.96  ,"15,970.80  "
FireWrap® Grip Kit Yellow,06/01/2021,Invoice,M-060121-002,,FireWrap® Grip Kit Yellow,6,18.75  ,112.50  ,"16,083.30  "
FireWrap® Grip Kit Yellow,06/16/2021,Invoice,M-061621-001,,FireWrap® Grip Kit Yellow,4,18.75  ,75.00  ,"16,158.30  "
FireWrap® Grip Kit Yellow,06/16/2021,Invoice,M-061621-001,,FireWrap® Grip Kit Yellow,2,18.75  ,37.50  ,"16,195.80  "
FireWrap® Grip Kit Yellow,06/28/2021,Sales Receipt,5717,,"FIREWRAP® GRIP KIT
Color: Yellow",1,24.99  ,24.99  ,"16,220.79  "
FireWrap® Grip Kit Yellow,07/14/2021,Sales Receipt,5778,,"FIREWRAP® GRIP KIT
Color: Yellow",4,24.99  ,99.96  ,"16,320.75  "
FireWrap® Grip Kit Yellow,07/20/2021,Sales Receipt,5802,,"FIREWRAP® GRIP KIT
Color: Yellow",2,24.99  ,49.98  ,"16,370.73  "
FireWrap® Grip Kit Yellow,07/26/2021,Sales Receipt,5825,,"FIREWRAP® GRIP KIT
Color: Yellow",8,24.99  ,199.92  ,"16,570.65  "
FireWrap® Grip Kit Yellow,08/05/2021,Sales Receipt,5859,,"FIREWRAP® GRIP KIT
Color: Yellow",1,24.99  ,24.99  ,"16,595.64  "
FireWrap® Grip Kit Yellow,08/09/2021,Sales Receipt,5886,,"FIREWRAP® GRIP KIT
Color: Yellow",4,24.99  ,99.96  ,"16,695.60  "
FireWrap® Grip Kit Yellow,08/14/2021,Sales Receipt,5913,,"FIREWRAP® GRIP KIT
Color: Yellow",1,24.99  ,24.99  ,"16,720.59  "
FireWrap® Grip Kit Yellow,08/15/2021,Sales Receipt,5923,,"FIREWRAP® GRIP KIT
Color: Yellow",1,24.99  ,24.99  ,"16,745.58  "
FireWrap® Grip Kit Yellow,08/16/2021,Sales Receipt,5928,,"FIREWRAP® GRIP KIT
Color: Yellow",5,24.99  ,124.95  ,"16,870.53  "
FireWrap® Grip Kit Yellow,08/17/2021,Invoice,M-081221-001,,FireWrap® Grip Kit Yellow,2,18.75  ,37.50  ,"16,908.03  "
FireWrap® Grip Kit Yellow,08/21/2021,Sales Receipt,5951,,"FIREWRAP® GRIP KIT
Color: Yellow",1,24.99  ,24.99  ,"16,933.02  "
FireWrap® Grip Kit Yellow,08/25/2021,Sales Receipt,5976,,"FIREWRAP® GRIP KIT
Color: Yellow",1,24.99  ,24.99  ,"16,958.01  "
FireWrap® Grip Kit Yellow,09/01/2021,Sales Receipt,6027,,"FIREWRAP® GRIP KIT
Color: Yellow",3,24.99  ,74.97  ,"17,032.98  "
FireWrap® Grip Kit Yellow,09/05/2021,Sales Receipt,6044,,"FIREWRAP® GRIP KIT
Color: Yellow",1,24.99  ,24.99  ,"17,057.97  "
FireWrap® Grip Kit Yellow,09/19/2021,Sales Receipt,6110,,"FIREWRAP® GRIP KIT
Color: Yellow",1,24.99  ,24.99  ,"17,082.96  "
FireWrap® Grip Kit Yellow,09/23/2021,Sales Receipt,6145,,"FIREWRAP® GRIP KIT
Color: Yellow",4,19.99  ,79.96  ,"17,162.92  "
FireWrap® Grip Kit Yellow,09/26/2021,Sales Receipt,6164,,"FIREWRAP® GRIP KIT
Color: Yellow",1,19.99  ,19.99  ,"17,182.91  "
FireWrap® Grip Kit Yellow,10/05/2021,Sales Receipt,6240,,"FIREWRAP® GRIP KIT
Color: Yellow",1,24.95  ,24.95  ,"17,207.86  "
FireWrap® Grip Kit Yellow,10/09/2021,Sales Receipt,6269,,"FIREWRAP® GRIP KIT
Color: Yellow",1,24.95  ,24.95  ,"17,232.81  "
FireWrap® Grip Kit Yellow,10/11/2021,Sales Receipt,6276,,"FIREWRAP® GRIP KIT
Color: Yellow",1,24.95  ,24.95  ,"17,257.76  "
FireWrap® Grip Kit Yellow,10/25/2021,Sales Receipt,6364,,"FIREWRAP® GRIP KIT
Color: Yellow",1,24.95  ,24.95  ,"17,282.71  "
FireWrap® Grip Kit Yellow,11/09/2021,Sales Receipt,6452,,"FIREWRAP® GRIP KIT
Color: Yellow",1,24.95  ,24.95  ,"17,307.66  "
FireWrap® Grip Kit Yellow,11/18/2021,Sales Receipt,6530,,"FIREWRAP® GRIP KIT
Color: Yellow",1,24.95  ,24.95  ,"17,332.61  "
FireWrap® Grip Kit Yellow,11/19/2021,Sales Receipt,6539,,"FIREWRAP® GRIP KIT
Color: Yellow",1,24.95  ,24.95  ,"17,357.56  "
FireWrap® Grip Kit Yellow,11/26/2021,Sales Receipt,6597,,"FIREWRAP® GRIP KIT
Color: Yellow",2,19.99  ,39.98  ,"17,397.54  "
FireWrap® Grip Kit Yellow,12/06/2021,Sales Receipt,6681,,"FIREWRAP® GRIP KIT
Color: Yellow",3,24.95  ,74.85  ,"17,472.39  "
FireWrap® Grip Kit Yellow,12/07/2021,Sales Receipt,6690,,"FIREWRAP® GRIP KIT
Color: Yellow",1,24.95  ,24.95  ,"17,497.34  "
FireWrap® Grip Kit Yellow,12/13/2021,Sales Receipt,6735,,"FIREWRAP® GRIP KIT
Color: Yellow",2,24.95  ,49.90  ,"17,547.24  "
FireWrap® Grip Kit Yellow,12/26/2021,Sales Receipt,6835,,"FIREWRAP® GRIP KIT
Color: Yellow",2,24.95  ,49.90  ,"17,597.14  "
FireWrap® Grip Kit Yellow,12/30/2021,Sales Receipt,6863,,"FIREWRAP® GRIP KIT
Color: Yellow",1,24.95  ,24.95  ,"17,622.09  "
FireWrap® Grip Kit Yellow,01/11/2022,Sales Receipt,6978,,"FIREWRAP® GRIP KIT
Color: Yellow",10,24.95  ,249.50  ,"17,871.59  "
FireWrap® Grip Kit Yellow,01/13/2022,Sales Receipt,6996,,"FIREWRAP® GRIP KIT
Color: Yellow",1,24.95  ,24.95  ,"17,896.54  "
FireWrap® Grip Kit Yellow,01/21/2022,Sales Receipt,7058,,"FIREWRAP® GRIP KIT
Color: Yellow",1,24.95  ,24.95  ,"17,921.49  "
FireWrap® Grip Kit Yellow,01/25/2022,Sales Receipt,7092,,"FIREWRAP® GRIP KIT
Color: Yellow",2,24.95  ,49.90  ,"17,971.39  "
FireWrap® Grip Kit Yellow,01/27/2022,Sales Receipt,7112,,"FIREWRAP® GRIP KIT
Color: Yellow",4,24.95  ,99.80  ,"18,071.19  "
FireWrap® Grip Kit Yellow,01/29/2022,Sales Receipt,7142,,"FIREWRAP® GRIP KIT
Color: Yellow",1,24.95  ,24.95  ,"18,096.14  "
FireWrap® Grip Kit Yellow,01/29/2022,Sales Receipt,7144,,"FIREWRAP® GRIP KIT
Color: Yellow",1,24.95  ,24.95  ,"18,121.09  "
FireWrap® Grip Kit Yellow,02/02/2022,Sales Receipt,7180,,"FIREWRAP® GRIP KIT
Color: Yellow",3,24.95  ,74.85  ,"18,195.94  "
FireWrap® Grip Kit Yellow,02/09/2022,Sales Receipt,7247,,"FIREWRAP® GRIP KIT
Color: Yellow",6,27.95  ,167.70  ,"18,363.64  "
FireWrap® Grip Kit Yellow,02/10/2022,Sales Receipt,7256,,"FIREWRAP® GRIP KIT
Color: Yellow",2,27.95  ,55.90  ,"18,419.54  "
FireWrap® Grip Kit Yellow,02/11/2022,Sales Receipt,7267,,"FIREWRAP® GRIP KIT
Color: Yellow",1,27.95  ,27.95  ,"18,447.49  "
FireWrap® Grip Kit Yellow,02/13/2022,Sales Receipt,7283,,"FIREWRAP® GRIP KIT
Color: Yellow",1,27.95  ,27.95  ,"18,475.44  "
FireWrap® Grip Kit Yellow,02/22/2022,Sales Receipt,7360,,"FIREWRAP® GRIP KIT
Color: Yellow",1,27.95  ,27.95  ,"18,503.39  "
FireWrap® Grip Kit Yellow,02/25/2022,Sales Receipt,7388,,"FIREWRAP® GRIP KIT
Color: Yellow",1,27.95  ,27.95  ,"18,531.34  "
FireWrap® Grip Kit Yellow,02/27/2022,Sales Receipt,7412,,"FIREWRAP® GRIP KIT
Color: Yellow",1,27.95  ,27.95  ,"18,559.29  "
FireWrap® Grip Kit Yellow,03/04/2022,Sales Receipt,7466,,"FIREWRAP® GRIP KIT
Color: Yellow",1,27.95  ,27.95  ,"18,587.24  "
FireWrap® Grip Kit Yellow,03/05/2022,Sales Receipt,7473,,"FIREWRAP® GRIP KIT
Color: Yellow",8,27.95  ,223.60  ,"18,810.84  "
FireWrap® Grip Kit Yellow,03/07/2022,Sales Receipt,7497,,"FIREWRAP® GRIP KIT
Color: Yellow",1,27.95  ,27.95  ,"18,838.79  "
FireWrap® Grip Kit Yellow,03/12/2022,Sales Receipt,7524,,"FIREWRAP® GRIP KIT
Color: Yellow",1,27.95  ,27.95  ,"18,866.74  "
FireWrap® Grip Kit Yellow,03/29/2022,Sales Receipt,7651,,"FIREWRAP® GRIP KIT
Color: Yellow",3,27.95  ,83.85  ,"18,950.59  "
FireWrap® Grip Kit Yellow,04/08/2022,Sales Receipt,7716,,"FIREWRAP® GRIP KIT
Color: Yellow",4,27.95  ,111.80  ,"19,062.39  "
FireWrap® Grip Kit Yellow,04/09/2022,Sales Receipt,7722,,"FIREWRAP® GRIP KIT
Color: Yellow",1,27.95  ,27.95  ,"19,090.34  "
FireWrap® Grip Kit Yellow,04/22/2022,Sales Receipt,7794,,"FIREWRAP® GRIP KIT
Color: Yellow",1,27.95  ,27.95  ,"19,118.29  "
FireWrap® Grip Kit Yellow,04/24/2022,Sales Receipt,7808,,"FIREWRAP® GRIP KIT
Color: Yellow",1,27.95  ,27.95  ,"19,146.24  "
FireWrap® Grip Kit Yellow,04/26/2022,Sales Receipt,7819,,"FIREWRAP® GRIP KIT
Color: Yellow",1,27.95  ,27.95  ,"19,174.19  "
FireWrap® Grip Kit Yellow,04/29/2022,Sales Receipt,7842,,"FIREWRAP® GRIP KIT
Color: Yellow",2,22.95  ,45.90  ,"19,220.09  "
FireWrap® Grip Kit Yellow,05/05/2022,Sales Receipt,7909,,"FIREWRAP® GRIP KIT
Color: Yellow",1,22.95  ,22.95  ,"19,243.04  "
FireWrap® Grip Kit Yellow,05/08/2022,Sales Receipt,7923,,"FIREWRAP® GRIP KIT
Color: Yellow",1,27.95  ,27.95  ,"19,270.99  "
FireWrap® Grip Kit Yellow,05/17/2022,Sales Receipt,7967,,"FIREWRAP® GRIP KIT
Color: Yellow",2,27.95  ,55.90  ,"19,326.89  "
FireWrap® Grip Kit Yellow,05/17/2022,Sales Receipt,7965,,"FIREWRAP® GRIP KIT
Color: Yellow",1,27.95  ,27.95  ,"19,354.84  "
FireWrap® Grip Kit Yellow,06/03/2022,Sales Receipt,8049,,"FIREWRAP® GRIP KIT
Color: Yellow",2,27.95  ,55.90  ,"19,410.74  "
FireWrap® Grip Kit Yellow,06/05/2022,Sales Receipt,8055,,"FIREWRAP® GRIP KIT
Color: Yellow",1,27.95  ,27.95  ,"19,438.69  "
FireWrap® Grip Kit Yellow,06/07/2022,Sales Receipt,8064,,"FIREWRAP® GRIP KIT
Color: Yellow",1,27.95  ,27.95  ,"19,466.64  "
FireWrap® Grip Kit Yellow,06/09/2022,Sales Receipt,8086,,"FIREWRAP® GRIP KIT
Color: Yellow",1,27.95  ,27.95  ,"19,494.59  "
FireWrap® Grip Kit Yellow,06/13/2022,Sales Receipt,8114,,"FIREWRAP® GRIP KIT
Color: Yellow",3,27.95  ,83.85  ,"19,578.44  "
FireWrap® Grip Kit Yellow,06/15/2022,Sales Receipt,8127,,"FIREWRAP® GRIP KIT
Color: Yellow",12,27.95  ,335.40  ,"19,913.84  "
FireWrap® Grip Kit Yellow,06/20/2022,Invoice,8161,,FireWrap® Grip Kit Yellow,1,27.95  ,27.95  ,"19,941.79  "
FireWrap® Grip Kit Yellow,06/27/2022,Sales Receipt,8187,,"FIREWRAP® GRIP KIT
Color: Yellow",3,27.95  ,83.85  ,"20,025.64  "
FireWrap® Grip Kit Yellow,07/14/2022,Sales Receipt,8300,,"FIREWRAP® GRIP KIT
Color: Yellow",1,27.95  ,27.95  ,"20,053.59  "
FireWrap® Grip Kit Yellow,07/14/2022,Sales Receipt,8297,,"FIREWRAP® GRIP KIT
Color: Yellow",1,27.95  ,27.95  ,"20,081.54  "
FireWrap® Grip Kit Yellow,07/19/2022,Sales Receipt,8323,,"FIREWRAP® GRIP KIT
Color: Yellow",4,27.95  ,111.80  ,"20,193.34  "
FireWrap® Grip Kit Yellow,07/23/2022,Sales Receipt,8348,,"FIREWRAP® GRIP KIT
Color: Yellow",1,27.95  ,27.95  ,"20,221.29  "
FireWrap® Grip Kit Yellow,07/25/2022,Refund,R-8161,,FireWrap® Grip Kit Yellow,-1,27.95  ,-27.95  ,"20,193.34  "
FireWrap® Grip Kit Yellow,07/30/2022,Sales Receipt,8400,,"FIREWRAP® GRIP KIT
Color: Yellow",3,27.95  ,83.85  ,"20,277.19  "
FireWrap® Grip Kit Yellow,08/01/2022,Sales Receipt,8408,,"FIREWRAP® GRIP KIT
Color: Yellow",2,27.95  ,55.90  ,"20,333.09  "
FireWrap® Grip Kit Yellow,08/02/2022,Sales Receipt,8414,,"FIREWRAP® GRIP KIT
Color: Yellow",8,27.95  ,223.60  ,"20,556.69  "
FireWrap® Grip Kit Yellow,08/08/2022,Sales Receipt,8445,,"FIREWRAP® GRIP KIT
Color: Yellow",5,27.95  ,139.75  ,"20,696.44  "
FireWrap® Grip Kit Yellow,08/12/2022,Sales Receipt,8473,,"FIREWRAP® GRIP KIT
Color: Yellow",1,27.95  ,27.95  ,"20,724.39  "
FireWrap® Grip Kit Yellow,08/18/2022,Sales Receipt,8512,,"FIREWRAP® GRIP KIT
Color: Yellow",4,27.95  ,111.80  ,"20,836.19  "
FireWrap® Grip Kit Yellow,08/22/2022,Sales Receipt,8539,,"FIREWRAP® GRIP KIT
Color: Yellow",1,27.95  ,27.95  ,"20,864.14  "
FireWrap® Grip Kit Yellow,08/30/2022,Sales Receipt,8588,,"FIREWRAP® GRIP KIT
Color: Yellow",1,27.95  ,27.95  ,"20,892.09  "
FireWrap® Grip Kit Yellow,09/06/2022,Sales Receipt,8636,,"FIREWRAP® GRIP KIT
Color: Yellow",4,27.95  ,111.80  ,"21,003.89  "
FireWrap® Grip Kit Yellow,09/17/2022,Sales Receipt,8700,,"FIREWRAP® GRIP KIT
Color: Yellow",1,27.95  ,27.95  ,"21,031.84  "
FireWrap® Grip Kit Yellow,09/26/2022,Sales Receipt,8753,,"FIREWRAP® GRIP KIT
Color: Yellow",1,27.95  ,27.95  ,"21,059.79  "
FireWrap® Grip Kit Yellow,10/03/2022,Sales Receipt,8829,,"FIREWRAP® GRIP KIT
Color: Yellow",1,27.95  ,27.95  ,"21,087.74  "
FireWrap® Grip Kit Yellow,10/20/2022,Sales Receipt,8946,,"FIREWRAP® GRIP KIT
Color: Yellow",2,27.95  ,55.90  ,"21,143.64  "
FireWrap® Grip Kit Yellow,10/21/2022,Sales Receipt,8959,,"FIREWRAP® GRIP KIT
Color: Yellow",1,27.95  ,27.95  ,"21,171.59  "
FireWrap® Grip Kit Yellow,11/10/2022,Sales Receipt,M-113-0984600-2732217,,FireWrap® Grip Kit - Yellow,1,28.95  ,28.95  ,"21,200.54  "
FireWrap® Grip Kit Yellow,11/15/2022,Sales Receipt,M-111-9048431-3236263,,FireWrap® Grip Kit - Yellow,1,28.95  ,28.95  ,"21,229.49  "
FireWrap® Grip Kit Yellow,11/24/2022,Sales Receipt,9153,,"FIREWRAP® GRIP KIT
Color: Yellow",2,27.95  ,55.90  ,"21,285.39  "
FireWrap® Grip Kit Yellow,11/28/2022,Sales Receipt,9200,,"FIREWRAP® GRIP KIT
Color: Yellow",6,27.95  ,167.70  ,"21,453.09  "
FireWrap® Grip Kit Yellow,11/28/2022,Sales Receipt,9202,,"FIREWRAP® GRIP KIT
Color: Yellow",10,27.95  ,279.50  ,"21,732.59  "
FireWrap® Grip Kit Yellow,11/28/2022,Sales Receipt,9197,,"FIREWRAP® GRIP KIT
Color: Yellow",7,27.95  ,195.65  ,"21,928.24  "
FireWrap® Grip Kit Yellow,11/30/2022,Sales Receipt,M-114-8106992-1417852,,FireWrap® Grip Kit - Yellow,1,28.95  ,28.95  ,"21,957.19  "
FireWrap® Grip Kit Yellow,12/03/2022,Sales Receipt,M-113-2927290-1983463,,FireWrap® Grip Kit - Yellow,1,28.95  ,28.95  ,"21,986.14  "
FireWrap® Grip Kit Yellow,12/07/2022,Sales Receipt,9276,,"FIREWRAP® GRIP KIT
Color: Yellow",1,27.95  ,27.95  ,"22,014.09  "
FireWrap® Grip Kit Yellow,12/08/2022,Sales Receipt,9277,,"FIREWRAP® GRIP KIT
Color: Yellow",1,27.95  ,27.95  ,"22,042.04  "
FireWrap® Grip Kit Yellow,12/14/2022,Sales Receipt,9324,,"FIREWRAP® GRIP KIT
Color: Yellow",1,27.95  ,27.95  ,"22,069.99  "
FireWrap® Grip Kit Yellow,12/15/2022,Sales Receipt,9329,,"FIREWRAP® GRIP KIT
Color: Yellow",1,27.95  ,27.95  ,"22,097.94  "
FireWrap® Grip Kit Yellow,12/26/2022,Sales Receipt,9398,,"FIREWRAP® GRIP KIT
Color: Yellow",1,27.95  ,27.95  ,"22,125.89  "
FireWrap® Grip Kit Yellow,12/27/2022,Sales Receipt,9403,,"FIREWRAP® GRIP KIT
Color: Yellow",1,27.95  ,27.95  ,"22,153.84  "
FireWrap® Grip Kit Yellow,01/02/2023,Sales Receipt,M-111-9610982-1768243,,FireWrap® Grip Kit - Yellow,1,28.95  ,28.95  ,"22,182.79  "
FireWrap® Grip Kit Yellow,01/05/2023,Sales Receipt,M-113-5667766-0645026,,FireWrap® Grip Kit - Yellow,1,28.95  ,28.95  ,"22,211.74  "
FireWrap® Grip Kit Yellow,01/06/2023,Sales Receipt,9464,,"FIREWRAP® GRIP KIT
Color: Yellow",2,27.95  ,55.90  ,"22,267.64  "
FireWrap® Grip Kit Yellow,01/06/2023,Sales Receipt,9465,,"FIREWRAP® GRIP KIT
Color: Yellow",2,27.95  ,55.90  ,"22,323.54  "
Total for FireWrap® Grip Kit Yellow,,,,,,868,,"$	22,323.54  ",
FireWrap® Grip Kit GLOW - Aqua,,,,,,,,,
FireWrap® Grip Kit GLOW - Aqua,03/26/2021,Invoice,M-032621-014,,FIREWRAP® GRIP KIT	GLOW Aqua,1,28.50  ,28.50  ,28.50  
FireWrap® Grip Kit GLOW - Aqua,07/13/2021,Invoice,M-071321-001,,FIREWRAP® GRIP KIT	GLOW Aqua,3,28.50  ,85.50  ,114.00  
FireWrap® Grip Kit GLOW - Aqua,10/27/2021,Invoice,M-102721-005,,FIREWRAP® GRIP KIT	GLOW Aqua,1,28.50  ,28.50  ,142.50  
FireWrap® Grip Kit GLOW - Aqua,12/02/2021,Invoice,M-120221-001,,FIREWRAP® GRIP KIT	GLOW Aqua,1,32.99  ,32.99  ,175.49  
FireWrap® Grip Kit GLOW - Aqua,12/03/2021,Invoice,M-120321-001,,FIREWRAP® GRIP KIT	GLOW Aqua,2,28.50  ,57.00  ,232.49  
FireWrap® Grip Kit GLOW - Aqua,12/22/2021,Invoice,M-122221-001,,FIREWRAP® GRIP KIT	GLOW Aqua,1,28.50  ,28.50  ,260.99  
FireWrap® Grip Kit GLOW - Aqua,12/28/2021,Invoice,M-122821-001,,FIREWRAP® GRIP KIT	GLOW Aqua,2,28.50  ,57.00  ,317.99  
FireWrap® Grip Kit GLOW - Aqua,01/12/2022,Invoice,M-011222-004,,FIREWRAP® GRIP KIT	GLOW Aqua,2,28.50  ,57.00  ,374.99  
FireWrap® Grip Kit GLOW - Aqua,02/04/2022,Invoice,M-020422-001,,FIREWRAP® GRIP KIT	GLOW Aqua,7,31.50  ,220.50  ,595.49  
FireWrap® Grip Kit GLOW - Aqua,02/22/2022,Invoice,M-022122-005,,FIREWRAP® GRIP KIT	GLOW Aqua,1,31.50  ,31.50  ,626.99  
FireWrap® Grip Kit GLOW - Aqua,03/04/2022,Invoice,M-030422-004,,FIREWRAP® GRIP KIT	GLOW Aqua,3,31.50  ,94.50  ,721.49  
FireWrap® Grip Kit GLOW - Aqua,03/11/2022,Invoice,M-031122-004,,FIREWRAP® GRIP KIT	GLOW Aqua,8,37.95  ,303.60  ,"1,025.09  "
FireWrap® Grip Kit GLOW - Aqua,04/09/2022,Invoice,M-040922-001,,FIREWRAP® GRIP KIT	GLOW Aqua - UPGRADE FOR TSR FIRE MAUL,1,12.95  ,12.95  ,"1,038.04  "
FireWrap® Grip Kit GLOW - Aqua,05/03/2022,Invoice,M-030122-003,,FIREWRAP® GRIP KIT	GLOW Aqua,2,26.00  ,52.00  ,"1,090.04  "
FireWrap® Grip Kit GLOW - Aqua,05/10/2022,Invoice,M-050322-005,,FIREWRAP® GRIP KIT	GLOW Aqua,1,31.50  ,31.50  ,"1,121.54  "
FireWrap® Grip Kit GLOW - Aqua,05/10/2022,Invoice,M-050322-006,,FIREWRAP® GRIP KIT	GLOW Aqua,4,31.50  ,126.00  ,"1,247.54  "
FireWrap® Grip Kit GLOW - Aqua,05/31/2022,Invoice,M-053122-002,,FIREWRAP® GRIP KIT	GLOW Aqua,7,26.00  ,182.00  ,"1,429.54  "
FireWrap® Grip Kit GLOW - Aqua,06/10/2022,Invoice,M-061022-009,,FIREWRAP® GRIP KIT	GLOW Aqua,2,31.50  ,63.00  ,"1,492.54  "
FireWrap® Grip Kit GLOW - Aqua,07/12/2022,Invoice,M-071222-004,,FIREWRAP® GRIP KIT	GLOW Aqua,1,31.50  ,31.50  ,"1,524.04  "
FireWrap® Grip Kit GLOW - Aqua,08/08/2022,Invoice,M-080822-005,,FIREWRAP® GRIP KIT	GLOW Aqua,6,31.50  ,189.00  ,"1,713.04  "
FireWrap® Grip Kit GLOW - Aqua,08/09/2022,Invoice,M-080922-001,,FIREWRAP® GRIP KIT	GLOW Aqua,8,31.50  ,252.00  ,"1,965.04  "
FireWrap® Grip Kit GLOW - Aqua,09/08/2022,Invoice,M-082522-003,,FIREWRAP® GRIP KIT	GLOW Aqua,2,31.50  ,63.00  ,"2,028.04  "
FireWrap® Grip Kit GLOW - Aqua,09/13/2022,Invoice,M-091322-001,,FIREWRAP® GRIP KIT	GLOW Aqua,2,31.50  ,63.00  ,"2,091.04  "
FireWrap® Grip Kit GLOW - Aqua,09/15/2022,Invoice,M-090722-002B,,FIREWRAP® GRIP KIT	GLOW Aqua,1,31.50  ,31.50  ,"2,122.54  "
FireWrap® Grip Kit GLOW - Aqua,10/31/2022,Invoice,M-110122-001,,FIREWRAP® GRIP KIT	GLOW Aqua,1,31.50  ,31.50  ,"2,154.04  "
FireWrap® Grip Kit GLOW - Aqua,10/31/2022,Invoice,M-103122-002,,FIREWRAP® GRIP KIT	GLOW Aqua,5,31.50  ,157.50  ,"2,311.54  "
FireWrap® Grip Kit GLOW - Aqua,12/13/2022,Invoice,M-121322-001,,FIREWRAP® GRIP KIT	GLOW Aqua,1,31.50  ,31.50  ,"2,343.04  "
FireWrap® Grip Kit GLOW - Aqua,01/10/2023,Invoice,M-011023-001,,FIREWRAP® GRIP KIT	GLOW Aqua,1,31.50  ,31.50  ,"2,374.54  "
Total for FireWrap® Grip Kit GLOW - Aqua,,,,,,77,,"$	2,374.54  ",
FireWrap® Grip Kit GLOW - Green ( 927 ),,,,,,,,,
FireWrap® Grip Kit GLOW - Green ( 927 ),03/26/2021,Invoice,M-032621-006,,FIREWRAP® GRIP KIT	GLOW Green,1,28.50  ,28.50  ,28.50  
FireWrap® Grip Kit GLOW - Green ( 927 ),03/26/2021,Invoice,M-032621-014,,FIREWRAP® GRIP KIT	GLOW Green,3,28.50  ,85.50  ,114.00  
FireWrap® Grip Kit GLOW - Green ( 927 ),03/26/2021,Invoice,M-032621-012,,FIREWRAP® GRIP KIT	GLOW Green,2,28.50  ,57.00  ,171.00  
FireWrap® Grip Kit GLOW - Green ( 927 ),03/27/2021,Invoice,M-032721-001,,FIREWRAP® GRIP KIT	GLOW Green,3,28.50  ,85.50  ,256.50  
FireWrap® Grip Kit GLOW - Green ( 927 ),03/27/2021,Invoice,M-032721-006,,FIREWRAP® GRIP KIT	GLOW Green,2,28.50  ,57.00  ,313.50  
FireWrap® Grip Kit GLOW - Green ( 927 ),03/30/2021,Invoice,M-033021-006,,FIREWRAP® GRIP KIT	GLOW Green,1,28.50  ,28.50  ,342.00  
FireWrap® Grip Kit GLOW - Green ( 927 ),03/30/2021,Invoice,M-033021-008,,FIREWRAP® GRIP KIT	GLOW Green,4,28.50  ,114.00  ,456.00  
FireWrap® Grip Kit GLOW - Green ( 927 ),04/07/2021,Invoice,M-040721-003,,FIREWRAP® GRIP KIT	GLOW Green,4,28.50  ,114.00  ,570.00  
FireWrap® Grip Kit GLOW - Green ( 927 ),04/13/2021,Invoice,M-041321-009,,FIREWRAP® GRIP KIT	GLOW Green,6,28.50  ,171.00  ,741.00  
FireWrap® Grip Kit GLOW - Green ( 927 ),05/03/2021,Invoice,M-050321-003,,FIREWRAP® GRIP KIT	GLOW Green,2,28.50  ,57.00  ,798.00  
FireWrap® Grip Kit GLOW - Green ( 927 ),05/20/2021,Invoice,M-052021-001,,FIREWRAP® GRIP KIT	GLOW Green,5,28.50  ,142.50  ,940.50  
FireWrap® Grip Kit GLOW - Green ( 927 ),06/10/2021,Invoice,M-061021-001,,FIREWRAP® GRIP KIT	GLOW Green,32,28.50  ,912.00  ,"1,852.50  "
FireWrap® Grip Kit GLOW - Green ( 927 ),06/16/2021,Invoice,M-061621-001,,FIREWRAP® GRIP KIT	GLOW Green,1,28.50  ,28.50  ,"1,881.00  "
FireWrap® Grip Kit GLOW - Green ( 927 ),07/13/2021,Invoice,M-071321-001,,FIREWRAP® GRIP KIT	GLOW Green,4,28.50  ,114.00  ,"1,995.00  "
FireWrap® Grip Kit GLOW - Green ( 927 ),07/26/2021,Invoice,M-072621-002,,FIREWRAP® GRIP KIT	GLOW Green,2,28.50  ,57.00  ,"2,052.00  "
FireWrap® Grip Kit GLOW - Green ( 927 ),08/17/2021,Invoice,M-081221-001,,FIREWRAP® GRIP KIT	GLOW Green,4,37.95  ,151.80  ,"2,203.80  "
FireWrap® Grip Kit GLOW - Green ( 927 ),09/07/2021,Invoice,M-090721-002,,FIREWRAP® GRIP KIT	GLOW Green,4,28.50  ,114.00  ,"2,317.80  "
FireWrap® Grip Kit GLOW - Green ( 927 ),10/13/2021,Invoice,M-101221-002-B,,FIREWRAP® GRIP KIT	GLOW Green,2,28.50  ,57.00  ,"2,374.80  "
FireWrap® Grip Kit GLOW - Green ( 927 ),11/02/2021,Invoice,M-110221-001,,FIREWRAP® GRIP KIT	GLOW Green,1,28.50  ,28.50  ,"2,403.30  "
FireWrap® Grip Kit GLOW - Green ( 927 ),12/02/2021,Invoice,M-120221-001,,FIREWRAP® GRIP KIT	GLOW Green,2,32.99  ,65.98  ,"2,469.28  "
FireWrap® Grip Kit GLOW - Green ( 927 ),01/04/2022,Invoice,M-010422-001,,FIREWRAP® GRIP KIT	GLOW Green,1,28.50  ,28.50  ,"2,497.78  "
FireWrap® Grip Kit GLOW - Green ( 927 ),01/04/2022,Invoice,M-010422-003,,FIREWRAP® GRIP KIT	GLOW Green,2,28.50  ,57.00  ,"2,554.78  "
FireWrap® Grip Kit GLOW - Green ( 927 ),01/04/2022,Invoice,M-010422-002,,FIREWRAP® GRIP KIT	GLOW Green,1,28.50  ,28.50  ,"2,583.28  "
FireWrap® Grip Kit GLOW - Green ( 927 ),01/11/2022,Invoice,M-011122-002,,FIREWRAP® GRIP KIT	GLOW Green,1,28.50  ,28.50  ,"2,611.78  "
FireWrap® Grip Kit GLOW - Green ( 927 ),01/12/2022,Invoice,M-011222-004,,FIREWRAP® GRIP KIT	GLOW Green,2,28.50  ,57.00  ,"2,668.78  "
FireWrap® Grip Kit GLOW - Green ( 927 ),02/01/2022,Invoice,M-020122-004,,FIREWRAP® GRIP KIT	GLOW Green,10,37.90  ,379.00  ,"3,047.78  "
FireWrap® Grip Kit GLOW - Green ( 927 ),02/04/2022,Invoice,M-020422-001,,FIREWRAP® GRIP KIT	GLOW Green,6,31.50  ,189.00  ,"3,236.78  "
FireWrap® Grip Kit GLOW - Green ( 927 ),02/22/2022,Invoice,M-022122-005,,FIREWRAP® GRIP KIT	GLOW Green,3,31.50  ,94.50  ,"3,331.28  "
FireWrap® Grip Kit GLOW - Green ( 927 ),03/04/2022,Invoice,M-030422-004,,FIREWRAP® GRIP KIT	GLOW Green,1,31.50  ,31.50  ,"3,362.78  "
FireWrap® Grip Kit GLOW - Green ( 927 ),03/11/2022,Invoice,M-031122-004,,FIREWRAP® GRIP KIT	GLOW Green,4,31.50  ,126.00  ,"3,488.78  "
FireWrap® Grip Kit GLOW - Green ( 927 ),03/18/2022,Invoice,M-030122-005B,,FIREWRAP® GRIP KIT	GLOW Green,0,,0.00  ,"3,488.78  "
FireWrap® Grip Kit GLOW - Green ( 927 ),04/28/2022,Invoice,M-040522-001,,FIREWRAP® GRIP KIT	GLOW Green,1,31.50  ,31.50  ,"3,520.28  "
FireWrap® Grip Kit GLOW - Green ( 927 ),05/03/2022,Invoice,M-041822-001,,FIREWRAP® GRIP KIT	GLOW Green,1,31.50  ,31.50  ,"3,551.78  "
FireWrap® Grip Kit GLOW - Green ( 927 ),05/03/2022,Invoice,M-030122-003,,FIREWRAP® GRIP KIT	GLOW Green,3,26.00  ,78.00  ,"3,629.78  "
FireWrap® Grip Kit GLOW - Green ( 927 ),05/03/2022,Invoice,M-041222-004,,FIREWRAP® GRIP KIT	GLOW Green,1,31.50  ,31.50  ,"3,661.28  "
FireWrap® Grip Kit GLOW - Green ( 927 ),05/10/2022,Invoice,M-050322-002,,FIREWRAP® GRIP KIT	GLOW Green,1,31.50  ,31.50  ,"3,692.78  "
FireWrap® Grip Kit GLOW - Green ( 927 ),05/10/2022,Invoice,M-050322-006,,FIREWRAP® GRIP KIT	GLOW Green,3,31.50  ,94.50  ,"3,787.28  "
FireWrap® Grip Kit GLOW - Green ( 927 ),05/20/2022,Invoice,M-050922-001,,FIREWRAP® GRIP KIT	GLOW Green,1,31.50  ,31.50  ,"3,818.78  "
FireWrap® Grip Kit GLOW - Green ( 927 ),05/26/2022,Invoice,M-052622-005,,FIREWRAP® GRIP KIT	GLOW Green,2,31.50  ,63.00  ,"3,881.78  "
FireWrap® Grip Kit GLOW - Green ( 927 ),05/31/2022,Invoice,M-053122-002,,FIREWRAP® GRIP KIT	GLOW Green,4,26.00  ,104.00  ,"3,985.78  "
FireWrap® Grip Kit GLOW - Green ( 927 ),06/23/2022,Invoice,M-062322-001,,FIREWRAP® GRIP KIT	GLOW Green,1,31.50  ,31.50  ,"4,017.28  "
FireWrap® Grip Kit GLOW - Green ( 927 ),06/23/2022,Invoice,M-062322-002,,FIREWRAP® GRIP KIT	GLOW Green,4,31.50  ,126.00  ,"4,143.28  "
FireWrap® Grip Kit GLOW - Green ( 927 ),07/05/2022,Invoice,M-070522-002,,FIREWRAP® GRIP KIT	GLOW Green,0,,0.00  ,"4,143.28  "
FireWrap® Grip Kit GLOW - Green ( 927 ),07/18/2022,Invoice,M-071822-004,,FIREWRAP® GRIP KIT	GLOW Green,1,31.50  ,31.50  ,"4,174.78  "
FireWrap® Grip Kit GLOW - Green ( 927 ),07/26/2022,Invoice,M-072622-001,,FIREWRAP® GRIP KIT	GLOW Green,2,31.50  ,63.00  ,"4,237.78  "
FireWrap® Grip Kit GLOW - Green ( 927 ),07/30/2022,Invoice,M-073022-003,,FIREWRAP® GRIP KIT	GLOW Green,1,31.50  ,31.50  ,"4,269.28  "
FireWrap® Grip Kit GLOW - Green ( 927 ),07/30/2022,Invoice,M-073022-004,,FIREWRAP® GRIP KIT	GLOW Green,10,31.50  ,315.00  ,"4,584.28  "
FireWrap® Grip Kit GLOW - Green ( 927 ),08/10/2022,Invoice,M-081022-001,,FIREWRAP® GRIP KIT	GLOW Green,10,40.95  ,409.50  ,"4,993.78  "
FireWrap® Grip Kit GLOW - Green ( 927 ),08/17/2022,Invoice,M-081722-002,,FIREWRAP® GRIP KIT	GLOW Green,4,31.50  ,126.00  ,"5,119.78  "
FireWrap® Grip Kit GLOW - Green ( 927 ),10/02/2022,Invoice,M-100222-001,,FIREWRAP® GRIP KIT	GLOW Green,3,31.50  ,94.50  ,"5,214.28  "
FireWrap® Grip Kit GLOW - Green ( 927 ),10/31/2022,Invoice,M-103122-002,,FIREWRAP® GRIP KIT	GLOW Green,5,31.50  ,157.50  ,"5,371.78  "
FireWrap® Grip Kit GLOW - Green ( 927 ),10/31/2022,Invoice,M-110122-001,,FIREWRAP® GRIP KIT	GLOW Green,1,31.50  ,31.50  ,"5,403.28  "
FireWrap® Grip Kit GLOW - Green ( 927 ),11/28/2022,Invoice,M-112222-005,,FIREWRAP® GRIP KIT	GLOW Green,11,31.50  ,346.50  ,"5,749.78  "
FireWrap® Grip Kit GLOW - Green ( 927 ),12/07/2022,Invoice,M-120722-001,,FIREWRAP® GRIP KIT	GLOW Green,2,31.50  ,63.00  ,"5,812.78  "
FireWrap® Grip Kit GLOW - Green ( 927 ),12/12/2022,Invoice,M-121222-005,,FIREWRAP® GRIP KIT	GLOW Green,6,31.50  ,189.00  ,"6,001.78  "
FireWrap® Grip Kit GLOW - Green ( 927 ),12/12/2022,Invoice,M-121222-008,,FIREWRAP® GRIP KIT	GLOW Green,2,31.50  ,63.00  ,"6,064.78  "
FireWrap® Grip Kit GLOW - Green ( 927 ),12/13/2022,Invoice,M-121322-001,,FIREWRAP® GRIP KIT	GLOW Green,2,31.50  ,63.00  ,"6,127.78  "
FireWrap® Grip Kit GLOW - Green ( 927 ),01/06/2023,Invoice,M-090922-002,,FIREWRAP® GRIP KIT	GLOW Green,6,31.50  ,189.00  ,"6,316.78  "
Total for FireWrap® Grip Kit GLOW - Green ( 927 ),,,,,,204,,"$	6,316.78  ",
FireWrap® Grip Kit Black,,,,,,,,,
FireWrap® Grip Kit Black,03/26/2021,Invoice,M-032621-008,,FIREWRAP® GRIP KIT 	Black,10,18.75  ,187.50  ,187.50  
FireWrap® Grip Kit Black,03/26/2021,Invoice,M-032621-010,,FIREWRAP® GRIP KIT 	Black,1,18.75  ,18.75  ,206.25  
FireWrap® Grip Kit Black,03/26/2021,Invoice,M-032621-014,,FIREWRAP® GRIP KIT 	Black,2,18.75  ,37.50  ,243.75  
FireWrap® Grip Kit Black,03/26/2021,Invoice,M-032621-015,,FIREWRAP® GRIP KIT 	Black,36,18.75  ,675.00  ,918.75  
FireWrap® Grip Kit Black,03/26/2021,Invoice,M-032621-005,,FIREWRAP® GRIP KIT 	Black,1,18.75  ,18.75  ,937.50  
FireWrap® Grip Kit Black,07/08/2021,Invoice,M-070821-001,,FIREWRAP® GRIP KIT 	Black,10,18.75  ,187.50  ,"1,125.00  "
FireWrap® Grip Kit Black,09/07/2021,Invoice,M-090721-002,,FIREWRAP® GRIP KIT 	Black,6,18.75  ,112.50  ,"1,237.50  "
FireWrap® Grip Kit Black,09/14/2021,Invoice,M-091421-002,,FIREWRAP® GRIP KIT 	Black,1,24.99  ,24.99  ,"1,262.49  "
FireWrap® Grip Kit Black,09/20/2021,Invoice,M-092021-001,,FIREWRAP® GRIP KIT 	Black,5,18.75  ,93.75  ,"1,356.24  "
FireWrap® Grip Kit Black,09/22/2021,Invoice,M-092221-001,,FIREWRAP® GRIP KIT 	Black,3,18.75  ,56.25  ,"1,412.49  "
FireWrap® Grip Kit Black,09/22/2021,Invoice,M-092221-002,,FIREWRAP® GRIP KIT 	Black,20,24.99  ,499.80  ,"1,912.29  "
FireWrap® Grip Kit Black,09/30/2021,Invoice,M-093021-001,,FIREWRAP® GRIP KIT 	Black,12,19.99  ,239.88  ,"2,152.17  "
FireWrap® Grip Kit Black,10/20/2021,Invoice,M-102021-002,,FIREWRAP® GRIP KIT 	Black,5,18.75  ,93.75  ,"2,245.92  "
FireWrap® Grip Kit Black,10/20/2021,Invoice,M-102021-005,,FIREWRAP® GRIP KIT 	Black,2,18.75  ,37.50  ,"2,283.42  "
FireWrap® Grip Kit Black,10/20/2021,Invoice,M-102021-003,,FIREWRAP® GRIP KIT 	Black,2,18.75  ,37.50  ,"2,320.92  "
FireWrap® Grip Kit Black,10/20/2021,Invoice,M-102021-006,,FIREWRAP® GRIP KIT 	Black,6,18.75  ,112.50  ,"2,433.42  "
FireWrap® Grip Kit Black,10/28/2021,Invoice,M-102821-005,,FIREWRAP® GRIP KIT 	Black,1,24.95  ,24.95  ,"2,458.37  "
FireWrap® Grip Kit Black,11/02/2021,Invoice,M-091021-001,,FIREWRAP® GRIP KIT 	Black,3,18.75  ,56.25  ,"2,514.62  "
FireWrap® Grip Kit Black,11/19/2021,Invoice,M-111921-001,,FIREWRAP® GRIP KIT 	Black,1,18.75  ,18.75  ,"2,533.37  "
FireWrap® Grip Kit Black,11/19/2021,Invoice,M-111921-002,,FIREWRAP® GRIP KIT 	Black,10,18.75  ,187.50  ,"2,720.87  "
FireWrap® Grip Kit Black,11/25/2021,Invoice,M-112521-001,,FIREWRAP® GRIP KIT 	Black,7,24.95  ,174.65  ,"2,895.52  "
FireWrap® Grip Kit Black,11/30/2021,Invoice,M-113021-003,,FIREWRAP® GRIP KIT 	Black,1,18.75  ,18.75  ,"2,914.27  "
FireWrap® Grip Kit Black,12/02/2021,Invoice,M-120221-001,,FIREWRAP® GRIP KIT 	Black,2,19.99  ,39.98  ,"2,954.25  "
FireWrap® Grip Kit Black,12/09/2021,Invoice,M-120921-001,,FIREWRAP® GRIP KIT 	Black,1,18.75  ,18.75  ,"2,973.00  "
FireWrap® Grip Kit Black,12/17/2021,Invoice,M-121721-002,,FIREWRAP® GRIP KIT 	Black,5,18.75  ,93.75  ,"3,066.75  "
FireWrap® Grip Kit Black,12/17/2021,Invoice,M-121721-003,,FIREWRAP® GRIP KIT 	Black,1,18.75  ,18.75  ,"3,085.50  "
FireWrap® Grip Kit Black,12/17/2021,Invoice,M-121721-004,,FIREWRAP® GRIP KIT 	Black,3,18.75  ,56.25  ,"3,141.75  "
FireWrap® Grip Kit Black,12/20/2021,Invoice,M-122021-003,,FIREWRAP® GRIP KIT 	Black,15,24.95  ,374.25  ,"3,516.00  "
FireWrap® Grip Kit Black,01/04/2022,Invoice,M-010422-003,,FIREWRAP® GRIP KIT 	Black,4,18.75  ,75.00  ,"3,591.00  "
FireWrap® Grip Kit Black,01/12/2022,Invoice,M-011222-004,,FIREWRAP® GRIP KIT 	Black,3,18.75  ,56.25  ,"3,647.25  "
FireWrap® Grip Kit Black,01/18/2022,Invoice,M-011822-006,,FIREWRAP® GRIP KIT 	Black,0,,0.00  ,"3,647.25  "
FireWrap® Grip Kit Black,01/26/2022,Invoice,M-012622-001,,FIREWRAP® GRIP KIT 	Black,2,18.75  ,37.50  ,"3,684.75  "
FireWrap® Grip Kit Black,01/31/2022,Invoice,M-010522-001,,FIREWRAP® GRIP KIT 	Black,5,18.75  ,93.75  ,"3,778.50  "
FireWrap® Grip Kit Black,02/01/2022,Invoice,M-020122-002,,FIREWRAP® GRIP KIT 	Black,17,21.75  ,369.75  ,"4,148.25  "
FireWrap® Grip Kit Black,02/16/2022,Invoice,M-021622-001,,FIREWRAP® GRIP KIT 	Black,1,21.75  ,21.75  ,"4,170.00  "
FireWrap® Grip Kit Black,02/22/2022,Invoice,M-022122-005,,FIREWRAP® GRIP KIT 	Black,5,21.75  ,108.75  ,"4,278.75  "
FireWrap® Grip Kit Black,02/25/2022,Invoice,M-022522-001,,FIREWRAP® GRIP KIT 	Black,4,18.75  ,75.00  ,"4,353.75  "
FireWrap® Grip Kit Black,03/01/2022,Invoice,M-030122-002,,FIREWRAP® GRIP KIT 	Black,1,21.75  ,21.75  ,"4,375.50  "
FireWrap® Grip Kit Black,03/11/2022,Invoice,M-031122-004,,FIREWRAP® GRIP KIT 	Black,1,21.75  ,21.75  ,"4,397.25  "
FireWrap® Grip Kit Black,03/17/2022,Invoice,M-031722-003,,FIREWRAP® GRIP KIT 	Black,1,21.75  ,21.75  ,"4,419.00  "
FireWrap® Grip Kit Black,03/18/2022,Invoice,M-030122-005B,,FIREWRAP® GRIP KIT 	Black,0,,0.00  ,"4,419.00  "
FireWrap® Grip Kit Black,03/21/2022,Invoice,M-020422-003,,FIREWRAP® GRIP KIT 	Black,2,21.75  ,43.50  ,"4,462.50  "
FireWrap® Grip Kit Black,03/28/2022,Invoice,M-032822-005,,FIREWRAP® GRIP KIT 	Black,3,27.95  ,83.85  ,"4,546.35  "
FireWrap® Grip Kit Black,03/30/2022,Invoice,M-033022-005,,FIREWRAP® GRIP KIT 	Black,1,27.95  ,27.95  ,"4,574.30  "
FireWrap® Grip Kit Black,04/18/2022,Invoice,M-041822-002,,FIREWRAP® GRIP KIT 	Black,36,21.75  ,783.00  ,"5,357.30  "
FireWrap® Grip Kit Black,04/18/2022,Invoice,M-041822-005,,FIREWRAP® GRIP KIT 	Black,20,21.75  ,435.00  ,"5,792.30  "
FireWrap® Grip Kit Black,04/25/2022,Invoice,M-032822-002,,FIREWRAP® GRIP KIT 	Black,1,21.75  ,21.75  ,"5,814.05  "
FireWrap® Grip Kit Black,04/28/2022,Invoice,M-040522-001,,FIREWRAP® GRIP KIT 	Black,10,21.75  ,217.50  ,"6,031.55  "
FireWrap® Grip Kit Black,05/03/2022,Invoice,M-050322-007,,FIREWRAP® GRIP KIT 	Black,0,,0.00  ,"6,031.55  "
FireWrap® Grip Kit Black,05/03/2022,Invoice,M-041822-006,,FIREWRAP® GRIP KIT 	Black,5,21.75  ,108.75  ,"6,140.30  "
FireWrap® Grip Kit Black,05/03/2022,Invoice,M-041222-004,,FIREWRAP® GRIP KIT 	Black,2,21.75  ,43.50  ,"6,183.80  "
FireWrap® Grip Kit Black,05/03/2022,Invoice,M-030122-003,,FIREWRAP® GRIP KIT 	Black,20,16.50  ,330.00  ,"6,513.80  "
FireWrap® Grip Kit Black,05/03/2022,Invoice,M-041222-003,,FIREWRAP® GRIP KIT 	Black,1,21.75  ,21.75  ,"6,535.55  "
FireWrap® Grip Kit Black,05/10/2022,Invoice,M-050322-004,,FIREWRAP® GRIP KIT 	Black,1,21.75  ,21.75  ,"6,557.30  "
FireWrap® Grip Kit Black,05/11/2022,Invoice,M-051122-005,,FIREWRAP® GRIP KIT 	Black,1,21.75  ,21.75  ,"6,579.05  "
FireWrap® Grip Kit Black,05/12/2022,Invoice,M-050922-006,,FIREWRAP® GRIP KIT 	Black,12,27.95  ,335.40  ,"6,914.45  "
FireWrap® Grip Kit Black,05/17/2022,Invoice,M-051722-003,,FIREWRAP® GRIP KIT 	Black,1,21.75  ,21.75  ,"6,936.20  "
FireWrap® Grip Kit Black,05/20/2022,Invoice,M-050922-002,,FIREWRAP® GRIP KIT 	Black,1,21.75  ,21.75  ,"6,957.95  "
FireWrap® Grip Kit Black,05/23/2022,Invoice,M-052322-002,,FIREWRAP® GRIP KIT 	Black,1,21.75  ,21.75  ,"6,979.70  "
FireWrap® Grip Kit Black,05/23/2022,Invoice,M-052322-003,,FIREWRAP® GRIP KIT 	Black,2,21.75  ,43.50  ,"7,023.20  "
FireWrap® Grip Kit Black,05/26/2022,Invoice,M-052622-010,,FIREWRAP® GRIP KIT 	Black,1,21.75  ,21.75  ,"7,044.95  "
FireWrap® Grip Kit Black,05/26/2022,Invoice,M-052622-004,,FIREWRAP® GRIP KIT 	Black,6,21.75  ,130.50  ,"7,175.45  "
FireWrap® Grip Kit Black,05/26/2022,Invoice,M-052622-008,,FIREWRAP® GRIP KIT 	Black,3,21.75  ,65.25  ,"7,240.70  "
FireWrap® Grip Kit Black,05/31/2022,Invoice,M-053122-002,,FIREWRAP® GRIP KIT 	Black,28,16.50  ,462.00  ,"7,702.70  "
FireWrap® Grip Kit Black,06/07/2022,Invoice,M-060722-002,,FIREWRAP® GRIP KIT 	Black,1,21.75  ,21.75  ,"7,724.45  "
FireWrap® Grip Kit Black,06/07/2022,Invoice,M-060722-001,,FIREWRAP® GRIP KIT 	Black,5,21.75  ,108.75  ,"7,833.20  "
FireWrap® Grip Kit Black,06/10/2022,Invoice,M-060322-001,,FIREWRAP® GRIP KIT 	Black,6,21.75  ,130.50  ,"7,963.70  "
FireWrap® Grip Kit Black,06/10/2022,Invoice,M-061022-002,,FIREWRAP® GRIP KIT 	Black,1,21.75  ,21.75  ,"7,985.45  "
FireWrap® Grip Kit Black,06/19/2022,Invoice,M-061922-003,,FIREWRAP® GRIP KIT 	Black,3,21.75  ,65.25  ,"8,050.70  "
FireWrap® Grip Kit Black,06/22/2022,Invoice,M-062222-001,,FIREWRAP® GRIP KIT 	Black,8,21.75  ,174.00  ,"8,224.70  "
FireWrap® Grip Kit Black,06/23/2022,Invoice,M-062322-001,,FIREWRAP® GRIP KIT 	Black,12,21.75  ,261.00  ,"8,485.70  "
FireWrap® Grip Kit Black,06/23/2022,Invoice,M-052622-009,,FIREWRAP® GRIP KIT 	Black,10,21.75  ,217.50  ,"8,703.20  "
FireWrap® Grip Kit Black,07/05/2022,Invoice,M-070522-001,,FIREWRAP® GRIP KIT 	Black,1,21.75  ,21.75  ,"8,724.95  "
FireWrap® Grip Kit Black,07/18/2022,Invoice,M-071822-005,,FIREWRAP® GRIP KIT 	Black,2,21.75  ,43.50  ,"8,768.45  "
FireWrap® Grip Kit Black,07/21/2022,Invoice,M-072122-004,,FIREWRAP® GRIP KIT 	Black,5,21.75  ,108.75  ,"8,877.20  "
FireWrap® Grip Kit Black,07/21/2022,Invoice,M-072122-006,,FIREWRAP® GRIP KIT 	Black,4,21.75  ,87.00  ,"8,964.20  "
FireWrap® Grip Kit Black,07/21/2022,Invoice,M-072122-003,,FIREWRAP® GRIP KIT 	Black,8,21.75  ,174.00  ,"9,138.20  "
FireWrap® Grip Kit Black,07/21/2022,Invoice,M-072122-005,,FIREWRAP® GRIP KIT 	Black,1,21.75  ,21.75  ,"9,159.95  "
FireWrap® Grip Kit Black,07/25/2022,Invoice,M-072522-001,,FIREWRAP® GRIP KIT 	Black,6,21.75  ,130.50  ,"9,290.45  "
FireWrap® Grip Kit Black,07/25/2022,Invoice,M-072122-007,,FIREWRAP® GRIP KIT 	Black,5,27.95  ,139.75  ,"9,430.20  "
FireWrap® Grip Kit Black,08/08/2022,Invoice,M-080822-005,,FIREWRAP® GRIP KIT 	Black,17,21.75  ,369.75  ,"9,799.95  "
FireWrap® Grip Kit Black,08/25/2022,Invoice,M-082922-001,,FIREWRAP® GRIP KIT 	Black,1,21.75  ,21.75  ,"9,821.70  "
FireWrap® Grip Kit Black,09/05/2022,Invoice,M-082422-002,,FIREWRAP® GRIP KIT 	Black,6,21.75  ,130.50  ,"9,952.20  "
FireWrap® Grip Kit Black,09/08/2022,Invoice,M-082522-003,,FIREWRAP® GRIP KIT 	Black,3,21.75  ,65.25  ,"10,017.45  "
FireWrap® Grip Kit Black,09/13/2022,Invoice,M-091322-001,,FIREWRAP® GRIP KIT 	Black,2,21.75  ,43.50  ,"10,060.95  "
FireWrap® Grip Kit Black,09/15/2022,Invoice,M-091522-001,,FIREWRAP® GRIP KIT 	Black,2,21.75  ,43.50  ,"10,104.45  "
FireWrap® Grip Kit Black,09/20/2022,Invoice,M-092022-003,,FIREWRAP® GRIP KIT 	Black,5,21.75  ,108.75  ,"10,213.20  "
FireWrap® Grip Kit Black,09/26/2022,Invoice,M-092622-002,,FIREWRAP® GRIP KIT 	Black,5,21.75  ,108.75  ,"10,321.95  "
FireWrap® Grip Kit Black,10/05/2022,Invoice,M-100522-003,,FIREWRAP® GRIP KIT 	Black,1,21.75  ,21.75  ,"10,343.70  "
FireWrap® Grip Kit Black,10/31/2022,Invoice,M-103122-001,,FIREWRAP® GRIP KIT 	Black,10,21.75  ,217.50  ,"10,561.20  "
FireWrap® Grip Kit Black,10/31/2022,Invoice,M-103122-002,,FIREWRAP® GRIP KIT 	Black,5,21.75  ,108.75  ,"10,669.95  "
FireWrap® Grip Kit Black,11/05/2022,Invoice,M-110522-002,,FIREWRAP® GRIP KIT 	Black,2,21.75  ,43.50  ,"10,713.45  "
FireWrap® Grip Kit Black,11/05/2022,Invoice,M-110522-001,,FIREWRAP® GRIP KIT 	Black,1,21.75  ,21.75  ,"10,735.20  "
FireWrap® Grip Kit Black,11/13/2022,Invoice,M-111322-002,,FIREWRAP® GRIP KIT 	Black,1,21.75  ,21.75  ,"10,756.95  "
FireWrap® Grip Kit Black,11/28/2022,Invoice,M-112222-005,,FIREWRAP® GRIP KIT 	Black,5,21.75  ,108.75  ,"10,865.70  "
FireWrap® Grip Kit Black,11/28/2022,Invoice,M-110922-002,,FIREWRAP® GRIP KIT 	Black,16,21.75  ,348.00  ,"11,213.70  "
FireWrap® Grip Kit Black,11/28/2022,Invoice,M-112222-004,,FIREWRAP® GRIP KIT 	Black,20,21.75  ,435.00  ,"11,648.70  "
FireWrap® Grip Kit Black,12/06/2022,Invoice,M-120622-005,,FIREWRAP® GRIP KIT 	Black,6,27.95  ,167.70  ,"11,816.40  "
FireWrap® Grip Kit Black,12/07/2022,Invoice,M-112222-001,,FIREWRAP® GRIP KIT 	Black,6,21.75  ,130.50  ,"11,946.90  "
FireWrap® Grip Kit Black,12/12/2022,Invoice,M-121222-007,,FIREWRAP® GRIP KIT 	Black,5,21.75  ,108.75  ,"12,055.65  "
FireWrap® Grip Kit Black,12/15/2022,Invoice,M-121522-001,,FIREWRAP® GRIP KIT 	Black,10,27.95  ,279.50  ,"12,335.15  "
FireWrap® Grip Kit Black,12/27/2022,Invoice,M-122722-001,,FIREWRAP® GRIP KIT 	Black,11,21.75  ,239.25  ,"12,574.40  "
FireWrap® Grip Kit Black,12/27/2022,Invoice,M-121922-006,,FIREWRAP® GRIP KIT 	Black,4,21.75  ,87.00  ,"12,661.40  "
FireWrap® Grip Kit Black,01/06/2023,Invoice,M-010623-001,,FIREWRAP® GRIP KIT 	Black,6,21.75  ,130.50  ,"12,791.90  "
FireWrap® Grip Kit Black,01/06/2023,Invoice,M-121922-003,,FIREWRAP® GRIP KIT 	Black,10,21.75  ,217.50  ,"13,009.40  "
FireWrap® Grip Kit Black,01/10/2023,Invoice,M-011023-002,,FIREWRAP® GRIP KIT 	Black,1,21.75  ,21.75  ,"13,031.15  "
FireWrap® Grip Kit Black,01/10/2023,Invoice,M-011023-004,,FIREWRAP® GRIP KIT 	Black,6,21.75  ,130.50  ,"13,161.65  "
Total for FireWrap® Grip Kit Black,,,,,,619,,"$	13,161.65  ",
FireWrap® Grip Kit Blue,,,,,,,,,
FireWrap® Grip Kit Blue,03/26/2021,Invoice,M-032621-011,,FIREWRAP® GRIP KIT	Blue,2,18.75  ,37.50  ,37.50  
FireWrap® Grip Kit Blue,03/26/2021,Invoice,M-032621-004,,FIREWRAP® GRIP KIT	Blue,2,18.75  ,37.50  ,75.00  
FireWrap® Grip Kit Blue,03/26/2021,Invoice,M-032621-008,,FIREWRAP® GRIP KIT	Blue,10,18.75  ,187.50  ,262.50  
FireWrap® Grip Kit Blue,03/26/2021,Invoice,M-032621-012,,FIREWRAP® GRIP KIT	Blue,2,18.75  ,37.50  ,300.00  
FireWrap® Grip Kit Blue,07/08/2021,Invoice,M-070821-001,,FIREWRAP® GRIP KIT	Blue,10,18.75  ,187.50  ,487.50  
FireWrap® Grip Kit Blue,08/12/2021,Invoice,M-081221-002,,FIREWRAP® GRIP KIT	Blue,5,18.75  ,93.75  ,581.25  
FireWrap® Grip Kit Blue,08/24/2021,Invoice,M-082421-003,,FIREWRAP® GRIP KIT	Blue,1,24.99  ,24.99  ,606.24  
FireWrap® Grip Kit Blue,09/07/2021,Invoice,M-090721-002,,FIREWRAP® GRIP KIT	Blue,4,18.75  ,75.00  ,681.24  
FireWrap® Grip Kit Blue,09/20/2021,Invoice,M-092021-001,,FIREWRAP® GRIP KIT	Blue,1,18.75  ,18.75  ,699.99  
FireWrap® Grip Kit Blue,09/22/2021,Invoice,M-092221-001,,FIREWRAP® GRIP KIT	Blue,3,18.75  ,56.25  ,756.24  
FireWrap® Grip Kit Blue,09/30/2021,Invoice,M-093021-001,,FIREWRAP® GRIP KIT	Blue,4,19.99  ,79.96  ,836.20  
FireWrap® Grip Kit Blue,10/07/2021,Invoice,M-100721-008,,FIREWRAP® GRIP KIT	Blue,2,18.75  ,37.50  ,873.70  
FireWrap® Grip Kit Blue,10/07/2021,Invoice,M-100721-003,,FIREWRAP® GRIP KIT	Blue,7,18.75  ,131.25  ,"1,004.95  "
FireWrap® Grip Kit Blue,10/20/2021,Invoice,M-102021-005,,FIREWRAP® GRIP KIT	Blue,2,18.75  ,37.50  ,"1,042.45  "
FireWrap® Grip Kit Blue,10/20/2021,Invoice,M-102021-002,,FIREWRAP® GRIP KIT	Blue,3,18.75  ,56.25  ,"1,098.70  "
FireWrap® Grip Kit Blue,10/27/2021,Invoice,M-102721-005,,FIREWRAP® GRIP KIT	Blue,9,18.75  ,168.75  ,"1,267.45  "
FireWrap® Grip Kit Blue,11/02/2021,Invoice,M-091021-001,,FIREWRAP® GRIP KIT	Blue,3,18.75  ,56.25  ,"1,323.70  "
FireWrap® Grip Kit Blue,11/30/2021,Invoice,M-113021-002,,FIREWRAP® GRIP KIT	Blue,1,18.75  ,18.75  ,"1,342.45  "
FireWrap® Grip Kit Blue,12/02/2021,Invoice,M-120221-001,,FIREWRAP® GRIP KIT	Blue,1,19.99  ,19.99  ,"1,362.44  "
FireWrap® Grip Kit Blue,12/17/2021,Invoice,M-121721-005,,FIREWRAP® GRIP KIT	Blue,6,18.75  ,112.50  ,"1,474.94  "
FireWrap® Grip Kit Blue,12/22/2021,Invoice,M-122221-001,,FIREWRAP® GRIP KIT	Blue,3,18.75  ,56.25  ,"1,531.19  "
FireWrap® Grip Kit Blue,01/07/2022,Invoice,M-101821-002,,FIREWRAP® GRIP KIT	Blue,2,18.75  ,37.50  ,"1,568.69  "
FireWrap® Grip Kit Blue,01/11/2022,Invoice,M-011122-003,,FIREWRAP® GRIP KIT	Blue,10,24.95  ,249.50  ,"1,818.19  "
FireWrap® Grip Kit Blue,01/12/2022,Invoice,M-011222-004,,FIREWRAP® GRIP KIT	Blue,7,18.75  ,131.25  ,"1,949.44  "
FireWrap® Grip Kit Blue,01/18/2022,Invoice,M-011822-006,,FIREWRAP® GRIP KIT	Blue,0,,0.00  ,"1,949.44  "
FireWrap® Grip Kit Blue,01/31/2022,Invoice,M-010522-001,,FIREWRAP® GRIP KIT	Blue,15,18.75  ,281.25  ,"2,230.69  "
FireWrap® Grip Kit Blue,02/01/2022,Invoice,M-020122-002,,FIREWRAP® GRIP KIT	Blue,4,21.75  ,87.00  ,"2,317.69  "
FireWrap® Grip Kit Blue,02/14/2022,Invoice,M-021422-002,,FIREWRAP® GRIP KIT	Blue,2,21.75  ,43.50  ,"2,361.19  "
FireWrap® Grip Kit Blue,02/21/2022,Invoice,M-022122-001,,FIREWRAP® GRIP KIT	Blue,2,27.95  ,55.90  ,"2,417.09  "
FireWrap® Grip Kit Blue,02/21/2022,Invoice,M-022122-006,,FIREWRAP® GRIP KIT	Blue,2,21.75  ,43.50  ,"2,460.59  "
FireWrap® Grip Kit Blue,02/22/2022,Invoice,M-022222-002,,FIREWRAP® GRIP KIT	Blue,4,21.75  ,87.00  ,"2,547.59  "
FireWrap® Grip Kit Blue,02/22/2022,Invoice,M-022122-005,,FIREWRAP® GRIP KIT	Blue,2,21.75  ,43.50  ,"2,591.09  "
FireWrap® Grip Kit Blue,02/25/2022,Invoice,M-022522-002,,FIREWRAP® GRIP KIT	Blue,2,21.75  ,43.50  ,"2,634.59  "
FireWrap® Grip Kit Blue,03/04/2022,Invoice,M-030422-001,,FIREWRAP® GRIP KIT	Blue,1,21.75  ,21.75  ,"2,656.34  "
FireWrap® Grip Kit Blue,03/04/2022,Invoice,M-030422-002,,FIREWRAP® GRIP KIT	Blue,15,21.75  ,326.25  ,"2,982.59  "
FireWrap® Grip Kit Blue,03/04/2022,Invoice,M-030422-004,,FIREWRAP® GRIP KIT	Blue,24,21.75  ,522.00  ,"3,504.59  "
FireWrap® Grip Kit Blue,03/11/2022,Invoice,M-031122-004,,FIREWRAP® GRIP KIT	Blue,4,21.75  ,87.00  ,"3,591.59  "
FireWrap® Grip Kit Blue,03/14/2022,Invoice,M-031422-001,,FIREWRAP® GRIP KIT	Blue,18,27.95  ,503.10  ,"4,094.69  "
FireWrap® Grip Kit Blue,03/17/2022,Invoice,M-031722-003,,FIREWRAP® GRIP KIT	Blue,1,21.75  ,21.75  ,"4,116.44  "
FireWrap® Grip Kit Blue,03/21/2022,Invoice,M-020422-003,,FIREWRAP® GRIP KIT	Blue,2,21.75  ,43.50  ,"4,159.94  "
FireWrap® Grip Kit Blue,03/30/2022,Invoice,M-033022-005,,FIREWRAP® GRIP KIT	Blue,1,27.95  ,27.95  ,"4,187.89  "
FireWrap® Grip Kit Blue,04/18/2022,Invoice,M-041822-005,,FIREWRAP® GRIP KIT	Blue,3,21.75  ,65.25  ,"4,253.14  "
FireWrap® Grip Kit Blue,04/22/2022,Invoice,M-041822-003,,FIREWRAP® GRIP KIT	Blue,4,21.75  ,87.00  ,"4,340.14  "
FireWrap® Grip Kit Blue,04/22/2022,Invoice,M-041822-003,,FIREWRAP® GRIP KIT	Blue,3,21.75  ,65.25  ,"4,405.39  "
FireWrap® Grip Kit Blue,04/22/2022,Invoice,M-042222-001,,FIREWRAP® GRIP KIT	Blue,6,27.95  ,167.70  ,"4,573.09  "
FireWrap® Grip Kit Blue,04/25/2022,Invoice,M-032422-005,,FIREWRAP® GRIP KIT	Blue,3,21.75  ,65.25  ,"4,638.34  "
FireWrap® Grip Kit Blue,05/03/2022,Invoice,M-041222-004,,FIREWRAP® GRIP KIT	Blue,2,21.75  ,43.50  ,"4,681.84  "
FireWrap® Grip Kit Blue,05/03/2022,Invoice,M-030122-003,,FIREWRAP® GRIP KIT	Blue,10,16.50  ,165.00  ,"4,846.84  "
FireWrap® Grip Kit Blue,05/03/2022,Invoice,M-041222-001,,FIREWRAP® GRIP KIT	Blue,1,21.75  ,21.75  ,"4,868.59  "
FireWrap® Grip Kit Blue,05/04/2022,Invoice,M-050422-001,,FIREWRAP® GRIP KIT	Blue,16,27.95  ,447.20  ,"5,315.79  "
FireWrap® Grip Kit Blue,05/11/2022,Invoice,M-051122-004,,FIREWRAP® GRIP KIT	Blue,1,21.75  ,21.75  ,"5,337.54  "
FireWrap® Grip Kit Blue,05/26/2022,Invoice,M-052622-005,,FIREWRAP® GRIP KIT	Blue,9,21.75  ,195.75  ,"5,533.29  "
FireWrap® Grip Kit Blue,05/31/2022,Invoice,M-053122-003A,,FIREWRAP® GRIP KIT	Blue,11,21.75  ,239.25  ,"5,772.54  "
FireWrap® Grip Kit Blue,05/31/2022,Invoice,M-053122-002,,FIREWRAP® GRIP KIT	Blue,32,16.50  ,528.00  ,"6,300.54  "
FireWrap® Grip Kit Blue,06/10/2022,Invoice,M-061022-009,,FIREWRAP® GRIP KIT	Blue,12,21.75  ,261.00  ,"6,561.54  "
FireWrap® Grip Kit Blue,06/23/2022,Invoice,M-052622-009,,FIREWRAP® GRIP KIT	Blue,10,21.75  ,217.50  ,"6,779.04  "
FireWrap® Grip Kit Blue,06/23/2022,Invoice,M-062322-001,,FIREWRAP® GRIP KIT	Blue,3,21.75  ,65.25  ,"6,844.29  "
FireWrap® Grip Kit Blue,06/23/2022,Invoice,M-062322-002,,FIREWRAP® GRIP KIT	Blue,5,21.75  ,108.75  ,"6,953.04  "
FireWrap® Grip Kit Blue,06/23/2022,Invoice,M-041822-007-B,,FIREWRAP® GRIP KIT	Blue,2,21.75  ,43.50  ,"6,996.54  "
FireWrap® Grip Kit Blue,06/23/2022,Invoice,M-061522-001-B,,FIREWRAP® GRIP KIT	Blue,2,21.75  ,43.50  ,"7,040.04  "
FireWrap® Grip Kit Blue,07/12/2022,Invoice,M-071222-004,,FIREWRAP® GRIP KIT	Blue,2,21.75  ,43.50  ,"7,083.54  "
FireWrap® Grip Kit Blue,07/18/2022,Invoice,M-071822-002,,FIREWRAP® GRIP KIT	Blue,1,21.75  ,21.75  ,"7,105.29  "
FireWrap® Grip Kit Blue,07/18/2022,Invoice,M-071822-004,,FIREWRAP® GRIP KIT	Blue,9,21.75  ,195.75  ,"7,301.04  "
FireWrap® Grip Kit Blue,07/21/2022,Invoice,M-072122-003,,FIREWRAP® GRIP KIT	Blue,5,21.75  ,108.75  ,"7,409.79  "
FireWrap® Grip Kit Blue,07/21/2022,Invoice,M-072122-006,,FIREWRAP® GRIP KIT	Blue,6,21.75  ,130.50  ,"7,540.29  "
FireWrap® Grip Kit Blue,07/25/2022,Invoice,M-072122-007,,FIREWRAP® GRIP KIT	Blue,5,27.95  ,139.75  ,"7,680.04  "
FireWrap® Grip Kit Blue,07/30/2022,Invoice,M-073022-004,,FIREWRAP® GRIP KIT	Blue,5,21.75  ,108.75  ,"7,788.79  "
FireWrap® Grip Kit Blue,08/03/2022,Invoice,M-080322-003,,FIREWRAP® GRIP KIT	Blue,5,27.95  ,139.75  ,"7,928.54  "
FireWrap® Grip Kit Blue,09/02/2022,Invoice,M-090222-001,,FIREWRAP® GRIP KIT	Blue,8,27.95  ,223.60  ,"8,152.14  "
FireWrap® Grip Kit Blue,09/05/2022,Invoice,M-082422-002,,FIREWRAP® GRIP KIT	Blue,6,21.75  ,130.50  ,"8,282.64  "
FireWrap® Grip Kit Blue,09/08/2022,Invoice,M-082722-001,,FIREWRAP® GRIP KIT	Blue,4,21.75  ,87.00  ,"8,369.64  "
FireWrap® Grip Kit Blue,09/08/2022,Invoice,M-082522-003,,FIREWRAP® GRIP KIT	Blue,2,21.75  ,43.50  ,"8,413.14  "
FireWrap® Grip Kit Blue,09/13/2022,Invoice,M-091322-001,,FIREWRAP® GRIP KIT	Blue,3,21.75  ,65.25  ,"8,478.39  "
FireWrap® Grip Kit Blue,09/15/2022,Invoice,M-090722-002B,,FIREWRAP® GRIP KIT	Blue,6,21.75  ,130.50  ,"8,608.89  "
FireWrap® Grip Kit Blue,10/31/2022,Invoice,M-103122-002,,FIREWRAP® GRIP KIT	Blue,5,21.75  ,108.75  ,"8,717.64  "
FireWrap® Grip Kit Blue,11/09/2022,Invoice,M-110922-003,,FIREWRAP® GRIP KIT	Blue,2,21.75  ,43.50  ,"8,761.14  "
FireWrap® Grip Kit Blue,11/28/2022,Invoice,M-110922-002,,FIREWRAP® GRIP KIT	Blue,18,21.75  ,391.50  ,"9,152.64  "
FireWrap® Grip Kit Blue,11/28/2022,Invoice,M-112222-004,,FIREWRAP® GRIP KIT	Blue,20,21.75  ,435.00  ,"9,587.64  "
FireWrap® Grip Kit Blue,12/06/2022,Invoice,M-120622-001,,FIREWRAP® GRIP KIT	Blue,4,21.75  ,87.00  ,"9,674.64  "
FireWrap® Grip Kit Blue,12/06/2022,Invoice,M-120622-005,,FIREWRAP® GRIP KIT	Blue,6,27.95  ,167.70  ,"9,842.34  "
FireWrap® Grip Kit Blue,12/12/2022,Invoice,M-121222-002B,,FIREWRAP® GRIP KIT	Blue,3,21.75  ,65.25  ,"9,907.59  "
FireWrap® Grip Kit Blue,12/27/2022,Invoice,M-121922-004,,FIREWRAP® GRIP KIT	Blue,1,21.75  ,21.75  ,"9,929.34  "
FireWrap® Grip Kit Blue,01/03/2023,Invoice,M-010323-002,,FIREWRAP® GRIP KIT	Blue,4,21.75  ,87.00  ,"10,016.34  "
Total for FireWrap® Grip Kit Blue,,,,,,464,,"$	10,016.34  ",
FireWrap® Grip Kit Green,,,,,,,,,
FireWrap® Grip Kit Green,03/20/2021,Sales Receipt,5151,,"FIREWRAP® GRIP KIT - Yes, I understand.
Color: Green",1,24.99  ,24.99  ,24.99  
FireWrap® Grip Kit Green,03/22/2021,Sales Receipt,5160,,"FIREWRAP® GRIP KIT - Yes, I understand.
Color: Green",2,24.99  ,49.98  ,74.97  
FireWrap® Grip Kit Green,03/25/2021,Sales Receipt,5178,,"FIREWRAP® GRIP KIT - Yes, I understand.
Color: Green",1,24.99  ,24.99  ,99.96  
FireWrap® Grip Kit Green,03/26/2021,Invoice,M-032621-008,,FIREWRAP® GRIP KIT	Green,10,18.75  ,187.50  ,287.46  
FireWrap® Grip Kit Green,03/26/2021,Invoice,M-032621-015,,FIREWRAP® GRIP KIT	Green,20,18.75  ,375.00  ,662.46  
FireWrap® Grip Kit Green,03/26/2021,Invoice,M-032621-002,,FIREWRAP® GRIP KIT	Green,2,18.75  ,37.50  ,699.96  
FireWrap® Grip Kit Green,03/27/2021,Invoice,M-032721-001,,FIREWRAP® GRIP KIT	Green,5,18.75  ,93.75  ,793.71  
FireWrap® Grip Kit Green,03/27/2021,Invoice,M-021921-001,,FIREWRAP® GRIP KIT	Green,2,18.75  ,37.50  ,831.21  
FireWrap® Grip Kit Green,03/27/2021,Invoice,M-032721-006,,FIREWRAP® GRIP KIT	Green,4,18.75  ,75.00  ,906.21  
FireWrap® Grip Kit Green,03/27/2021,Invoice,M-032721-006,,FIREWRAP® GRIP KIT	Green,10,18.75  ,187.50  ,"1,093.71  "
FireWrap® Grip Kit Green,03/27/2021,Invoice,M-032721-006,,FIREWRAP® GRIP KIT	Green,4,18.75  ,75.00  ,"1,168.71  "
FireWrap® Grip Kit Green,03/27/2021,Sales Receipt,5181,,"FIREWRAP® GRIP KIT - Yes, I understand.
Color: Green",1,24.99  ,24.99  ,"1,193.70  "
FireWrap® Grip Kit Green,03/28/2021,Sales Receipt,5190,,"FIREWRAP® GRIP KIT - Yes, I understand.
Color: Green",2,24.99  ,49.98  ,"1,243.68  "
FireWrap® Grip Kit Green,03/28/2021,Sales Receipt,5194,,"FIREWRAP® GRIP KIT - Yes, I understand.
Color: Green",1,24.99  ,24.99  ,"1,268.67  "
FireWrap® Grip Kit Green,03/30/2021,Invoice,M-033021-005,,FIREWRAP® GRIP KIT	Green,1,18.75  ,18.75  ,"1,287.42  "
FireWrap® Grip Kit Green,03/31/2021,Sales Receipt,5219,,"FIREWRAP® GRIP KIT - Yes, I understand.
Color: Green",1,24.99  ,24.99  ,"1,312.41  "
FireWrap® Grip Kit Green,04/02/2021,Sales Receipt,5226,,"FIREWRAP® GRIP KIT - Yes, I understand.
Color: Green",2,24.99  ,49.98  ,"1,362.39  "
FireWrap® Grip Kit Green,04/02/2021,Sales Receipt,5225,,"FIREWRAP® GRIP KIT - Yes, I understand.
Color: Green",1,24.99  ,24.99  ,"1,387.38  "
FireWrap® Grip Kit Green,04/02/2021,Sales Receipt,5231,,"FIREWRAP® GRIP KIT - Yes, I understand.
Color: Green",1,24.99  ,24.99  ,"1,412.37  "
FireWrap® Grip Kit Green,04/03/2021,Sales Receipt,5235,,"FIREWRAP® GRIP KIT - Yes, I understand.
Color: Green",1,24.99  ,24.99  ,"1,437.36  "
FireWrap® Grip Kit Green,04/06/2021,Sales Receipt,5250,,"FIREWRAP® GRIP KIT - Yes, I understand.
Color: Green",2,24.99  ,49.98  ,"1,487.34  "
FireWrap® Grip Kit Green,04/08/2021,Invoice,M-040821-002,,FIREWRAP® GRIP KIT	Green,1,18.75  ,18.75  ,"1,506.09  "
FireWrap® Grip Kit Green,04/12/2021,Invoice,M-041221-002,,FIREWRAP® GRIP KIT	Green,1,18.75  ,18.75  ,"1,524.84  "
FireWrap® Grip Kit Green,04/12/2021,Invoice,M-041221-004,,FIREWRAP® GRIP KIT	Green,2,18.75  ,37.50  ,"1,562.34  "
FireWrap® Grip Kit Green,04/12/2021,Invoice,M-041221-001,,FIREWRAP® GRIP KIT	Green,1,18.75  ,18.75  ,"1,581.09  "
FireWrap® Grip Kit Green,04/13/2021,Sales Receipt,5294,,"FIREWRAP® GRIP KIT - Yes, I understand.
Color: Green",1,24.99  ,24.99  ,"1,606.08  "
FireWrap® Grip Kit Green,04/14/2021,Sales Receipt,5299,,"FIREWRAP® GRIP KIT - Yes, I understand.
Color: Green",9,24.99  ,224.91  ,"1,830.99  "
FireWrap® Grip Kit Green,04/16/2021,Sales Receipt,5308,,"FIREWRAP® GRIP KIT - Yes, I understand.
Color: Green",6,24.99  ,149.94  ,"1,980.93  "
FireWrap® Grip Kit Green,04/19/2021,Invoice,M-041921-001,,FIREWRAP® GRIP KIT	Green,14,18.75  ,262.50  ,"2,243.43  "
FireWrap® Grip Kit Green,04/21/2021,Sales Receipt,5341,,"FIREWRAP® GRIP KIT
Color: Green",1,24.99  ,24.99  ,"2,268.42  "
FireWrap® Grip Kit Green,04/23/2021,Sales Receipt,5367,,"FIREWRAP® GRIP KIT
Color: Green",2,24.99  ,49.98  ,"2,318.40  "
FireWrap® Grip Kit Green,04/24/2021,Sales Receipt,5382,,"FIREWRAP® GRIP KIT
Color: Green",7,24.99  ,174.93  ,"2,493.33  "
FireWrap® Grip Kit Green,04/29/2021,Sales Receipt,5413,,"FIREWRAP® GRIP KIT
Color: Green",1,24.99  ,24.99  ,"2,518.32  "
FireWrap® Grip Kit Green,04/30/2021,Sales Receipt,5427,,"FIREWRAP® GRIP KIT
Color: Green",1,24.99  ,24.99  ,"2,543.31  "
FireWrap® Grip Kit Green,04/30/2021,Invoice,M-043021-002,,FIREWRAP® GRIP KIT	Green,2,24.99  ,49.98  ,"2,593.29  "
FireWrap® Grip Kit Green,05/01/2021,Sales Receipt,5437,,"FIREWRAP® GRIP KIT
Color: Green",1,24.99  ,24.99  ,"2,618.28  "
FireWrap® Grip Kit Green,05/03/2021,Invoice,M-050321-003,,FIREWRAP® GRIP KIT	Green,3,18.75  ,56.25  ,"2,674.53  "
FireWrap® Grip Kit Green,05/05/2021,Sales Receipt,5454,,"FIREWRAP® GRIP KIT
Color: Green",1,24.99  ,24.99  ,"2,699.52  "
FireWrap® Grip Kit Green,05/06/2021,Sales Receipt,5456,,"FIREWRAP® GRIP KIT
Color: Green",1,24.99  ,24.99  ,"2,724.51  "
FireWrap® Grip Kit Green,05/18/2021,Sales Receipt,5532,,"FIREWRAP® GRIP KIT
Color: Green",2,24.99  ,49.98  ,"2,774.49  "
FireWrap® Grip Kit Green,05/23/2021,Sales Receipt,5563,,"FIREWRAP® GRIP KIT
Color: Green",1,24.99  ,24.99  ,"2,799.48  "
FireWrap® Grip Kit Green,05/26/2021,Sales Receipt,5582,,"FIREWRAP® GRIP KIT
Color: Green",5,24.99  ,124.95  ,"2,924.43  "
FireWrap® Grip Kit Green,05/28/2021,Sales Receipt,5588,,"FIREWRAP® GRIP KIT
Color: Green",4,24.99  ,99.96  ,"3,024.39  "
FireWrap® Grip Kit Green,06/15/2021,Sales Receipt,5670,,"FIREWRAP® GRIP KIT
Color: Green",5,24.99  ,124.95  ,"3,149.34  "
FireWrap® Grip Kit Green,06/16/2021,Invoice,M-061621-001,,FIREWRAP® GRIP KIT	Green,2,18.75  ,37.50  ,"3,186.84  "
FireWrap® Grip Kit Green,06/16/2021,Sales Receipt,5675,,"FIREWRAP® GRIP KIT
Color: Green",2,24.99  ,49.98  ,"3,236.82  "
FireWrap® Grip Kit Green,06/18/2021,Sales Receipt,5685,,"FIREWRAP® GRIP KIT
Color: Green",5,24.99  ,124.95  ,"3,361.77  "
FireWrap® Grip Kit Green,06/18/2021,Invoice,M-061821-001,,FIREWRAP® GRIP KIT	Green,1,18.75  ,18.75  ,"3,380.52  "
FireWrap® Grip Kit Green,06/21/2021,Invoice,M-062121-001,,FIREWRAP® GRIP KIT	Green,3,24.99  ,74.97  ,"3,455.49  "
FireWrap® Grip Kit Green,06/29/2021,Sales Receipt,5720,,"FIREWRAP® GRIP KIT
Color: Green",5,24.99  ,124.95  ,"3,580.44  "
FireWrap® Grip Kit Green,06/30/2021,Invoice,M-063021-001,,FIREWRAP® GRIP KIT	Green,4,18.75  ,75.00  ,"3,655.44  "
FireWrap® Grip Kit Green,07/04/2021,Sales Receipt,5744,,"FIREWRAP® GRIP KIT
Color: Green",1,24.99  ,24.99  ,"3,680.43  "
FireWrap® Grip Kit Green,07/05/2021,Sales Receipt,5747,,"FIREWRAP® GRIP KIT
Color: Green",1,24.99  ,24.99  ,"3,705.42  "
FireWrap® Grip Kit Green,07/05/2021,Sales Receipt,5748,,"FIREWRAP® GRIP KIT
Color: Green",2,24.99  ,49.98  ,"3,755.40  "
FireWrap® Grip Kit Green,07/07/2021,Sales Receipt,5757,,"FIREWRAP® GRIP KIT
Color: Green",1,24.99  ,24.99  ,"3,780.39  "
FireWrap® Grip Kit Green,07/08/2021,Invoice,M-070821-001,,FIREWRAP® GRIP KIT	Green,10,18.75  ,187.50  ,"3,967.89  "
FireWrap® Grip Kit Green,07/10/2021,Sales Receipt,5765,,"FIREWRAP® GRIP KIT
Color: Green",1,24.99  ,24.99  ,"3,992.88  "
FireWrap® Grip Kit Green,07/15/2021,Sales Receipt,5786,,"FIREWRAP® GRIP KIT
Color: Green",6,24.99  ,149.94  ,"4,142.82  "
FireWrap® Grip Kit Green,07/25/2021,Sales Receipt,5819,,"FIREWRAP® GRIP KIT
Color: Green",2,24.99  ,49.98  ,"4,192.80  "
FireWrap® Grip Kit Green,07/26/2021,Sales Receipt,5828,,"FIREWRAP® GRIP KIT
Color: Green",1,24.99  ,24.99  ,"4,217.79  "
FireWrap® Grip Kit Green,07/26/2021,Invoice,M-072621-003,,FIREWRAP® GRIP KIT	Green,1,18.75  ,18.75  ,"4,236.54  "
FireWrap® Grip Kit Green,07/31/2021,Sales Receipt,5842,,"FIREWRAP® GRIP KIT
Color: Green",2,24.99  ,49.98  ,"4,286.52  "
FireWrap® Grip Kit Green,08/01/2021,Sales Receipt,5845,,"FIREWRAP® GRIP KIT
Color: Green",2,24.99  ,49.98  ,"4,336.50  "
FireWrap® Grip Kit Green,08/05/2021,Sales Receipt,5860,,"FIREWRAP® GRIP KIT
Color: Green",2,24.99  ,49.98  ,"4,386.48  "
FireWrap® Grip Kit Green,08/06/2021,Sales Receipt,5867,,"FIREWRAP® GRIP KIT
Color: Green",1,24.99  ,24.99  ,"4,411.47  "
FireWrap® Grip Kit Green,08/09/2021,Sales Receipt,5886,,"FIREWRAP® GRIP KIT
Color: Green",4,24.99  ,99.96  ,"4,511.43  "
FireWrap® Grip Kit Green,08/10/2021,Sales Receipt,5892,,"FIREWRAP® GRIP KIT
Color: Green",2,24.99  ,49.98  ,"4,561.41  "
FireWrap® Grip Kit Green,08/11/2021,Sales Receipt,5896,,"FIREWRAP® GRIP KIT
Color: Green",2,24.99  ,49.98  ,"4,611.39  "
FireWrap® Grip Kit Green,08/14/2021,Sales Receipt,5916,,"FIREWRAP® GRIP KIT
Color: Green",2,24.99  ,49.98  ,"4,661.37  "
FireWrap® Grip Kit Green,08/16/2021,Sales Receipt,5924,,"FIREWRAP® GRIP KIT
Color: Green",2,24.99  ,49.98  ,"4,711.35  "
FireWrap® Grip Kit Green,08/16/2021,Sales Receipt,5925,,"FIREWRAP® GRIP KIT
Color: Green",6,24.99  ,149.94  ,"4,861.29  "
FireWrap® Grip Kit Green,08/16/2021,Sales Receipt,5929,,"FIREWRAP® GRIP KIT
Color: Green",1,24.99  ,24.99  ,"4,886.28  "
FireWrap® Grip Kit Green,08/17/2021,Invoice,M-081721-001,,FIREWRAP® GRIP KIT	Green,1,24.99  ,24.99  ,"4,911.27  "
FireWrap® Grip Kit Green,08/18/2021,Invoice,M-081821-007,,FIREWRAP® GRIP KIT	Green,4,15.00  ,60.00  ,"4,971.27  "
FireWrap® Grip Kit Green,08/18/2021,Invoice,M-081821-009,,FIREWRAP® GRIP KIT	Green,2,18.75  ,37.50  ,"5,008.77  "
FireWrap® Grip Kit Green,08/20/2021,Sales Receipt,5948,,"FIREWRAP® GRIP KIT
Color: Green",1,24.99  ,24.99  ,"5,033.76  "
FireWrap® Grip Kit Green,08/20/2021,Sales Receipt,5947,,"FIREWRAP® GRIP KIT
Color: Green",1,24.99  ,24.99  ,"5,058.75  "
FireWrap® Grip Kit Green,08/23/2021,Sales Receipt,5963,,"FIREWRAP® GRIP KIT
Color: Green",1,24.99  ,24.99  ,"5,083.74  "
FireWrap® Grip Kit Green,08/25/2021,Sales Receipt,5976,,"FIREWRAP® GRIP KIT
Color: Green",2,24.99  ,49.98  ,"5,133.72  "
FireWrap® Grip Kit Green,08/26/2021,Sales Receipt,5981,,"FIREWRAP® GRIP KIT
Color: Green",1,24.99  ,24.99  ,"5,158.71  "
FireWrap® Grip Kit Green,09/01/2021,Invoice,M-090121-001,,FIREWRAP® GRIP KIT	Green,1,15.00  ,15.00  ,"5,173.71  "
FireWrap® Grip Kit Green,09/03/2021,Sales Receipt,6040,,"FIREWRAP® GRIP KIT
Color: Green",4,24.99  ,99.96  ,"5,273.67  "
FireWrap® Grip Kit Green,09/07/2021,Invoice,M-090721-005,,FIREWRAP® GRIP KIT	Green,2,18.75  ,37.50  ,"5,311.17  "
FireWrap® Grip Kit Green,09/11/2021,Sales Receipt,6070,,"FIREWRAP® GRIP KIT
Color: Green",2,24.99  ,49.98  ,"5,361.15  "
FireWrap® Grip Kit Green,09/13/2021,Sales Receipt,6078,,"FIREWRAP® GRIP KIT
Color: Green",2,24.99  ,49.98  ,"5,411.13  "
FireWrap® Grip Kit Green,09/14/2021,Sales Receipt,6080,,"FIREWRAP® GRIP KIT
Color: Green",1,24.99  ,24.99  ,"5,436.12  "
FireWrap® Grip Kit Green,09/20/2021,Invoice,M-092021-001,,FIREWRAP® GRIP KIT	Green,6,18.75  ,112.50  ,"5,548.62  "
FireWrap® Grip Kit Green,09/22/2021,Invoice,M-092221-001,,FIREWRAP® GRIP KIT	Green,10,18.75  ,187.50  ,"5,736.12  "
FireWrap® Grip Kit Green,09/27/2021,Sales Receipt,6175,,"FIREWRAP® GRIP KIT
Color: Green",1,19.99  ,19.99  ,"5,756.11  "
FireWrap® Grip Kit Green,09/30/2021,Sales Receipt,6207,,"FIREWRAP® GRIP KIT
Color: Green",4,24.95  ,99.80  ,"5,855.91  "
FireWrap® Grip Kit Green,10/04/2021,Sales Receipt,6227,,"FIREWRAP® GRIP KIT
Color: Green",2,24.95  ,49.90  ,"5,905.81  "
FireWrap® Grip Kit Green,10/06/2021,Sales Receipt,6245,,"FIREWRAP® GRIP KIT
Color: Green",2,24.95  ,49.90  ,"5,955.71  "
FireWrap® Grip Kit Green,10/07/2021,Invoice,M-100721-003,,FIREWRAP® GRIP KIT	Green,8,18.75  ,150.00  ,"6,105.71  "
FireWrap® Grip Kit Green,10/07/2021,Invoice,M-100721-007,,FIREWRAP® GRIP KIT	Green,1,18.75  ,18.75  ,"6,124.46  "
FireWrap® Grip Kit Green,10/17/2021,Sales Receipt,6321,,"FIREWRAP® GRIP KIT
Color: Green",1,24.95  ,24.95  ,"6,149.41  "
FireWrap® Grip Kit Green,10/17/2021,Sales Receipt,6319,,"FIREWRAP® GRIP KIT
Color: Green",1,24.95  ,24.95  ,"6,174.36  "
FireWrap® Grip Kit Green,10/20/2021,Invoice,M-102021-002,,FIREWRAP® GRIP KIT	Green,1,18.75  ,18.75  ,"6,193.11  "
FireWrap® Grip Kit Green,10/20/2021,Invoice,M-102021-001,,FIREWRAP® GRIP KIT	Green,7,24.95  ,174.65  ,"6,367.76  "
FireWrap® Grip Kit Green,10/21/2021,Sales Receipt,6342,,"FIREWRAP® GRIP KIT
Color: Green",2,24.95  ,49.90  ,"6,417.66  "
FireWrap® Grip Kit Green,10/22/2021,Sales Receipt,6350,,"FIREWRAP® GRIP KIT
Color: Green",1,24.95  ,24.95  ,"6,442.61  "
FireWrap® Grip Kit Green,10/25/2021,Sales Receipt,6367,,"FIREWRAP® GRIP KIT
Color: Green",1,24.95  ,24.95  ,"6,467.56  "
FireWrap® Grip Kit Green,10/27/2021,Invoice,M-102721-005,,FIREWRAP® GRIP KIT	Green,7,18.75  ,131.25  ,"6,598.81  "
FireWrap® Grip Kit Green,10/28/2021,Invoice,M-102821-005,,FIREWRAP® GRIP KIT	Green,1,24.95  ,24.95  ,"6,623.76  "
FireWrap® Grip Kit Green,10/28/2021,Invoice,M-102821-001,,FIREWRAP® GRIP KIT	Green,10,24.99  ,249.90  ,"6,873.66  "
FireWrap® Grip Kit Green,11/02/2021,Invoice,M-091021-001,,FIREWRAP® GRIP KIT	Green,2,18.75  ,37.50  ,"6,911.16  "
FireWrap® Grip Kit Green,11/03/2021,Sales Receipt,6426,,"FIREWRAP® GRIP KIT
Color: Green",1,24.95  ,24.95  ,"6,936.11  "
FireWrap® Grip Kit Green,11/09/2021,Sales Receipt,6454,,"FIREWRAP® GRIP KIT
Color: Green",1,24.95  ,24.95  ,"6,961.06  "
FireWrap® Grip Kit Green,11/11/2021,Sales Receipt,6479,,"FIREWRAP® GRIP KIT
Color: Green",2,24.95  ,49.90  ,"7,010.96  "
FireWrap® Grip Kit Green,11/13/2021,Sales Receipt,6497,,"FIREWRAP® GRIP KIT
Color: Green",1,24.95  ,24.95  ,"7,035.91  "
FireWrap® Grip Kit Green,11/15/2021,Sales Receipt,6514,,"FIREWRAP® GRIP KIT
Color: Green",1,24.95  ,24.95  ,"7,060.86  "
FireWrap® Grip Kit Green,11/15/2021,Sales Receipt,6515,,"FIREWRAP® GRIP KIT
Color: Green",1,24.95  ,24.95  ,"7,085.81  "
FireWrap® Grip Kit Green,11/19/2021,Sales Receipt,6539,,"FIREWRAP® GRIP KIT
Color: Green",1,24.95  ,24.95  ,"7,110.76  "
FireWrap® Grip Kit Green,11/29/2021,Sales Receipt,6624,,"FIREWRAP® GRIP KIT
Color: Green",1,19.99  ,19.99  ,"7,130.75  "
FireWrap® Grip Kit Green,12/02/2021,Invoice,M-120221-001,,FIREWRAP® GRIP KIT	Green,1,19.99  ,19.99  ,"7,150.74  "
FireWrap® Grip Kit Green,12/09/2021,Invoice,M-120921-002,,FIREWRAP® GRIP KIT	Green,1,18.75  ,18.75  ,"7,169.49  "
FireWrap® Grip Kit Green,12/12/2021,Sales Receipt,6726,,"FIREWRAP® GRIP KIT
Color: Green",1,24.95  ,24.95  ,"7,194.44  "
FireWrap® Grip Kit Green,12/16/2021,Sales Receipt,6753,,"FIREWRAP® GRIP KIT
Color: Green",3,24.95  ,74.85  ,"7,269.29  "
FireWrap® Grip Kit Green,12/18/2021,Sales Receipt,6776,,"FIREWRAP® GRIP KIT
Color: Green",1,24.95  ,24.95  ,"7,294.24  "
FireWrap® Grip Kit Green,12/22/2021,Invoice,M-122221-001,,FIREWRAP® GRIP KIT	Green,11,18.75  ,206.25  ,"7,500.49  "
FireWrap® Grip Kit Green,12/26/2021,Sales Receipt,6836,,"FIREWRAP® GRIP KIT
Color: Green",3,24.95  ,74.85  ,"7,575.34  "
FireWrap® Grip Kit Green,12/28/2021,Sales Receipt,6850,,"FIREWRAP® GRIP KIT
Color: Green",8,24.95  ,199.60  ,"7,774.94  "
FireWrap® Grip Kit Green,12/30/2021,Sales Receipt,6863,,"FIREWRAP® GRIP KIT
Color: Green",1,24.95  ,24.95  ,"7,799.89  "
FireWrap® Grip Kit Green,12/30/2021,Sales Receipt,6870,,"FIREWRAP® GRIP KIT
Color: Green",1,24.95  ,24.95  ,"7,824.84  "
FireWrap® Grip Kit Green,01/05/2022,Sales Receipt,6925,,"FIREWRAP® GRIP KIT
Color: Green",2,24.95  ,49.90  ,"7,874.74  "
FireWrap® Grip Kit Green,01/05/2022,Sales Receipt,6926,,"FIREWRAP® GRIP KIT
Color: Green",1,24.95  ,24.95  ,"7,899.69  "
FireWrap® Grip Kit Green,01/05/2022,Sales Receipt,6927,,"FIREWRAP® GRIP KIT
Color: Green",1,24.95  ,24.95  ,"7,924.64  "
FireWrap® Grip Kit Green,01/07/2022,Sales Receipt,6945,,"FIREWRAP® GRIP KIT
Color: Green",1,24.95  ,24.95  ,"7,949.59  "
FireWrap® Grip Kit Green,01/07/2022,Sales Receipt,6946,,"FIREWRAP® GRIP KIT
Color: Green",1,24.95  ,24.95  ,"7,974.54  "
FireWrap® Grip Kit Green,01/09/2022,Sales Receipt,6962,,"FIREWRAP® GRIP KIT
Color: Green",1,24.95  ,24.95  ,"7,999.49  "
FireWrap® Grip Kit Green,01/10/2022,Sales Receipt,6968,,"FIREWRAP® GRIP KIT
Color: Green",1,24.95  ,24.95  ,"8,024.44  "
FireWrap® Grip Kit Green,01/13/2022,Sales Receipt,6996,,"FIREWRAP® GRIP KIT
Color: Green",1,24.95  ,24.95  ,"8,049.39  "
FireWrap® Grip Kit Green,01/14/2022,Sales Receipt,7007,,"FIREWRAP® GRIP KIT
Color: Green",1,24.95  ,24.95  ,"8,074.34  "
FireWrap® Grip Kit Green,01/18/2022,Invoice,M-011822-002,,FIREWRAP® GRIP KIT	Green,3,24.95  ,74.85  ,"8,149.19  "
FireWrap® Grip Kit Green,01/21/2022,Sales Receipt,7058,,"FIREWRAP® GRIP KIT
Color: Green",1,24.95  ,24.95  ,"8,174.14  "
FireWrap® Grip Kit Green,01/22/2022,Sales Receipt,7067,,"FIREWRAP® GRIP KIT
Color: Green",1,24.95  ,24.95  ,"8,199.09  "
FireWrap® Grip Kit Green,01/24/2022,Sales Receipt,7078,,"FIREWRAP® GRIP KIT
Color: Green",1,24.95  ,24.95  ,"8,224.04  "
FireWrap® Grip Kit Green,01/27/2022,Sales Receipt,7110,,"FIREWRAP® GRIP KIT
Color: Green",1,24.95  ,24.95  ,"8,248.99  "
FireWrap® Grip Kit Green,01/28/2022,Sales Receipt,7135,,"FIREWRAP® GRIP KIT
Color: Green",5,24.95  ,124.75  ,"8,373.74  "
FireWrap® Grip Kit Green,01/29/2022,Sales Receipt,7146,,"FIREWRAP® GRIP KIT
Color: Green",1,24.95  ,24.95  ,"8,398.69  "
FireWrap® Grip Kit Green,01/29/2022,Sales Receipt,7147,,"FIREWRAP® GRIP KIT
Color: Green",1,24.95  ,24.95  ,"8,423.64  "
FireWrap® Grip Kit Green,02/01/2022,Invoice,M-020122-002,,FIREWRAP® GRIP KIT	Green,3,21.75  ,65.25  ,"8,488.89  "
FireWrap® Grip Kit Green,02/03/2022,Sales Receipt,7186,,"FIREWRAP® GRIP KIT
Color: Green",1,27.95  ,27.95  ,"8,516.84  "
FireWrap® Grip Kit Green,02/03/2022,Sales Receipt,7191,,"FIREWRAP® GRIP KIT
Color: Green",1,27.95  ,27.95  ,"8,544.79  "
FireWrap® Grip Kit Green,02/05/2022,Sales Receipt,7202,,"FIREWRAP® GRIP KIT
Color: Green",1,27.95  ,27.95  ,"8,572.74  "
FireWrap® Grip Kit Green,02/07/2022,Sales Receipt,7217,,"FIREWRAP® GRIP KIT
Color: Green",3,27.95  ,83.85  ,"8,656.59  "
FireWrap® Grip Kit Green,02/08/2022,Sales Receipt,7235,,"FIREWRAP® GRIP KIT
Color: Green",1,27.95  ,27.95  ,"8,684.54  "
FireWrap® Grip Kit Green,02/10/2022,Sales Receipt,7253,,"FIREWRAP® GRIP KIT
Color: Green",5,27.95  ,139.75  ,"8,824.29  "
FireWrap® Grip Kit Green,02/10/2022,Sales Receipt,7252,,"FIREWRAP® GRIP KIT
Color: Green",1,27.95  ,27.95  ,"8,852.24  "
FireWrap® Grip Kit Green,02/10/2022,Sales Receipt,7255,,"FIREWRAP® GRIP KIT
Color: Green",6,27.95  ,167.70  ,"9,019.94  "
FireWrap® Grip Kit Green,02/13/2022,Sales Receipt,7283,,"FIREWRAP® GRIP KIT
Color: Green",1,27.95  ,27.95  ,"9,047.89  "
FireWrap® Grip Kit Green,02/17/2022,Sales Receipt,7306,,"FIREWRAP® GRIP KIT
Color: Green",3,27.95  ,83.85  ,"9,131.74  "
FireWrap® Grip Kit Green,02/19/2022,Sales Receipt,7327,,"FIREWRAP® GRIP KIT
Color: Green",1,27.95  ,27.95  ,"9,159.69  "
FireWrap® Grip Kit Green,02/22/2022,Invoice,M-022122-005,,FIREWRAP® GRIP KIT	Green,1,21.75  ,21.75  ,"9,181.44  "
FireWrap® Grip Kit Green,02/22/2022,Sales Receipt,7357,,"FIREWRAP® GRIP KIT
Color: Green",1,27.95  ,27.95  ,"9,209.39  "
FireWrap® Grip Kit Green,02/24/2022,Sales Receipt,7376,,"FIREWRAP® GRIP KIT
Color: Green",1,27.95  ,27.95  ,"9,237.34  "
FireWrap® Grip Kit Green,02/25/2022,Sales Receipt,7386,,"FIREWRAP® GRIP KIT
Color: Green",2,27.95  ,55.90  ,"9,293.24  "
FireWrap® Grip Kit Green,02/27/2022,Sales Receipt,7412,,"FIREWRAP® GRIP KIT
Color: Green",1,27.95  ,27.95  ,"9,321.19  "
FireWrap® Grip Kit Green,03/05/2022,Sales Receipt,7473,,"FIREWRAP® GRIP KIT
Color: Green",8,27.95  ,223.60  ,"9,544.79  "
FireWrap® Grip Kit Green,03/11/2022,Sales Receipt,7513,,"FIREWRAP® GRIP KIT
Color: Green",10,27.95  ,279.50  ,"9,824.29  "
FireWrap® Grip Kit Green,03/11/2022,Invoice,M-031122-004,,FIREWRAP® GRIP KIT	Green,1,21.75  ,21.75  ,"9,846.04  "
FireWrap® Grip Kit Green,03/12/2022,Sales Receipt,7525,,"FIREWRAP® GRIP KIT
Color: Green",1,27.95  ,27.95  ,"9,873.99  "
FireWrap® Grip Kit Green,03/14/2022,Invoice,M-031422-001,,FIREWRAP® GRIP KIT	Green,22,27.95  ,614.90  ,"10,488.89  "
FireWrap® Grip Kit Green,03/17/2022,Invoice,M-031722-003,,FIREWRAP® GRIP KIT	Green,1,21.75  ,21.75  ,"10,510.64  "
FireWrap® Grip Kit Green,03/17/2022,Sales Receipt,7552,,"FIREWRAP® GRIP KIT
Color: Green",1,27.95  ,27.95  ,"10,538.59  "
FireWrap® Grip Kit Green,03/18/2022,Sales Receipt,7563,,"FIREWRAP® GRIP KIT
Color: Green",4,27.95  ,111.80  ,"10,650.39  "
FireWrap® Grip Kit Green,03/20/2022,Sales Receipt,7576,,"FIREWRAP® GRIP KIT
Color: Green",1,27.95  ,27.95  ,"10,678.34  "
FireWrap® Grip Kit Green,03/22/2022,Sales Receipt,7599,,"FIREWRAP® GRIP KIT
Color: Green",1,27.95  ,27.95  ,"10,706.29  "
FireWrap® Grip Kit Green,03/28/2022,Sales Receipt,7641,,"FIREWRAP® GRIP KIT
Color: Green",4,27.95  ,111.80  ,"10,818.09  "
FireWrap® Grip Kit Green,03/29/2022,Sales Receipt,7651,,"FIREWRAP® GRIP KIT
Color: Green",2,27.95  ,55.90  ,"10,873.99  "
FireWrap® Grip Kit Green,03/29/2022,Sales Receipt,7649,,"FIREWRAP® GRIP KIT
Color: Green",1,27.95  ,27.95  ,"10,901.94  "
FireWrap® Grip Kit Green,03/30/2022,Sales Receipt,7657,,"FIREWRAP® GRIP KIT
Color: Green",1,27.95  ,27.95  ,"10,929.89  "
FireWrap® Grip Kit Green,04/05/2022,Sales Receipt,7692,,"FIREWRAP® GRIP KIT
Color: Green",2,27.95  ,55.90  ,"10,985.79  "
FireWrap® Grip Kit Green,04/06/2022,Sales Receipt,7698,,"FIREWRAP® GRIP KIT
Color: Green",4,27.95  ,111.80  ,"11,097.59  "
FireWrap® Grip Kit Green,04/11/2022,Sales Receipt,7735,,"FIREWRAP® GRIP KIT
Color: Green",2,27.95  ,55.90  ,"11,153.49  "
FireWrap® Grip Kit Green,04/14/2022,Sales Receipt,7757,,"FIREWRAP® GRIP KIT
Color: Green",1,27.95  ,27.95  ,"11,181.44  "
FireWrap® Grip Kit Green,04/19/2022,Sales Receipt,7778,,"FIREWRAP® GRIP KIT
Color: Green",1,27.95  ,27.95  ,"11,209.39  "
FireWrap® Grip Kit Green,04/21/2022,Sales Receipt,7791,,"FIREWRAP® GRIP KIT
Color: Green",1,27.95  ,27.95  ,"11,237.34  "
FireWrap® Grip Kit Green,04/22/2022,Invoice,M-041822-003,,FIREWRAP® GRIP KIT	Green,5,21.75  ,108.75  ,"11,346.09  "
FireWrap® Grip Kit Green,04/25/2022,Invoice,M-032422-005,,FIREWRAP® GRIP KIT	Green,2,21.75  ,43.50  ,"11,389.59  "
FireWrap® Grip Kit Green,04/25/2022,Invoice,M-033022-001,,FIREWRAP® GRIP KIT	Green,1,21.75  ,21.75  ,"11,411.34  "
FireWrap® Grip Kit Green,04/26/2022,Sales Receipt,7814,,"FIREWRAP® GRIP KIT
Color: Green",5,27.95  ,139.75  ,"11,551.09  "
FireWrap® Grip Kit Green,04/29/2022,Sales Receipt,7842,,"FIREWRAP® GRIP KIT
Color: Green",4,22.95  ,91.80  ,"11,642.89  "
FireWrap® Grip Kit Green,05/02/2022,Sales Receipt,7877,,"FIREWRAP® GRIP KIT
Color: Green",1,22.95  ,22.95  ,"11,665.84  "
FireWrap® Grip Kit Green,05/02/2022,Sales Receipt,7875,,"FIREWRAP® GRIP KIT
Color: Green",10,22.95  ,229.50  ,"11,895.34  "
FireWrap® Grip Kit Green,05/03/2022,Invoice,M-030122-003,,FIREWRAP® GRIP KIT	Green,6,16.50  ,99.00  ,"11,994.34  "
FireWrap® Grip Kit Green,05/03/2022,Invoice,M-041222-004,,FIREWRAP® GRIP KIT	Green,3,21.75  ,65.25  ,"12,059.59  "
FireWrap® Grip Kit Green,05/04/2022,Invoice,M-050422-001,,FIREWRAP® GRIP KIT	Green,4,27.95  ,111.80  ,"12,171.39  "
FireWrap® Grip Kit Green,05/10/2022,Sales Receipt,7927,,"FIREWRAP® GRIP KIT
Color: Green",1,27.95  ,27.95  ,"12,199.34  "
FireWrap® Grip Kit Green,05/11/2022,Invoice,M-051122-003,,FIREWRAP® GRIP KIT	Green,1,21.75  ,21.75  ,"12,221.09  "
FireWrap® Grip Kit Green,05/12/2022,Sales Receipt,7935,,"FIREWRAP® GRIP KIT
Color: Green",2,27.95  ,55.90  ,"12,276.99  "
FireWrap® Grip Kit Green,05/17/2022,Sales Receipt,7965,,"FIREWRAP® GRIP KIT
Color: Green",1,27.95  ,27.95  ,"12,304.94  "
FireWrap® Grip Kit Green,05/17/2022,Sales Receipt,7970,,"FIREWRAP® GRIP KIT
Color: Green",1,27.95  ,27.95  ,"12,332.89  "
FireWrap® Grip Kit Green,05/26/2022,Invoice,M-052622-005,,FIREWRAP® GRIP KIT	Green,2,21.75  ,43.50  ,"12,376.39  "
FireWrap® Grip Kit Green,05/26/2022,Invoice,M-052622-006,,FIREWRAP® GRIP KIT	Green,6,21.75  ,130.50  ,"12,506.89  "
FireWrap® Grip Kit Green,05/27/2022,Sales Receipt,8007,,"FIREWRAP® GRIP KIT
Color: Green",1,27.95  ,27.95  ,"12,534.84  "
FireWrap® Grip Kit Green,05/30/2022,Sales Receipt,8025,,"FIREWRAP® GRIP KIT
Color: Green",1,27.95  ,27.95  ,"12,562.79  "
FireWrap® Grip Kit Green,05/31/2022,Invoice,M-053122-002,,FIREWRAP® GRIP KIT	Green,6,16.50  ,99.00  ,"12,661.79  "
FireWrap® Grip Kit Green,06/07/2022,Sales Receipt,8059,,"FIREWRAP® GRIP KIT
Color: Green",1,27.95  ,27.95  ,"12,689.74  "
FireWrap® Grip Kit Green,06/09/2022,Sales Receipt,8087,,"FIREWRAP® GRIP KIT
Color: Green",1,27.95  ,27.95  ,"12,717.69  "
FireWrap® Grip Kit Green,06/10/2022,Invoice,M-061022-009,,FIREWRAP® GRIP KIT	Green,3,21.75  ,65.25  ,"12,782.94  "
FireWrap® Grip Kit Green,06/10/2022,Sales Receipt,8098,,"FIREWRAP® GRIP KIT
Color: Green",1,27.95  ,27.95  ,"12,810.89  "
FireWrap® Grip Kit Green,06/11/2022,Sales Receipt,8109,,"FIREWRAP® GRIP KIT
Color: Green",1,27.95  ,27.95  ,"12,838.84  "
FireWrap® Grip Kit Green,06/23/2022,Invoice,M-062322-001,,FIREWRAP® GRIP KIT	Green,1,21.75  ,21.75  ,"12,860.59  "
FireWrap® Grip Kit Green,06/23/2022,Invoice,M-041822-007-B,,FIREWRAP® GRIP KIT	Green,2,21.75  ,43.50  ,"12,904.09  "
FireWrap® Grip Kit Green,06/24/2022,Sales Receipt,8174,,"FIREWRAP® GRIP KIT
Color: Green",2,27.95  ,55.90  ,"12,959.99  "
FireWrap® Grip Kit Green,06/26/2022,Sales Receipt,8180,,"FIREWRAP® GRIP KIT
Color: Green",2,27.95  ,55.90  ,"13,015.89  "
FireWrap® Grip Kit Green,06/28/2022,Sales Receipt,8198,,"FIREWRAP® GRIP KIT
Color: Green",1,27.95  ,27.95  ,"13,043.84  "
FireWrap® Grip Kit Green,07/07/2022,Invoice,M-070722-001,,FIREWRAP® GRIP KIT	Green,5,27.95  ,139.75  ,"13,183.59  "
FireWrap® Grip Kit Green,07/09/2022,Sales Receipt,8274,,"FIREWRAP® GRIP KIT
Color: Green",2,27.95  ,55.90  ,"13,239.49  "
FireWrap® Grip Kit Green,07/10/2022,Sales Receipt,8279,,"FIREWRAP® GRIP KIT
Color: Green",1,27.95  ,27.95  ,"13,267.44  "
FireWrap® Grip Kit Green,07/12/2022,Invoice,M-071222-004,,FIREWRAP® GRIP KIT	Green,10,21.75  ,217.50  ,"13,484.94  "
FireWrap® Grip Kit Green,07/12/2022,Sales Receipt,8285,,"FIREWRAP® GRIP KIT
Color: Green",6,27.95  ,167.70  ,"13,652.64  "
FireWrap® Grip Kit Green,07/13/2022,Sales Receipt,8289,,"FIREWRAP® GRIP KIT
Color: Green",2,27.95  ,55.90  ,"13,708.54  "
FireWrap® Grip Kit Green,07/13/2022,Sales Receipt,8295,,"FIREWRAP® GRIP KIT
Color: Green",1,27.95  ,27.95  ,"13,736.49  "
FireWrap® Grip Kit Green,07/14/2022,Sales Receipt,8297,,"FIREWRAP® GRIP KIT
Color: Green",1,27.95  ,27.95  ,"13,764.44  "
FireWrap® Grip Kit Green,07/18/2022,Invoice,M-071822-004,,FIREWRAP® GRIP KIT	Green,4,21.75  ,87.00  ,"13,851.44  "
FireWrap® Grip Kit Green,07/18/2022,Invoice,M-071822-002,,FIREWRAP® GRIP KIT	Green,1,21.75  ,21.75  ,"13,873.19  "
FireWrap® Grip Kit Green,07/21/2022,Invoice,M-072122-003,,FIREWRAP® GRIP KIT	Green,5,21.75  ,108.75  ,"13,981.94  "
FireWrap® Grip Kit Green,07/21/2022,Invoice,M-072122-006,,FIREWRAP® GRIP KIT	Green,4,21.75  ,87.00  ,"14,068.94  "
FireWrap® Grip Kit Green,07/22/2022,Sales Receipt,8344,,"FIREWRAP® GRIP KIT
Color: Green",1,27.95  ,27.95  ,"14,096.89  "
FireWrap® Grip Kit Green,07/22/2022,Sales Receipt,8340,,"FIREWRAP® GRIP KIT
Color: Green",1,27.95  ,27.95  ,"14,124.84  "
FireWrap® Grip Kit Green,07/25/2022,Invoice,M-072122-007,,FIREWRAP® GRIP KIT	Green,12,27.95  ,335.40  ,"14,460.24  "
FireWrap® Grip Kit Green,07/28/2022,Invoice,M-063022-001,,FIREWRAP® GRIP KIT	Green,10,21.75  ,217.50  ,"14,677.74  "
FireWrap® Grip Kit Green,07/30/2022,Invoice,M-073022-002,,FIREWRAP® GRIP KIT	Green,3,21.75  ,65.25  ,"14,742.99  "
FireWrap® Grip Kit Green,08/02/2022,Sales Receipt,8416,,"FIREWRAP® GRIP KIT
Color: Green",1,27.95  ,27.95  ,"14,770.94  "
FireWrap® Grip Kit Green,08/04/2022,Sales Receipt,8428,,"FIREWRAP® GRIP KIT
Color: Green",5,27.95  ,139.75  ,"14,910.69  "
FireWrap® Grip Kit Green,08/05/2022,Sales Receipt,8434,,"FIREWRAP® GRIP KIT
Color: Green",2,27.95  ,55.90  ,"14,966.59  "
FireWrap® Grip Kit Green,08/06/2022,Sales Receipt,8437,,"FIREWRAP® GRIP KIT
Color: Green",1,27.95  ,27.95  ,"14,994.54  "
FireWrap® Grip Kit Green,08/08/2022,Sales Receipt,8447,,"FIREWRAP® GRIP KIT
Color: Green",1,27.95  ,27.95  ,"15,022.49  "
FireWrap® Grip Kit Green,08/08/2022,Invoice,M-080822-005,,FIREWRAP® GRIP KIT	Green,3,21.75  ,65.25  ,"15,087.74  "
FireWrap® Grip Kit Green,08/09/2022,Sales Receipt,8454,,"FIREWRAP® GRIP KIT
Color: Green",1,27.95  ,27.95  ,"15,115.69  "
FireWrap® Grip Kit Green,08/12/2022,Sales Receipt,8473,,"FIREWRAP® GRIP KIT
Color: Green",1,27.95  ,27.95  ,"15,143.64  "
FireWrap® Grip Kit Green,08/17/2022,Invoice,M-081722-002,,FIREWRAP® GRIP KIT	Green,4,21.75  ,87.00  ,"15,230.64  "
FireWrap® Grip Kit Green,08/18/2022,Sales Receipt,8504,,"FIREWRAP® GRIP KIT
Color: Green",1,27.95  ,27.95  ,"15,258.59  "
FireWrap® Grip Kit Green,08/21/2022,Sales Receipt,8530,,"FIREWRAP® GRIP KIT
Color: Green",1,27.95  ,27.95  ,"15,286.54  "
FireWrap® Grip Kit Green,08/26/2022,Sales Receipt,8562,,"FIREWRAP® GRIP KIT
Color: Green",1,27.95  ,27.95  ,"15,314.49  "
FireWrap® Grip Kit Green,08/28/2022,Sales Receipt,8584,,"FIREWRAP® GRIP KIT
Color: Green",1,27.95  ,27.95  ,"15,342.44  "
FireWrap® Grip Kit Green,08/30/2022,Sales Receipt,8589,,"FIREWRAP® GRIP KIT
Color: Green",4,27.95  ,111.80  ,"15,454.24  "
FireWrap® Grip Kit Green,08/30/2022,Sales Receipt,8593,,"FIREWRAP® GRIP KIT
Color: Green",1,27.95  ,27.95  ,"15,482.19  "
FireWrap® Grip Kit Green,08/30/2022,Sales Receipt,8592,,"FIREWRAP® GRIP KIT
Color: Green",2,27.95  ,55.90  ,"15,538.09  "
FireWrap® Grip Kit Green,08/31/2022,Sales Receipt,8596,,"FIREWRAP® GRIP KIT
Color: Green",1,27.95  ,27.95  ,"15,566.04  "
FireWrap® Grip Kit Green,09/02/2022,Invoice,M-090222-001,,FIREWRAP® GRIP KIT	Green,4,27.95  ,111.80  ,"15,677.84  "
FireWrap® Grip Kit Green,09/05/2022,Invoice,M-082422-002,,FIREWRAP® GRIP KIT	Green,6,21.75  ,130.50  ,"15,808.34  "
FireWrap® Grip Kit Green,09/05/2022,Invoice,M-090522-002,,FIREWRAP® GRIP KIT	Green,2,21.75  ,43.50  ,"15,851.84  "
FireWrap® Grip Kit Green,09/08/2022,Invoice,M-082522-003,,FIREWRAP® GRIP KIT	Green,1,21.75  ,21.75  ,"15,873.59  "
FireWrap® Grip Kit Green,09/08/2022,Invoice,M-082722-001,,FIREWRAP® GRIP KIT	Green,6,21.75  ,130.50  ,"16,004.09  "
FireWrap® Grip Kit Green,09/08/2022,Sales Receipt,8649,,"FIREWRAP® GRIP KIT
Color: Green",2,27.95  ,55.90  ,"16,059.99  "
FireWrap® Grip Kit Green,09/11/2022,Sales Receipt,8661,,"FIREWRAP® GRIP KIT
Color: Green",1,27.95  ,27.95  ,"16,087.94  "
FireWrap® Grip Kit Green,09/12/2022,Sales Receipt,8671,,"FIREWRAP® GRIP KIT
Color: Green",1,27.95  ,27.95  ,"16,115.89  "
FireWrap® Grip Kit Green,09/13/2022,Sales Receipt,8680,,"FIREWRAP® GRIP KIT
Color: Green",1,27.95  ,27.95  ,"16,143.84  "
FireWrap® Grip Kit Green,09/14/2022,Invoice,M-090922-001,,FIREWRAP® GRIP KIT	Green,6,27.95  ,167.70  ,"16,311.54  "
FireWrap® Grip Kit Green,09/15/2022,Sales Receipt,8689,,"FIREWRAP® GRIP KIT
Color: Green",2,27.95  ,55.90  ,"16,367.44  "
FireWrap® Grip Kit Green,09/22/2022,Sales Receipt,8732,,"FIREWRAP® GRIP KIT
Color: Green",1,27.95  ,27.95  ,"16,395.39  "
FireWrap® Grip Kit Green,09/24/2022,Sales Receipt,8749,,"FIREWRAP® GRIP KIT
Color: Green",1,27.95  ,27.95  ,"16,423.34  "
FireWrap® Grip Kit Green,09/25/2022,Invoice,M-092522-003,,FIREWRAP® GRIP KIT	Green,5,21.75  ,108.75  ,"16,532.09  "
FireWrap® Grip Kit Green,09/26/2022,Sales Receipt,8756,,"FIREWRAP® GRIP KIT
Color: Green",1,27.95  ,27.95  ,"16,560.04  "
FireWrap® Grip Kit Green,09/27/2022,Sales Receipt,8765,,"FIREWRAP® GRIP KIT
Color: Green",1,27.95  ,27.95  ,"16,587.99  "
FireWrap® Grip Kit Green,09/27/2022,Sales Receipt,8762,,"FIREWRAP® GRIP KIT
Color: Green",3,27.95  ,83.85  ,"16,671.84  "
FireWrap® Grip Kit Green,09/28/2022,Sales Receipt,8777,,"FIREWRAP® GRIP KIT
Color: Green",1,27.95  ,27.95  ,"16,699.79  "
FireWrap® Grip Kit Green,09/28/2022,Sales Receipt,8773,,"FIREWRAP® GRIP KIT
Color: Green",2,27.95  ,55.90  ,"16,755.69  "
FireWrap® Grip Kit Green,09/29/2022,Sales Receipt,8792,,"FIREWRAP® GRIP KIT
Color: Green",2,27.95  ,55.90  ,"16,811.59  "
FireWrap® Grip Kit Green,09/29/2022,Sales Receipt,8799,,"FIREWRAP® GRIP KIT
Color: Green",5,27.95  ,139.75  ,"16,951.34  "
FireWrap® Grip Kit Green,10/02/2022,Invoice,M-100222-001,,FIREWRAP® GRIP KIT	Green,7,21.75  ,152.25  ,"17,103.59  "
FireWrap® Grip Kit Green,10/03/2022,Invoice,M-100322-001,,FIREWRAP® GRIP KIT	Green,10,21.75  ,217.50  ,"17,321.09  "
FireWrap® Grip Kit Green,10/05/2022,Invoice,M-100522-002,,FIREWRAP® GRIP KIT	Green,13,21.75  ,282.75  ,"17,603.84  "
FireWrap® Grip Kit Green,10/07/2022,Sales Receipt,8853,,"FIREWRAP® GRIP KIT
Color: Green",1,27.95  ,27.95  ,"17,631.79  "
FireWrap® Grip Kit Green,10/08/2022,Sales Receipt,8866,,"FIREWRAP® GRIP KIT
Color: Green",1,27.95  ,27.95  ,"17,659.74  "
FireWrap® Grip Kit Green,10/08/2022,Sales Receipt,8867,,"FIREWRAP® GRIP KIT
Color: Green",2,27.95  ,55.90  ,"17,715.64  "
FireWrap® Grip Kit Green,10/11/2022,Invoice,M-101122-001,,FIREWRAP® GRIP KIT	Green,10,21.75  ,217.50  ,"17,933.14  "
FireWrap® Grip Kit Green,10/12/2022,Invoice,M-101222-006,,FIREWRAP® GRIP KIT	Green,1,21.75  ,21.75  ,"17,954.89  "
FireWrap® Grip Kit Green,10/12/2022,Invoice,M-101222-004,,FIREWRAP® GRIP KIT	Green,1,21.75  ,21.75  ,"17,976.64  "
FireWrap® Grip Kit Green,10/16/2022,Sales Receipt,8921,,"FIREWRAP® GRIP KIT
Color: Green",1,27.95  ,27.95  ,"18,004.59  "
FireWrap® Grip Kit Green,10/18/2022,Sales Receipt,8930,,"FIREWRAP® GRIP KIT
Color: Green",1,27.95  ,27.95  ,"18,032.54  "
FireWrap® Grip Kit Green,10/20/2022,Sales Receipt,8946,,"FIREWRAP® GRIP KIT
Color: Green",2,27.95  ,55.90  ,"18,088.44  "
FireWrap® Grip Kit Green,10/21/2022,Sales Receipt,8959,,"FIREWRAP® GRIP KIT
Color: Green",2,27.95  ,55.90  ,"18,144.34  "
FireWrap® Grip Kit Green,10/31/2022,Invoice,M-103122-003,,FIREWRAP® GRIP KIT	Green,2,21.75  ,43.50  ,"18,187.84  "
FireWrap® Grip Kit Green,10/31/2022,Invoice,M-103122-001,,FIREWRAP® GRIP KIT	Green,10,21.75  ,217.50  ,"18,405.34  "
FireWrap® Grip Kit Green,10/31/2022,Invoice,M-103122-002,,FIREWRAP® GRIP KIT	Green,5,21.75  ,108.75  ,"18,514.09  "
FireWrap® Grip Kit Green,11/02/2022,Sales Receipt,9018,,"FIREWRAP® GRIP KIT
Color: Green",8,27.95  ,223.60  ,"18,737.69  "
FireWrap® Grip Kit Green,11/05/2022,Invoice,M-110522-002,,FIREWRAP® GRIP KIT	Green,4,21.75  ,87.00  ,"18,824.69  "
FireWrap® Grip Kit Green,11/06/2022,Sales Receipt,9033,,"FIREWRAP® GRIP KIT
Color: Green",1,27.95  ,27.95  ,"18,852.64  "
FireWrap® Grip Kit Green,11/08/2022,Sales Receipt,9043,,"FIREWRAP® GRIP KIT
Color: Green",2,27.95  ,55.90  ,"18,908.54  "
FireWrap® Grip Kit Green,11/09/2022,Invoice,M-110922-003,,FIREWRAP® GRIP KIT	Green,2,21.75  ,43.50  ,"18,952.04  "
FireWrap® Grip Kit Green,11/09/2022,Sales Receipt,9054,,"FIREWRAP® GRIP KIT
Color: Green",1,27.95  ,27.95  ,"18,979.99  "
FireWrap® Grip Kit Green,11/09/2022,Invoice,M-110922-005,,FIREWRAP® GRIP KIT	Green,4,27.95  ,111.80  ,"19,091.79  "
FireWrap® Grip Kit Green,11/10/2022,Sales Receipt,M-114-1765128-8825824,,FireWrap® Grip Kit - Green,4,28.95  ,115.80  ,"19,207.59  "
FireWrap® Grip Kit Green,11/10/2022,Sales Receipt,9060,,"FIREWRAP® GRIP KIT
Color: Green",1,27.95  ,27.95  ,"19,235.54  "
FireWrap® Grip Kit Green,11/14/2022,Sales Receipt,9085,,"FIREWRAP® GRIP KIT
Color: Green",1,27.95  ,27.95  ,"19,263.49  "
FireWrap® Grip Kit Green,11/14/2022,Sales Receipt,9080,,"FIREWRAP® GRIP KIT
Color: Green",1,27.95  ,27.95  ,"19,291.44  "
FireWrap® Grip Kit Green,11/16/2022,Sales Receipt,9095,,"FIREWRAP® GRIP KIT
Color: Green",1,27.95  ,27.95  ,"19,319.39  "
FireWrap® Grip Kit Green,11/22/2022,Sales Receipt,9142,,"FIREWRAP® GRIP KIT
Color: Green",2,27.95  ,55.90  ,"19,375.29  "
FireWrap® Grip Kit Green,11/26/2022,Sales Receipt,9175,,"FIREWRAP® GRIP KIT
Color: Green",4,27.95  ,111.80  ,"19,487.09  "
FireWrap® Grip Kit Green,11/28/2022,Sales Receipt,9202,,"FIREWRAP® GRIP KIT
Color: Green",6,27.95  ,167.70  ,"19,654.79  "
FireWrap® Grip Kit Green,11/28/2022,Invoice,M-110922-002,,FIREWRAP® GRIP KIT	Green,1,21.75  ,21.75  ,"19,676.54  "
FireWrap® Grip Kit Green,11/28/2022,Invoice,M-112822-003,,FIREWRAP® GRIP KIT	Green,2,21.75  ,43.50  ,"19,720.04  "
FireWrap® Grip Kit Green,12/05/2022,Sales Receipt,9254,,"FIREWRAP® GRIP KIT
Color: Green",1,27.95  ,27.95  ,"19,747.99  "
FireWrap® Grip Kit Green,12/06/2022,Sales Receipt,M-112-9390446-5375444,,FireWrap® Grip Kit - Green,1,28.95  ,28.95  ,"19,776.94  "
FireWrap® Grip Kit Green,12/07/2022,Invoice,M-120722-001,,FIREWRAP® GRIP KIT	Green,4,21.75  ,87.00  ,"19,863.94  "
FireWrap® Grip Kit Green,12/07/2022,Sales Receipt,M-114-4652171-6393020,,FireWrap® Grip Kit - Green,1,28.95  ,28.95  ,"19,892.89  "
FireWrap® Grip Kit Green,12/07/2022,Sales Receipt,9263,,"FIREWRAP® GRIP KIT
Color: Green",1,27.95  ,27.95  ,"19,920.84  "
FireWrap® Grip Kit Green,12/08/2022,Sales Receipt,9277,,"FIREWRAP® GRIP KIT
Color: Green",3,27.95  ,83.85  ,"20,004.69  "
FireWrap® Grip Kit Green,12/09/2022,Sales Receipt,9286,,"FIREWRAP® GRIP KIT
Color: Green",2,27.95  ,55.90  ,"20,060.59  "
FireWrap® Grip Kit Green,12/12/2022,Invoice,M-121222-007,,FIREWRAP® GRIP KIT	Green,2,21.75  ,43.50  ,"20,104.09  "
FireWrap® Grip Kit Green,12/12/2022,Invoice,M-121222-008,,FIREWRAP® GRIP KIT	Green,3,21.75  ,65.25  ,"20,169.34  "
FireWrap® Grip Kit Green,12/12/2022,Invoice,M-121222-002B,,FIREWRAP® GRIP KIT	Green,5,21.75  ,108.75  ,"20,278.09  "
FireWrap® Grip Kit Green,12/12/2022,Invoice,M-121222-005,,FIREWRAP® GRIP KIT	Green,6,21.75  ,130.50  ,"20,408.59  "
FireWrap® Grip Kit Green,12/13/2022,Invoice,M-121322-001,,FIREWRAP® GRIP KIT	Green,1,21.75  ,21.75  ,"20,430.34  "
FireWrap® Grip Kit Green,12/14/2022,Sales Receipt,9324,,"FIREWRAP® GRIP KIT
Color: Green",1,27.95  ,27.95  ,"20,458.29  "
FireWrap® Grip Kit Green,12/15/2022,Sales Receipt,9328,,"FIREWRAP® GRIP KIT
Color: Green",6,27.95  ,167.70  ,"20,625.99  "
FireWrap® Grip Kit Green,12/16/2022,Sales Receipt,9344,,"FIREWRAP® GRIP KIT
Color: Green",1,27.95  ,27.95  ,"20,653.94  "
FireWrap® Grip Kit Green,12/16/2022,Sales Receipt,9340,,"FIREWRAP® GRIP KIT
Color: Green",1,27.95  ,27.95  ,"20,681.89  "
FireWrap® Grip Kit Green,12/17/2022,Sales Receipt,9352,,"FIREWRAP® GRIP KIT
Color: Green",8,27.95  ,223.60  ,"20,905.49  "
FireWrap® Grip Kit Green,12/19/2022,Sales Receipt,M-114-1994168-1278665,,FireWrap® Grip Kit - Green,1,28.95  ,28.95  ,"20,934.44  "
FireWrap® Grip Kit Green,12/20/2022,Invoice,M-122022-004,,FIREWRAP® GRIP KIT	Green,20,27.95  ,559.00  ,"21,493.44  "
FireWrap® Grip Kit Green,12/23/2022,Sales Receipt,9385,,"FIREWRAP® GRIP KIT
Color: Green",1,27.95  ,27.95  ,"21,521.39  "
FireWrap® Grip Kit Green,12/27/2022,Invoice,M-121922-004,,FIREWRAP® GRIP KIT	Green,1,21.75  ,21.75  ,"21,543.14  "
FireWrap® Grip Kit Green,12/27/2022,Invoice,M-122022-001,,FIREWRAP® GRIP KIT	Green,3,21.75  ,65.25  ,"21,608.39  "
FireWrap® Grip Kit Green,12/27/2022,Invoice,M-121922-006,,FIREWRAP® GRIP KIT	Green,1,21.75  ,21.75  ,"21,630.14  "
FireWrap® Grip Kit Green,12/29/2022,Sales Receipt,M-113-3346540-4086640,,FireWrap® Grip Kit - Green,1,28.95  ,28.95  ,"21,659.09  "
FireWrap® Grip Kit Green,01/02/2023,Sales Receipt,9445,,"FIREWRAP® GRIP KIT
Color: Green",1,27.95  ,27.95  ,"21,687.04  "
FireWrap® Grip Kit Green,01/03/2023,Invoice,M-010323-003,,FIREWRAP® GRIP KIT	Green,2,27.95  ,55.90  ,"21,742.94  "
FireWrap® Grip Kit Green,01/07/2023,Sales Receipt,9472,,"FIREWRAP® GRIP KIT
Color: Green",4,27.95  ,111.80  ,"21,854.74  "
Total for FireWrap® Grip Kit Green,,,,,,907,,"$	21,854.74  ",
FireWrap® Grip Kit Orange,,,,,,,,,
FireWrap® Grip Kit Orange,03/26/2021,Invoice,M-032621-012,,FIREWRAP® GRIP KIT	Orange,2,18.75  ,37.50  ,37.50  
FireWrap® Grip Kit Orange,03/26/2021,Invoice,M-032621-001,,FIREWRAP® GRIP KIT	Orange,1,18.75  ,18.75  ,56.25  
FireWrap® Grip Kit Orange,04/27/2021,Invoice,M-042721-002,,FIREWRAP® GRIP KIT	Orange,3,18.75  ,56.25  ,112.50  
FireWrap® Grip Kit Orange,07/08/2021,Invoice,M-070821-001,,FIREWRAP® GRIP KIT	Orange,10,18.75  ,187.50  ,300.00  
FireWrap® Grip Kit Orange,08/09/2021,Invoice,M-080921-003,,FIREWRAP® GRIP KIT	Orange,6,18.75  ,112.50  ,412.50  
FireWrap® Grip Kit Orange,08/18/2021,Invoice,M-081821-008,,FIREWRAP® GRIP KIT	Orange,1,15.00  ,15.00  ,427.50  
FireWrap® Grip Kit Orange,08/18/2021,Invoice,M-081821-006,,FIREWRAP® GRIP KIT	Orange,2,15.00  ,30.00  ,457.50  
FireWrap® Grip Kit Orange,09/22/2021,Invoice,M-092221-001,,FIREWRAP® GRIP KIT	Orange,1,18.75  ,18.75  ,476.25  
FireWrap® Grip Kit Orange,10/07/2021,Invoice,M-100721-006,,FIREWRAP® GRIP KIT	Orange,2,24.95  ,49.90  ,526.15  
FireWrap® Grip Kit Orange,10/27/2021,Invoice,M-102721-005,,FIREWRAP® GRIP KIT	Orange,5,18.75  ,93.75  ,619.90  
FireWrap® Grip Kit Orange,10/28/2021,Invoice,M-102821-005,,FIREWRAP® GRIP KIT	Orange,1,24.95  ,24.95  ,644.85  
FireWrap® Grip Kit Orange,12/02/2021,Invoice,M-120221-001,,FIREWRAP® GRIP KIT	Orange,1,19.99  ,19.99  ,664.84  
FireWrap® Grip Kit Orange,12/17/2021,Invoice,M-121721-007,,FIREWRAP® GRIP KIT	Orange,1,18.75  ,18.75  ,683.59  
FireWrap® Grip Kit Orange,12/22/2021,Invoice,M-122221-001,,FIREWRAP® GRIP KIT	Orange,4,18.75  ,75.00  ,758.59  
FireWrap® Grip Kit Orange,01/04/2022,Invoice,M-010422-003,,FIREWRAP® GRIP KIT	Orange,2,18.75  ,37.50  ,796.09  
FireWrap® Grip Kit Orange,01/12/2022,Invoice,M-011222-004,,FIREWRAP® GRIP KIT	Orange,3,18.75  ,56.25  ,852.34  
FireWrap® Grip Kit Orange,01/18/2022,Invoice,M-011822-001,,FIREWRAP® GRIP KIT	Orange,1,18.75  ,18.75  ,871.09  
FireWrap® Grip Kit Orange,01/18/2022,Invoice,M-011822-002,,FIREWRAP® GRIP KIT	Orange,6,24.95  ,149.70  ,"1,020.79  "
FireWrap® Grip Kit Orange,01/21/2022,Invoice,M-012122-001,,FIREWRAP® GRIP KIT	Orange,1,18.75  ,18.75  ,"1,039.54  "
FireWrap® Grip Kit Orange,02/01/2022,Invoice,M-020122-005,,FIREWRAP® GRIP KIT	Orange,6,24.95  ,149.70  ,"1,189.24  "
FireWrap® Grip Kit Orange,02/01/2022,Invoice,M-020122-002,,FIREWRAP® GRIP KIT	Orange,6,21.75  ,130.50  ,"1,319.74  "
FireWrap® Grip Kit Orange,02/21/2022,Invoice,M-022122-006,,FIREWRAP® GRIP KIT	Orange,2,21.75  ,43.50  ,"1,363.24  "
FireWrap® Grip Kit Orange,02/22/2022,Invoice,M-022222-002,,FIREWRAP® GRIP KIT	Orange,10,21.75  ,217.50  ,"1,580.74  "
FireWrap® Grip Kit Orange,02/22/2022,Invoice,M-022122-005,,FIREWRAP® GRIP KIT	Orange,1,21.75  ,21.75  ,"1,602.49  "
FireWrap® Grip Kit Orange,03/11/2022,Invoice,M-031122-002,,FIREWRAP® GRIP KIT	Orange,2,27.95  ,55.90  ,"1,658.39  "
FireWrap® Grip Kit Orange,03/14/2022,Invoice,M-031422-001,,FIREWRAP® GRIP KIT	Orange,14,27.95  ,391.30  ,"2,049.69  "
FireWrap® Grip Kit Orange,03/15/2022,Invoice,M-012522-016,,FIREWRAP® GRIP KIT	Orange,1,18.75  ,18.75  ,"2,068.44  "
FireWrap® Grip Kit Orange,03/17/2022,Invoice,M-031722-003,,FIREWRAP® GRIP KIT	Orange,1,21.75  ,21.75  ,"2,090.19  "
FireWrap® Grip Kit Orange,03/18/2022,Invoice,M-030122-005B,,FIREWRAP® GRIP KIT	Orange,0,,0.00  ,"2,090.19  "
FireWrap® Grip Kit Orange,03/30/2022,Invoice,M-033022-005,,FIREWRAP® GRIP KIT	Orange,1,27.95  ,27.95  ,"2,118.14  "
FireWrap® Grip Kit Orange,04/18/2022,Invoice,M-041822-005,,FIREWRAP® GRIP KIT	Orange,1,21.75  ,21.75  ,"2,139.89  "
FireWrap® Grip Kit Orange,04/22/2022,Invoice,M-042222-001,,FIREWRAP® GRIP KIT	Orange,3,27.95  ,83.85  ,"2,223.74  "
FireWrap® Grip Kit Orange,05/03/2022,Invoice,M-030122-003,,FIREWRAP® GRIP KIT	Orange,8,16.50  ,132.00  ,"2,355.74  "
FireWrap® Grip Kit Orange,05/03/2022,Invoice,M-041222-008,,FIREWRAP® GRIP KIT	Orange,1,21.75  ,21.75  ,"2,377.49  "
FireWrap® Grip Kit Orange,05/04/2022,Invoice,M-050422-001,,FIREWRAP® GRIP KIT	Orange,4,27.95  ,111.80  ,"2,489.29  "
FireWrap® Grip Kit Orange,05/10/2022,Invoice,M-050322-004,,FIREWRAP® GRIP KIT	Orange,2,21.75  ,43.50  ,"2,532.79  "
FireWrap® Grip Kit Orange,05/20/2022,Invoice,M-050922-003,,FIREWRAP® GRIP KIT	Orange,1,21.75  ,21.75  ,"2,554.54  "
FireWrap® Grip Kit Orange,05/26/2022,Invoice,M-052622-007,,FIREWRAP® GRIP KIT	Orange,1,21.75  ,21.75  ,"2,576.29  "
FireWrap® Grip Kit Orange,05/31/2022,Invoice,M-053122-002,,FIREWRAP® GRIP KIT	Orange,16,16.50  ,264.00  ,"2,840.29  "
FireWrap® Grip Kit Orange,06/10/2022,Invoice,M-061022-009,,FIREWRAP® GRIP KIT	Orange,3,21.75  ,65.25  ,"2,905.54  "
FireWrap® Grip Kit Orange,06/19/2022,Invoice,M-061922-002,,FIREWRAP® GRIP KIT	Orange,1,21.75  ,21.75  ,"2,927.29  "
FireWrap® Grip Kit Orange,06/23/2022,Invoice,M-052622-009,,FIREWRAP® GRIP KIT	Orange,10,21.75  ,217.50  ,"3,144.79  "
FireWrap® Grip Kit Orange,06/23/2022,Invoice,M-062322-001,,FIREWRAP® GRIP KIT	Orange,8,21.75  ,174.00  ,"3,318.79  "
FireWrap® Grip Kit Orange,06/23/2022,Invoice,M-062322-002,,FIREWRAP® GRIP KIT	Orange,3,21.75  ,65.25  ,"3,384.04  "
FireWrap® Grip Kit Orange,06/23/2022,Invoice,M-041822-007-B,,FIREWRAP® GRIP KIT	Orange,2,21.75  ,43.50  ,"3,427.54  "
FireWrap® Grip Kit Orange,07/12/2022,Invoice,M-071222-001,,FIREWRAP® GRIP KIT	Orange,6,21.75  ,130.50  ,"3,558.04  "
FireWrap® Grip Kit Orange,07/12/2022,Invoice,M-071222-004,,FIREWRAP® GRIP KIT	Orange,2,21.75  ,43.50  ,"3,601.54  "
FireWrap® Grip Kit Orange,07/18/2022,Invoice,M-071822-004,,FIREWRAP® GRIP KIT	Orange,10,21.75  ,217.50  ,"3,819.04  "
FireWrap® Grip Kit Orange,07/18/2022,Invoice,M-071822-003,,FIREWRAP® GRIP KIT	Orange,10,21.75  ,217.50  ,"4,036.54  "
FireWrap® Grip Kit Orange,07/21/2022,Invoice,M-072122-003,,FIREWRAP® GRIP KIT	Orange,4,21.75  ,87.00  ,"4,123.54  "
FireWrap® Grip Kit Orange,07/25/2022,Invoice,M-072122-007,,FIREWRAP® GRIP KIT	Orange,12,27.95  ,335.40  ,"4,458.94  "
FireWrap® Grip Kit Orange,08/08/2022,Invoice,M-080822-005,,FIREWRAP® GRIP KIT	Orange,2,21.75  ,43.50  ,"4,502.44  "
FireWrap® Grip Kit Orange,08/17/2022,Invoice,M-081722-002,,FIREWRAP® GRIP KIT	Orange,2,21.75  ,43.50  ,"4,545.94  "
FireWrap® Grip Kit Orange,08/30/2022,Invoice,M-083022-003,,FIREWRAP® GRIP KIT	Orange,1,21.75  ,21.75  ,"4,567.69  "
FireWrap® Grip Kit Orange,09/05/2022,Invoice,M-082422-002,,FIREWRAP® GRIP KIT	Orange,6,21.75  ,130.50  ,"4,698.19  "
FireWrap® Grip Kit Orange,09/08/2022,Invoice,M-082522-003,,FIREWRAP® GRIP KIT	Orange,3,21.75  ,65.25  ,"4,763.44  "
FireWrap® Grip Kit Orange,09/08/2022,Invoice,M-082722-001,,FIREWRAP® GRIP KIT	Orange,2,21.75  ,43.50  ,"4,806.94  "
FireWrap® Grip Kit Orange,09/15/2022,Invoice,M-090722-002B,,FIREWRAP® GRIP KIT	Orange,2,21.75  ,43.50  ,"4,850.44  "
FireWrap® Grip Kit Orange,09/25/2022,Invoice,M-092522-003,,FIREWRAP® GRIP KIT	Orange,10,21.75  ,217.50  ,"5,067.94  "
FireWrap® Grip Kit Orange,10/03/2022,Invoice,M-100322-002,,FIREWRAP® GRIP KIT	Orange,6,21.75  ,130.50  ,"5,198.44  "
FireWrap® Grip Kit Orange,10/05/2022,Invoice,M-100522-002,,FIREWRAP® GRIP KIT	Orange,1,21.75  ,21.75  ,"5,220.19  "
FireWrap® Grip Kit Orange,10/31/2022,Invoice,M-103122-002,,FIREWRAP® GRIP KIT	Orange,5,21.75  ,108.75  ,"5,328.94  "
FireWrap® Grip Kit Orange,10/31/2022,Invoice,M-103122-001,,FIREWRAP® GRIP KIT	Orange,1,21.75  ,21.75  ,"5,350.69  "
FireWrap® Grip Kit Orange,11/05/2022,Invoice,M-110522-002,,FIREWRAP® GRIP KIT	Orange,3,21.75  ,65.25  ,"5,415.94  "
FireWrap® Grip Kit Orange,11/28/2022,Invoice,M-112222-004,,FIREWRAP® GRIP KIT	Orange,15,21.75  ,326.25  ,"5,742.19  "
FireWrap® Grip Kit Orange,11/28/2022,Invoice,M-110922-002,,FIREWRAP® GRIP KIT	Orange,5,21.75  ,108.75  ,"5,850.94  "
FireWrap® Grip Kit Orange,12/07/2022,Invoice,M-120722-003,,FIREWRAP® GRIP KIT	Orange,2,21.75  ,43.50  ,"5,894.44  "
FireWrap® Grip Kit Orange,12/12/2022,Invoice,M-121222-002B,,FIREWRAP® GRIP KIT	Orange,5,21.75  ,108.75  ,"6,003.19  "
FireWrap® Grip Kit Orange,12/13/2022,Invoice,M-121322-001,,FIREWRAP® GRIP KIT	Orange,1,21.75  ,21.75  ,"6,024.94  "
FireWrap® Grip Kit Orange,12/27/2022,Invoice,M-121922-006,,FIREWRAP® GRIP KIT	Orange,1,21.75  ,21.75  ,"6,046.69  "
FireWrap® Grip Kit Orange,12/27/2022,Invoice,M-121922-005,,FIREWRAP® GRIP KIT	Orange,5,21.75  ,108.75  ,"6,155.44  "
Total for FireWrap® Grip Kit Orange,,,,,,283,,"$	6,155.44  ",
FireWrap® Grip Kit Red,,,,,,,,,
FireWrap® Grip Kit Red,03/26/2021,Invoice,M-032621-013,,FIREWRAP® GRIP KIT 	Red,2,18.75  ,37.50  ,37.50  
FireWrap® Grip Kit Red,03/26/2021,Invoice,M-032621-015,,FIREWRAP® GRIP KIT 	Red,40,18.75  ,750.00  ,787.50  
FireWrap® Grip Kit Red,03/26/2021,Invoice,M-032621-012,,FIREWRAP® GRIP KIT 	Red,4,18.75  ,75.00  ,862.50  
FireWrap® Grip Kit Red,03/26/2021,Invoice,M-032621-003,,FIREWRAP® GRIP KIT 	Red,1,18.75  ,18.75  ,881.25  
FireWrap® Grip Kit Red,03/26/2021,Credit Memo,M-032621-016,,FIREWRAP® GRIP KIT 	Red,0,,0.00  ,881.25  
FireWrap® Grip Kit Red,03/26/2021,Invoice,M-032621-007,,FIREWRAP® GRIP KIT 	Red,1,18.75  ,18.75  ,900.00  
FireWrap® Grip Kit Red,03/26/2021,Invoice,M-032621-002,,FIREWRAP® GRIP KIT 	Red,2,18.75  ,37.50  ,937.50  
FireWrap® Grip Kit Red,03/26/2021,Invoice,M-032621-008,,FIREWRAP® GRIP KIT 	Red,10,18.75  ,187.50  ,"1,125.00  "
FireWrap® Grip Kit Red,03/26/2021,Invoice,M-032621-014,,FIREWRAP® GRIP KIT 	Red,1,18.75  ,18.75  ,"1,143.75  "
FireWrap® Grip Kit Red,04/17/2021,Invoice,M-041721-002,,FIREWRAP® GRIP KIT 	Red,14,24.99  ,349.86  ,"1,493.61  "
FireWrap® Grip Kit Red,04/27/2021,Invoice,M-042721-004,,FIREWRAP® GRIP KIT 	Red,20,18.75  ,375.00  ,"1,868.61  "
FireWrap® Grip Kit Red,07/08/2021,Invoice,M-070821-001,,FIREWRAP® GRIP KIT 	Red,10,18.75  ,187.50  ,"2,056.11  "
FireWrap® Grip Kit Red,08/24/2021,Invoice,M-082421-003,,FIREWRAP® GRIP KIT 	Red,1,24.99  ,24.99  ,"2,081.10  "
FireWrap® Grip Kit Red,09/07/2021,Invoice,M-090721-002,,FIREWRAP® GRIP KIT 	Red,7,18.75  ,131.25  ,"2,212.35  "
FireWrap® Grip Kit Red,10/07/2021,Invoice,M-100721-003,,FIREWRAP® GRIP KIT 	Red,5,18.75  ,93.75  ,"2,306.10  "
FireWrap® Grip Kit Red,10/07/2021,Invoice,M-100721-008,,FIREWRAP® GRIP KIT 	Red,6,18.75  ,112.50  ,"2,418.60  "
FireWrap® Grip Kit Red,10/18/2021,Invoice,M-101821-006,,FIREWRAP® GRIP KIT 	Red,1,18.75  ,18.75  ,"2,437.35  "
FireWrap® Grip Kit Red,10/20/2021,Invoice,M-102021-005,,FIREWRAP® GRIP KIT 	Red,21,18.75  ,393.75  ,"2,831.10  "
FireWrap® Grip Kit Red,10/27/2021,Invoice,M-102721-005,,FIREWRAP® GRIP KIT 	Red,1,18.75  ,18.75  ,"2,849.85  "
FireWrap® Grip Kit Red,11/02/2021,Invoice,M-091021-001,,FIREWRAP® GRIP KIT 	Red,3,18.75  ,56.25  ,"2,906.10  "
FireWrap® Grip Kit Red,11/19/2021,Invoice,M-111921-002,,FIREWRAP® GRIP KIT 	Red,10,18.75  ,187.50  ,"3,093.60  "
FireWrap® Grip Kit Red,11/25/2021,Invoice,M-112521-001,,FIREWRAP® GRIP KIT 	Red,11,24.95  ,274.45  ,"3,368.05  "
FireWrap® Grip Kit Red,12/02/2021,Invoice,M-120221-001,,FIREWRAP® GRIP KIT 	Red,1,19.99  ,19.99  ,"3,388.04  "
FireWrap® Grip Kit Red,12/09/2021,Invoice,M-120921-001,,FIREWRAP® GRIP KIT 	Red,1,18.75  ,18.75  ,"3,406.79  "
FireWrap® Grip Kit Red,12/17/2021,Invoice,M-121721-002,,FIREWRAP® GRIP KIT 	Red,5,18.75  ,93.75  ,"3,500.54  "
FireWrap® Grip Kit Red,12/22/2021,Invoice,M-122221-001,,FIREWRAP® GRIP KIT 	Red,22,18.75  ,412.50  ,"3,913.04  "
FireWrap® Grip Kit Red,01/12/2022,Invoice,M-011222-004,,FIREWRAP® GRIP KIT 	Red,7,18.75  ,131.25  ,"4,044.29  "
FireWrap® Grip Kit Red,01/18/2022,Invoice,M-011822-007,,FIREWRAP® GRIP KIT 	Red,1,24.95  ,24.95  ,"4,069.24  "
FireWrap® Grip Kit Red,02/14/2022,Invoice,M-021422-002,,FIREWRAP® GRIP KIT 	Red,2,21.75  ,43.50  ,"4,112.74  "
FireWrap® Grip Kit Red,02/21/2022,Invoice,M-022122-001,,FIREWRAP® GRIP KIT 	Red,2,27.95  ,55.90  ,"4,168.64  "
FireWrap® Grip Kit Red,02/21/2022,Invoice,M-022122-006,,FIREWRAP® GRIP KIT 	Red,4,21.75  ,87.00  ,"4,255.64  "
FireWrap® Grip Kit Red,02/21/2022,Invoice,M-022122-004,,FIREWRAP® GRIP KIT 	Red,1,21.75  ,21.75  ,"4,277.39  "
FireWrap® Grip Kit Red,02/22/2022,Invoice,M-022122-005,,FIREWRAP® GRIP KIT 	Red,7,21.75  ,152.25  ,"4,429.64  "
FireWrap® Grip Kit Red,03/04/2022,Invoice,M-030422-004,,FIREWRAP® GRIP KIT 	Red,2,21.75  ,43.50  ,"4,473.14  "
FireWrap® Grip Kit Red,03/11/2022,Invoice,M-031122-004,,FIREWRAP® GRIP KIT 	Red,9,21.75  ,195.75  ,"4,668.89  "
FireWrap® Grip Kit Red,03/11/2022,Invoice,M-031122-002,,FIREWRAP® GRIP KIT 	Red,4,27.95  ,111.80  ,"4,780.69  "
FireWrap® Grip Kit Red,03/14/2022,Invoice,M-031422-001,,FIREWRAP® GRIP KIT 	Red,18,27.95  ,503.10  ,"5,283.79  "
FireWrap® Grip Kit Red,03/15/2022,Invoice,M-012522-016,,FIREWRAP® GRIP KIT 	Red,2,18.75  ,37.50  ,"5,321.29  "
FireWrap® Grip Kit Red,03/17/2022,Invoice,M-031722-003,,FIREWRAP® GRIP KIT 	Red,1,21.75  ,21.75  ,"5,343.04  "
FireWrap® Grip Kit Red,03/18/2022,Invoice,M-031822-001,,FIREWRAP® GRIP KIT 	Red,1,21.75  ,21.75  ,"5,364.79  "
FireWrap® Grip Kit Red,03/18/2022,Invoice,M-030122-005B,,FIREWRAP® GRIP KIT 	Red,0,,0.00  ,"5,364.79  "
FireWrap® Grip Kit Red,03/21/2022,Invoice,M-020422-003,,FIREWRAP® GRIP KIT 	Red,2,21.75  ,43.50  ,"5,408.29  "
FireWrap® Grip Kit Red,03/30/2022,Invoice,M-033022-005,,FIREWRAP® GRIP KIT 	Red,1,27.95  ,27.95  ,"5,436.24  "
FireWrap® Grip Kit Red,04/15/2022,Invoice,M-030422-003,,FIREWRAP® GRIP KIT 	Red,3,21.75  ,65.25  ,"5,501.49  "
FireWrap® Grip Kit Red,04/18/2022,Invoice,M-041822-005,,FIREWRAP® GRIP KIT 	Red,3,21.75  ,65.25  ,"5,566.74  "
FireWrap® Grip Kit Red,04/18/2022,Invoice,M-041822-002,,FIREWRAP® GRIP KIT 	Red,22,21.75  ,478.50  ,"6,045.24  "
FireWrap® Grip Kit Red,04/22/2022,Invoice,M-042222-001,,FIREWRAP® GRIP KIT 	Red,6,27.95  ,167.70  ,"6,212.94  "
FireWrap® Grip Kit Red,04/22/2022,Invoice,M-041822-003,,FIREWRAP® GRIP KIT 	Red,8,21.75  ,174.00  ,"6,386.94  "
FireWrap® Grip Kit Red,04/25/2022,Invoice,M-032422-005,,FIREWRAP® GRIP KIT 	Red,1,21.75  ,21.75  ,"6,408.69  "
FireWrap® Grip Kit Red,04/25/2022,Invoice,M-033022-003,,FIREWRAP® GRIP KIT 	Red,1,21.75  ,21.75  ,"6,430.44  "
FireWrap® Grip Kit Red,04/28/2022,Invoice,M-040522-001,,FIREWRAP® GRIP KIT 	Red,8,21.75  ,174.00  ,"6,604.44  "
FireWrap® Grip Kit Red,05/03/2022,Invoice,M-041222-006,,FIREWRAP® GRIP KIT 	Red,1,21.75  ,21.75  ,"6,626.19  "
FireWrap® Grip Kit Red,05/03/2022,Invoice,M-041222-004,,FIREWRAP® GRIP KIT 	Red,2,21.75  ,43.50  ,"6,669.69  "
FireWrap® Grip Kit Red,05/03/2022,Invoice,M-030122-003,,FIREWRAP® GRIP KIT 	Red,20,16.50  ,330.00  ,"6,999.69  "
FireWrap® Grip Kit Red,05/03/2022,Invoice,M-041222-002,,FIREWRAP® GRIP KIT 	Red,1,21.75  ,21.75  ,"7,021.44  "
FireWrap® Grip Kit Red,05/04/2022,Invoice,M-050422-001,,FIREWRAP® GRIP KIT 	Red,4,27.95  ,111.80  ,"7,133.24  "
FireWrap® Grip Kit Red,05/09/2022,Invoice,M-050922-008,,FIREWRAP® GRIP KIT 	Red,2,21.75  ,43.50  ,"7,176.74  "
FireWrap® Grip Kit Red,05/11/2022,Invoice,M-051122-004,,FIREWRAP® GRIP KIT 	Red,1,21.75  ,21.75  ,"7,198.49  "
FireWrap® Grip Kit Red,05/11/2022,Invoice,M-051122-002,,FIREWRAP® GRIP KIT 	Red,2,21.75  ,43.50  ,"7,241.99  "
FireWrap® Grip Kit Red,05/12/2022,Invoice,M-050922-006,,FIREWRAP® GRIP KIT 	Red,13,27.95  ,363.35  ,"7,605.34  "
FireWrap® Grip Kit Red,05/17/2022,Invoice,M-051722-002,,FIREWRAP® GRIP KIT 	Red,10,27.95  ,279.50  ,"7,884.84  "
FireWrap® Grip Kit Red,05/20/2022,Invoice,M-050922-004,,FIREWRAP® GRIP KIT 	Red,1,21.75  ,21.75  ,"7,906.59  "
FireWrap® Grip Kit Red,05/20/2022,Invoice,M-051122-001,,FIREWRAP® GRIP KIT 	Red,2,21.75  ,43.50  ,"7,950.09  "
FireWrap® Grip Kit Red,05/23/2022,Invoice,M-052322-004,,FIREWRAP® GRIP KIT 	Red,7,21.75  ,152.25  ,"8,102.34  "
FireWrap® Grip Kit Red,05/23/2022,Invoice,M-052322-001,,FIREWRAP® GRIP KIT 	Red,27,21.75  ,587.25  ,"8,689.59  "
FireWrap® Grip Kit Red,05/26/2022,Invoice,M-052622-005,,FIREWRAP® GRIP KIT 	Red,18,21.75  ,391.50  ,"9,081.09  "
FireWrap® Grip Kit Red,05/31/2022,Invoice,M-053122-002,,FIREWRAP® GRIP KIT 	Red,1,16.50  ,16.50  ,"9,097.59  "
FireWrap® Grip Kit Red,05/31/2022,Invoice,M-053122-003A,,FIREWRAP® GRIP KIT 	Red,5,21.75  ,108.75  ,"9,206.34  "
FireWrap® Grip Kit Red,06/10/2022,Invoice,M-061022-001,,FIREWRAP® GRIP KIT 	Red,1,21.75  ,21.75  ,"9,228.09  "
FireWrap® Grip Kit Red,06/19/2022,Invoice,M-061922-003,,FIREWRAP® GRIP KIT 	Red,3,21.75  ,65.25  ,"9,293.34  "
FireWrap® Grip Kit Red,06/23/2022,Invoice,M-062322-001,,FIREWRAP® GRIP KIT 	Red,14,21.75  ,304.50  ,"9,597.84  "
FireWrap® Grip Kit Red,06/23/2022,Invoice,M-041822-007-B,,FIREWRAP® GRIP KIT 	Red,2,21.75  ,43.50  ,"9,641.34  "
FireWrap® Grip Kit Red,06/23/2022,Invoice,M-061522-001-B,,FIREWRAP® GRIP KIT 	Red,2,21.75  ,43.50  ,"9,684.84  "
FireWrap® Grip Kit Red,06/23/2022,Invoice,M-052622-009,,FIREWRAP® GRIP KIT 	Red,10,21.75  ,217.50  ,"9,902.34  "
FireWrap® Grip Kit Red,07/07/2022,Invoice,M-070722-001,,FIREWRAP® GRIP KIT 	Red,1,27.95  ,27.95  ,"9,930.29  "
FireWrap® Grip Kit Red,07/12/2022,Invoice,M-071222-004,,FIREWRAP® GRIP KIT 	Red,17,21.75  ,369.75  ,"10,300.04  "
FireWrap® Grip Kit Red,07/18/2022,Invoice,M-071822-002,,FIREWRAP® GRIP KIT 	Red,1,21.75  ,21.75  ,"10,321.79  "
FireWrap® Grip Kit Red,07/18/2022,Invoice,M-071822-004,,FIREWRAP® GRIP KIT 	Red,5,21.75  ,108.75  ,"10,430.54  "
FireWrap® Grip Kit Red,07/21/2022,Invoice,M-072122-006,,FIREWRAP® GRIP KIT 	Red,7,21.75  ,152.25  ,"10,582.79  "
FireWrap® Grip Kit Red,07/25/2022,Invoice,M-072122-007,,FIREWRAP® GRIP KIT 	Red,10,27.95  ,279.50  ,"10,862.29  "
FireWrap® Grip Kit Red,07/25/2022,Invoice,M-072522-001,,FIREWRAP® GRIP KIT 	Red,5,21.75  ,108.75  ,"10,971.04  "
FireWrap® Grip Kit Red,07/28/2022,Invoice,M-063022-001,,FIREWRAP® GRIP KIT 	Red,10,21.75  ,217.50  ,"11,188.54  "
FireWrap® Grip Kit Red,08/09/2022,Invoice,M-080922-001,,FIREWRAP® GRIP KIT 	Red,11,21.75  ,239.25  ,"11,427.79  "
FireWrap® Grip Kit Red,08/17/2022,Invoice,M-081722-002,,FIREWRAP® GRIP KIT 	Red,4,21.75  ,87.00  ,"11,514.79  "
FireWrap® Grip Kit Red,08/25/2022,Invoice,M-082722-002,,FIREWRAP® GRIP KIT 	Red,1,21.75  ,21.75  ,"11,536.54  "
FireWrap® Grip Kit Red,09/05/2022,Invoice,M-082422-002,,FIREWRAP® GRIP KIT 	Red,6,21.75  ,130.50  ,"11,667.04  "
FireWrap® Grip Kit Red,09/08/2022,Invoice,M-082722-001,,FIREWRAP® GRIP KIT 	Red,5,21.75  ,108.75  ,"11,775.79  "
FireWrap® Grip Kit Red,09/08/2022,Invoice,M-082522-003,,FIREWRAP® GRIP KIT 	Red,12,21.75  ,261.00  ,"12,036.79  "
FireWrap® Grip Kit Red,09/15/2022,Invoice,M-090722-002B,,FIREWRAP® GRIP KIT 	Red,25,21.75  ,543.75  ,"12,580.54  "
FireWrap® Grip Kit Red,09/20/2022,Invoice,M-092022-002,,FIREWRAP® GRIP KIT 	Red,1,21.75  ,21.75  ,"12,602.29  "
FireWrap® Grip Kit Red,10/11/2022,Invoice,M-101122-001,,FIREWRAP® GRIP KIT 	Red,8,21.75  ,174.00  ,"12,776.29  "
FireWrap® Grip Kit Red,10/31/2022,Invoice,M-103122-002,,FIREWRAP® GRIP KIT 	Red,5,21.75  ,108.75  ,"12,885.04  "
FireWrap® Grip Kit Red,11/05/2022,Invoice,M-110522-001,,FIREWRAP® GRIP KIT 	Red,1,21.75  ,21.75  ,"12,906.79  "
FireWrap® Grip Kit Red,11/05/2022,Invoice,M-110522-002,,FIREWRAP® GRIP KIT 	Red,4,21.75  ,87.00  ,"12,993.79  "
FireWrap® Grip Kit Red,11/09/2022,Invoice,M-110922-004,,FIREWRAP® GRIP KIT 	Red,4,27.95  ,111.80  ,"13,105.59  "
FireWrap® Grip Kit Red,11/09/2022,Invoice,M-110922-003,,FIREWRAP® GRIP KIT 	Red,2,21.75  ,43.50  ,"13,149.09  "
FireWrap® Grip Kit Red,11/28/2022,Invoice,M-112822-004,,FIREWRAP® GRIP KIT 	Red,2,21.75  ,43.50  ,"13,192.59  "
FireWrap® Grip Kit Red,11/28/2022,Invoice,M-110922-002,,FIREWRAP® GRIP KIT 	Red,12,21.75  ,261.00  ,"13,453.59  "
FireWrap® Grip Kit Red,11/28/2022,Invoice,M-112222-004,,FIREWRAP® GRIP KIT 	Red,25,21.75  ,543.75  ,"13,997.34  "
FireWrap® Grip Kit Red,12/06/2022,Invoice,M-120622-005,,FIREWRAP® GRIP KIT 	Red,6,27.95  ,167.70  ,"14,165.04  "
FireWrap® Grip Kit Red,12/06/2022,Invoice,M-120622-002,,FIREWRAP® GRIP KIT 	Red,3,21.75  ,65.25  ,"14,230.29  "
FireWrap® Grip Kit Red,12/07/2022,Invoice,M-112222-001,,FIREWRAP® GRIP KIT 	Red,4,21.75  ,87.00  ,"14,317.29  "
FireWrap® Grip Kit Red,12/07/2022,Invoice,M-120722-001,,FIREWRAP® GRIP KIT 	Red,4,21.75  ,87.00  ,"14,404.29  "
FireWrap® Grip Kit Red,12/07/2022,Invoice,M-120722-003,,FIREWRAP® GRIP KIT 	Red,1,21.75  ,21.75  ,"14,426.04  "
FireWrap® Grip Kit Red,12/12/2022,Invoice,M-121222-005,,FIREWRAP® GRIP KIT 	Red,10,21.75  ,217.50  ,"14,643.54  "
FireWrap® Grip Kit Red,12/12/2022,Invoice,M-121222-007,,FIREWRAP® GRIP KIT 	Red,14,21.75  ,304.50  ,"14,948.04  "
FireWrap® Grip Kit Red,12/12/2022,Invoice,M-121222-002B,,FIREWRAP® GRIP KIT 	Red,3,21.75  ,65.25  ,"15,013.29  "
FireWrap® Grip Kit Red,12/13/2022,Invoice,M-121322-001,,FIREWRAP® GRIP KIT 	Red,14,21.75  ,304.50  ,"15,317.79  "
FireWrap® Grip Kit Red,12/27/2022,Invoice,M-121922-006,,FIREWRAP® GRIP KIT 	Red,1,21.75  ,21.75  ,"15,339.54  "
FireWrap® Grip Kit Red,12/27/2022,Invoice,M-121922-004,,FIREWRAP® GRIP KIT 	Red,1,21.75  ,21.75  ,"15,361.29  "
FireWrap® Grip Kit Red,12/27/2022,Invoice,M-121922-007,,FIREWRAP® GRIP KIT 	Red,2,21.75  ,43.50  ,"15,404.79  "
FireWrap® Grip Kit Red,12/27/2022,Invoice,M-122022-001,,FIREWRAP® GRIP KIT 	Red,3,21.75  ,65.25  ,"15,470.04  "
FireWrap® Grip Kit Red,01/03/2023,Invoice,M-010323-003,,FIREWRAP® GRIP KIT 	Red,2,27.95  ,55.90  ,"15,525.94  "
FireWrap® Grip Kit Red,01/03/2023,Invoice,M-010323-002,,FIREWRAP® GRIP KIT 	Red,10,21.75  ,217.50  ,"15,743.44  "
Total for FireWrap® Grip Kit Red,,,,,,727,,"$	15,743.44  ",
FireWrap® Grip Kit White,,,,,,,,,
FireWrap® Grip Kit White,03/20/2021,Sales Receipt,5151,,"FIREWRAP® GRIP KIT - Yes, I understand.
Color: White",1,24.99  ,24.99  ,24.99  
FireWrap® Grip Kit White,03/22/2021,Sales Receipt,5160,,"FIREWRAP® GRIP KIT - Yes, I understand.
Color: White",1,24.99  ,24.99  ,49.98  
FireWrap® Grip Kit White,03/27/2021,Invoice,M-021921-001,,FIREWRAP® GRIP KIT 	White,2,18.75  ,37.50  ,87.48  
FireWrap® Grip Kit White,03/27/2021,Invoice,M-032721-001,,FIREWRAP® GRIP KIT 	White,2,18.75  ,37.50  ,124.98  
FireWrap® Grip Kit White,03/27/2021,Invoice,M-032721-006,,FIREWRAP® GRIP KIT 	White,2,18.75  ,37.50  ,162.48  
FireWrap® Grip Kit White,03/27/2021,Invoice,M-032721-006,,FIREWRAP® GRIP KIT 	White,7,18.75  ,131.25  ,293.73  
FireWrap® Grip Kit White,03/30/2021,Invoice,M-033021-010,,FIREWRAP® GRIP KIT 	White,1,18.75  ,18.75  ,312.48  
FireWrap® Grip Kit White,04/02/2021,Sales Receipt,5226,,"FIREWRAP® GRIP KIT - Yes, I understand.
Color: White",3,24.99  ,74.97  ,387.45  
FireWrap® Grip Kit White,04/05/2021,Sales Receipt,5240,,"FIREWRAP® GRIP KIT - Yes, I understand.
Color: White",1,24.99  ,24.99  ,412.44  
FireWrap® Grip Kit White,04/09/2021,Sales Receipt,5272,,"FIREWRAP® GRIP KIT - Yes, I understand.
Color: White",1,24.99  ,24.99  ,437.43  
FireWrap® Grip Kit White,04/13/2021,Invoice,M-041321-001,,FIREWRAP® GRIP KIT 	White,1,18.75  ,18.75  ,456.18  
FireWrap® Grip Kit White,04/19/2021,Invoice,M-041921-001,,FIREWRAP® GRIP KIT 	White,2,18.75  ,37.50  ,493.68  
FireWrap® Grip Kit White,04/24/2021,Sales Receipt,5379,,"FIREWRAP® GRIP KIT
Color: White",1,24.99  ,24.99  ,518.67  
FireWrap® Grip Kit White,04/26/2021,Sales Receipt,5394,,"FIREWRAP® GRIP KIT
Color: White",1,24.99  ,24.99  ,543.66  
FireWrap® Grip Kit White,04/30/2021,Invoice,M-043021-002,,FIREWRAP® GRIP KIT 	White,2,24.99  ,49.98  ,593.64  
FireWrap® Grip Kit White,05/03/2021,Invoice,M-050321-003,,FIREWRAP® GRIP KIT 	White,2,18.75  ,37.50  ,631.14  
FireWrap® Grip Kit White,05/10/2021,Invoice,M-051021-001,,FIREWRAP® GRIP KIT 	White,1,18.75  ,18.75  ,649.89  
FireWrap® Grip Kit White,05/11/2021,Sales Receipt,5481,,"FIREWRAP® GRIP KIT
Color: White",2,24.99  ,49.98  ,699.87  
FireWrap® Grip Kit White,05/14/2021,Invoice,M-051421-001,,FIREWRAP® GRIP KIT 	White,4,18.75  ,75.00  ,774.87  
FireWrap® Grip Kit White,05/14/2021,Sales Receipt,5510,,"FIREWRAP® GRIP KIT
Color: White",1,24.99  ,24.99  ,799.86  
FireWrap® Grip Kit White,06/09/2021,Invoice,M-060921-001,,FIREWRAP® GRIP KIT 	White,1,18.75  ,18.75  ,818.61  
FireWrap® Grip Kit White,06/09/2021,Invoice,M-060921-002,,FIREWRAP® GRIP KIT 	- PURPLE,1,18.75  ,18.75  ,837.36  
FireWrap® Grip Kit White,07/06/2021,Sales Receipt,5752,,"FIREWRAP® GRIP KIT
Color: White",1,24.99  ,24.99  ,862.35  
FireWrap® Grip Kit White,07/08/2021,Invoice,M-070821-001,,FIREWRAP® GRIP KIT 	White,40,18.75  ,750.00  ,"1,612.35  "
FireWrap® Grip Kit White,07/16/2021,Sales Receipt,5789,,"FIREWRAP® GRIP KIT
Color: White",1,24.99  ,24.99  ,"1,637.34  "
FireWrap® Grip Kit White,08/09/2021,Sales Receipt,5889,,"FIREWRAP® GRIP KIT
Color: White",1,24.99  ,24.99  ,"1,662.33  "
FireWrap® Grip Kit White,08/09/2021,Invoice,M-080921-003,,FIREWRAP® GRIP KIT 	White,1,18.75  ,18.75  ,"1,681.08  "
FireWrap® Grip Kit White,08/26/2021,Sales Receipt,5983,,"FIREWRAP® GRIP KIT
Color: White",1,24.99  ,24.99  ,"1,706.07  "
FireWrap® Grip Kit White,09/09/2021,Sales Receipt,6060,,"FIREWRAP® GRIP KIT
Color: White",1,24.99  ,24.99  ,"1,731.06  "
FireWrap® Grip Kit White,09/11/2021,Sales Receipt,6069,,"FIREWRAP® GRIP KIT
Color: White",1,24.99  ,24.99  ,"1,756.05  "
FireWrap® Grip Kit White,09/15/2021,Sales Receipt,6081,,"FIREWRAP® GRIP KIT
Color: White",1,24.99  ,24.99  ,"1,781.04  "
FireWrap® Grip Kit White,09/15/2021,Sales Receipt,6085,,"FIREWRAP® GRIP KIT
Color: White",2,24.99  ,49.98  ,"1,831.02  "
FireWrap® Grip Kit White,09/27/2021,Sales Receipt,6175,,"FIREWRAP® GRIP KIT
Color: White",1,19.99  ,19.99  ,"1,851.01  "
FireWrap® Grip Kit White,09/30/2021,Invoice,M-093021-001,,FIREWRAP® GRIP KIT 	White,4,19.99  ,79.96  ,"1,930.97  "
FireWrap® Grip Kit White,10/11/2021,Sales Receipt,6277,,"FIREWRAP® GRIP KIT
Color: White",2,24.95  ,49.90  ,"1,980.87  "
FireWrap® Grip Kit White,10/16/2021,Sales Receipt,6317,,"FIREWRAP® GRIP KIT
Color: White",1,24.95  ,24.95  ,"2,005.82  "
FireWrap® Grip Kit White,10/20/2021,Invoice,M-102021-002,,FIREWRAP® GRIP KIT 	White,3,18.75  ,56.25  ,"2,062.07  "
FireWrap® Grip Kit White,10/25/2021,Sales Receipt,6364,,"FIREWRAP® GRIP KIT
Color: White",1,24.95  ,24.95  ,"2,087.02  "
FireWrap® Grip Kit White,10/28/2021,Invoice,M-102821-005,,FIREWRAP® GRIP KIT 	White,3,24.95  ,74.85  ,"2,161.87  "
FireWrap® Grip Kit White,11/02/2021,Invoice,M-101221-001,,FIREWRAP® GRIP KIT 	White,1,18.75  ,18.75  ,"2,180.62  "
FireWrap® Grip Kit White,11/10/2021,Sales Receipt,6470,,"FIREWRAP® GRIP KIT
Color: White",2,24.95  ,49.90  ,"2,230.52  "
FireWrap® Grip Kit White,11/10/2021,Sales Receipt,6475,,"FIREWRAP® GRIP KIT
Color: White",1,24.95  ,24.95  ,"2,255.47  "
FireWrap® Grip Kit White,11/14/2021,Sales Receipt,6509,,"FIREWRAP® GRIP KIT
Color: White",1,24.95  ,24.95  ,"2,280.42  "
FireWrap® Grip Kit White,12/02/2021,Sales Receipt,6651,,"FIREWRAP® GRIP KIT
Color: White",1,19.99  ,19.99  ,"2,300.41  "
FireWrap® Grip Kit White,12/02/2021,Invoice,M-120221-001,,FIREWRAP® GRIP KIT 	White,1,19.99  ,19.99  ,"2,320.40  "
FireWrap® Grip Kit White,12/08/2021,Sales Receipt,6696,,"FIREWRAP® GRIP KIT
Color: White",10,24.95  ,249.50  ,"2,569.90  "
FireWrap® Grip Kit White,12/16/2021,Sales Receipt,6754,,"FIREWRAP® GRIP KIT
Color: White",1,24.95  ,24.95  ,"2,594.85  "
FireWrap® Grip Kit White,12/16/2021,Sales Receipt,6751,,"FIREWRAP® GRIP KIT
Color: White",1,24.95  ,24.95  ,"2,619.80  "
FireWrap® Grip Kit White,12/23/2021,Sales Receipt,6804,,"FIREWRAP® GRIP KIT
Color: White",1,24.95  ,24.95  ,"2,644.75  "
FireWrap® Grip Kit White,12/25/2021,Sales Receipt,6828,,"FIREWRAP® GRIP KIT
Color: White",1,24.95  ,24.95  ,"2,669.70  "
FireWrap® Grip Kit White,01/02/2022,Sales Receipt,6891,,"FIREWRAP® GRIP KIT
Color: White",2,24.95  ,49.90  ,"2,719.60  "
FireWrap® Grip Kit White,01/04/2022,Invoice,M-010422-003,,FIREWRAP® GRIP KIT 	White,3,18.75  ,56.25  ,"2,775.85  "
FireWrap® Grip Kit White,01/05/2022,Sales Receipt,6920,,"FIREWRAP® GRIP KIT
Color: White",1,24.95  ,24.95  ,"2,800.80  "
FireWrap® Grip Kit White,01/10/2022,Sales Receipt,6968,,"FIREWRAP® GRIP KIT
Color: White",2,24.95  ,49.90  ,"2,850.70  "
FireWrap® Grip Kit White,01/12/2022,Invoice,M-011222-004,,FIREWRAP® GRIP KIT 	White,3,18.75  ,56.25  ,"2,906.95  "
FireWrap® Grip Kit White,01/18/2022,Invoice,M-011822-007,,FIREWRAP® GRIP KIT 	White,1,24.95  ,24.95  ,"2,931.90  "
FireWrap® Grip Kit White,01/21/2022,Sales Receipt,7058,,"FIREWRAP® GRIP KIT
Color: White",1,24.95  ,24.95  ,"2,956.85  "
FireWrap® Grip Kit White,02/05/2022,Sales Receipt,7202,,"FIREWRAP® GRIP KIT
Color: White",1,27.95  ,27.95  ,"2,984.80  "
FireWrap® Grip Kit White,02/07/2022,Sales Receipt,7217,,"FIREWRAP® GRIP KIT
Color: White",2,27.95  ,55.90  ,"3,040.70  "
FireWrap® Grip Kit White,02/08/2022,Sales Receipt,7227,,"FIREWRAP® GRIP KIT
Color: White",1,27.95  ,27.95  ,"3,068.65  "
FireWrap® Grip Kit White,02/08/2022,Invoice,M-020822-001,,FIREWRAP® GRIP KIT 	White,1,21.75  ,21.75  ,"3,090.40  "
FireWrap® Grip Kit White,02/09/2022,Sales Receipt,7247,,"FIREWRAP® GRIP KIT
Color: White",7,27.95  ,195.65  ,"3,286.05  "
FireWrap® Grip Kit White,02/10/2022,Sales Receipt,7262,,"FIREWRAP® GRIP KIT
Color: White",1,27.95  ,27.95  ,"3,314.00  "
FireWrap® Grip Kit White,02/16/2022,Sales Receipt,7296,,"FIREWRAP® GRIP KIT
Color: White",1,27.95  ,27.95  ,"3,341.95  "
FireWrap® Grip Kit White,02/18/2022,Sales Receipt,7315,,"FIREWRAP® GRIP KIT
Color: White",1,27.95  ,27.95  ,"3,369.90  "
FireWrap® Grip Kit White,02/22/2022,Invoice,M-022122-005,,FIREWRAP® GRIP KIT 	White,1,21.75  ,21.75  ,"3,391.65  "
FireWrap® Grip Kit White,02/23/2022,Invoice,M-022322-004,,FIREWRAP® GRIP KIT 	White,8,27.95  ,223.60  ,"3,615.25  "
FireWrap® Grip Kit White,02/28/2022,Sales Receipt,7419,,"FIREWRAP® GRIP KIT
Color: White",1,27.95  ,27.95  ,"3,643.20  "
FireWrap® Grip Kit White,03/04/2022,Invoice,M-030422-001,,FIREWRAP® GRIP KIT 	White,1,21.75  ,21.75  ,"3,664.95  "
FireWrap® Grip Kit White,03/04/2022,Sales Receipt,7466,,"FIREWRAP® GRIP KIT
Color: White",2,27.95  ,55.90  ,"3,720.85  "
FireWrap® Grip Kit White,03/11/2022,Invoice,M-031122-004,,FIREWRAP® GRIP KIT 	White,1,21.75  ,21.75  ,"3,742.60  "
FireWrap® Grip Kit White,03/17/2022,Invoice,M-031722-003,,FIREWRAP® GRIP KIT 	White,1,21.75  ,21.75  ,"3,764.35  "
FireWrap® Grip Kit White,04/04/2022,Sales Receipt,7688,,"FIREWRAP® GRIP KIT
Color: White",4,27.95  ,111.80  ,"3,876.15  "
FireWrap® Grip Kit White,04/24/2022,Sales Receipt,7809,,"FIREWRAP® GRIP KIT
Color: White",1,27.95  ,27.95  ,"3,904.10  "
FireWrap® Grip Kit White,04/25/2022,Invoice,M-033022-002,,FIREWRAP® GRIP KIT 	White,1,21.75  ,21.75  ,"3,925.85  "
FireWrap® Grip Kit White,04/30/2022,Sales Receipt,7862,,"FIREWRAP® GRIP KIT
Color: White",1,22.95  ,22.95  ,"3,948.80  "
FireWrap® Grip Kit White,05/02/2022,Sales Receipt,7879,,"FIREWRAP® GRIP KIT
Color: White",1,22.95  ,22.95  ,"3,971.75  "
FireWrap® Grip Kit White,05/02/2022,Sales Receipt,7877,,"FIREWRAP® GRIP KIT
Color: White",1,22.95  ,22.95  ,"3,994.70  "
FireWrap® Grip Kit White,05/03/2022,Sales Receipt,7884,,"FIREWRAP® GRIP KIT
Color: White",1,22.95  ,22.95  ,"4,017.65  "
FireWrap® Grip Kit White,05/03/2022,Invoice,M-030122-003,,FIREWRAP® GRIP KIT 	White,4,16.50  ,66.00  ,"4,083.65  "
FireWrap® Grip Kit White,05/03/2022,Sales Receipt,7888,,"FIREWRAP® GRIP KIT
Color: White",2,22.95  ,45.90  ,"4,129.55  "
FireWrap® Grip Kit White,05/03/2022,Sales Receipt,7897,,"FIREWRAP® GRIP KIT
Color: White",1,22.95  ,22.95  ,"4,152.50  "
FireWrap® Grip Kit White,05/04/2022,Sales Receipt,7904,,"FIREWRAP® GRIP KIT
Color: White",1,22.95  ,22.95  ,"4,175.45  "
FireWrap® Grip Kit White,05/12/2022,Invoice,M-050922-006,,FIREWRAP® GRIP KIT 	White,2,27.95  ,55.90  ,"4,231.35  "
FireWrap® Grip Kit White,05/18/2022,Sales Receipt,7976,,"FIREWRAP® GRIP KIT
Color: White",1,27.95  ,27.95  ,"4,259.30  "
FireWrap® Grip Kit White,05/31/2022,Invoice,M-053122-002,,FIREWRAP® GRIP KIT 	White,6,16.50  ,99.00  ,"4,358.30  "
FireWrap® Grip Kit White,06/01/2022,Sales Receipt,8031,,"FIREWRAP® GRIP KIT
Color: White",1,27.95  ,27.95  ,"4,386.25  "
FireWrap® Grip Kit White,06/04/2022,Sales Receipt,8054,,"FIREWRAP® GRIP KIT
Color: White",1,27.95  ,27.95  ,"4,414.20  "
FireWrap® Grip Kit White,06/10/2022,Sales Receipt,8090,,"FIREWRAP® GRIP KIT
Color: White",1,27.95  ,27.95  ,"4,442.15  "
FireWrap® Grip Kit White,06/10/2022,Invoice,M-061022-006,,FIREWRAP® GRIP KIT 	White,2,21.75  ,43.50  ,"4,485.65  "
FireWrap® Grip Kit White,06/17/2022,Sales Receipt,8146,,"FIREWRAP® GRIP KIT
Color: White",3,27.95  ,83.85  ,"4,569.50  "
FireWrap® Grip Kit White,06/23/2022,Invoice,M-061522-001-B,,FIREWRAP® GRIP KIT 	White,1,21.75  ,21.75  ,"4,591.25  "
FireWrap® Grip Kit White,06/23/2022,Invoice,M-062322-002,,FIREWRAP® GRIP KIT 	White,2,21.75  ,43.50  ,"4,634.75  "
FireWrap® Grip Kit White,06/23/2022,Invoice,M-062322-001,,FIREWRAP® GRIP KIT 	White,5,21.75  ,108.75  ,"4,743.50  "
FireWrap® Grip Kit White,07/14/2022,Sales Receipt,8302,,"FIREWRAP® GRIP KIT
Color: White",1,27.95  ,27.95  ,"4,771.45  "
FireWrap® Grip Kit White,07/14/2022,Sales Receipt,8299,,"FIREWRAP® GRIP KIT
Color: White",1,27.95  ,27.95  ,"4,799.40  "
FireWrap® Grip Kit White,07/19/2022,Sales Receipt,8324,,"FIREWRAP® GRIP KIT
Color: White",1,27.95  ,27.95  ,"4,827.35  "
FireWrap® Grip Kit White,07/19/2022,Sales Receipt,8323,,"FIREWRAP® GRIP KIT
Color: White",4,27.95  ,111.80  ,"4,939.15  "
FireWrap® Grip Kit White,07/22/2022,Sales Receipt,8341,,"FIREWRAP® GRIP KIT
Color: White",1,27.95  ,27.95  ,"4,967.10  "
FireWrap® Grip Kit White,07/25/2022,Invoice,M-072122-007,,FIREWRAP® GRIP KIT 	White,5,27.95  ,139.75  ,"5,106.85  "
FireWrap® Grip Kit White,07/26/2022,Sales Receipt,8369,,"FIREWRAP® GRIP KIT
Color: White",1,27.95  ,27.95  ,"5,134.80  "
FireWrap® Grip Kit White,07/28/2022,Sales Receipt,8379,,"FIREWRAP® GRIP KIT
Color: White",1,27.95  ,27.95  ,"5,162.75  "
FireWrap® Grip Kit White,07/30/2022,Sales Receipt,8399,,"FIREWRAP® GRIP KIT
Color: White",2,27.95  ,55.90  ,"5,218.65  "
FireWrap® Grip Kit White,07/30/2022,Invoice,M-073022-004,,FIREWRAP® GRIP KIT 	White,5,21.75  ,108.75  ,"5,327.40  "
FireWrap® Grip Kit White,08/03/2022,Invoice,M-080322-003,,FIREWRAP® GRIP KIT 	White,5,27.95  ,139.75  ,"5,467.15  "
FireWrap® Grip Kit White,08/12/2022,Sales Receipt,8473,,"FIREWRAP® GRIP KIT
Color: White",1,27.95  ,27.95  ,"5,495.10  "
FireWrap® Grip Kit White,08/20/2022,Sales Receipt,8525,,"FIREWRAP® GRIP KIT
Color: White",1,27.95  ,27.95  ,"5,523.05  "
FireWrap® Grip Kit White,08/21/2022,Sales Receipt,8533,,"FIREWRAP® GRIP KIT
Color: White",1,27.95  ,27.95  ,"5,551.00  "
FireWrap® Grip Kit White,08/25/2022,Sales Receipt,8552,,"FIREWRAP® GRIP KIT
Color: White",2,27.95  ,55.90  ,"5,606.90  "
FireWrap® Grip Kit White,08/27/2022,Sales Receipt,8565,,"FIREWRAP® GRIP KIT
Color: White",1,27.95  ,27.95  ,"5,634.85  "
FireWrap® Grip Kit White,09/02/2022,Invoice,M-090222-001,,FIREWRAP® GRIP KIT 	White,2,27.95  ,55.90  ,"5,690.75  "
FireWrap® Grip Kit White,09/08/2022,Sales Receipt,8648,,"FIREWRAP® GRIP KIT
Color: White",1,27.95  ,27.95  ,"5,718.70  "
FireWrap® Grip Kit White,09/08/2022,Invoice,M-082522-003,,FIREWRAP® GRIP KIT 	White,4,21.75  ,87.00  ,"5,805.70  "
FireWrap® Grip Kit White,09/12/2022,Sales Receipt,8671,,"FIREWRAP® GRIP KIT
Color: White",1,27.95  ,27.95  ,"5,833.65  "
FireWrap® Grip Kit White,09/13/2022,Sales Receipt,8680,,"FIREWRAP® GRIP KIT
Color: White",1,27.95  ,27.95  ,"5,861.60  "
FireWrap® Grip Kit White,09/13/2022,Invoice,M-091322-001,,FIREWRAP® GRIP KIT 	White,5,21.75  ,108.75  ,"5,970.35  "
FireWrap® Grip Kit White,09/18/2022,Sales Receipt,8708,,"FIREWRAP® GRIP KIT
Color: White",1,27.95  ,27.95  ,"5,998.30  "
FireWrap® Grip Kit White,09/22/2022,Sales Receipt,8739,,"FIREWRAP® GRIP KIT
Color: White",8,27.95  ,223.60  ,"6,221.90  "
FireWrap® Grip Kit White,09/23/2022,Sales Receipt,8743,,"FIREWRAP® GRIP KIT
Color: White",1,27.95  ,27.95  ,"6,249.85  "
FireWrap® Grip Kit White,09/25/2022,Sales Receipt,8751,,"FIREWRAP® GRIP KIT
Color: White",2,27.95  ,55.90  ,"6,305.75  "
FireWrap® Grip Kit White,09/28/2022,Sales Receipt,8782,,"FIREWRAP® GRIP KIT
Color: White",6,27.95  ,167.70  ,"6,473.45  "
FireWrap® Grip Kit White,09/28/2022,Sales Receipt,8789,,"FIREWRAP® GRIP KIT
Color: White",2,27.95  ,55.90  ,"6,529.35  "
FireWrap® Grip Kit White,10/02/2022,Sales Receipt,8828,,"FIREWRAP® GRIP KIT
Color: White",1,27.95  ,27.95  ,"6,557.30  "
FireWrap® Grip Kit White,10/06/2022,Sales Receipt,8852,,"FIREWRAP® GRIP KIT
Color: White",2,27.95  ,55.90  ,"6,613.20  "
FireWrap® Grip Kit White,10/18/2022,Sales Receipt,8932,,"FIREWRAP® GRIP KIT
Color: White",1,27.95  ,27.95  ,"6,641.15  "
FireWrap® Grip Kit White,10/21/2022,Sales Receipt,8959,,"FIREWRAP® GRIP KIT
Color: White",2,27.95  ,55.90  ,"6,697.05  "
FireWrap® Grip Kit White,10/31/2022,Invoice,M-103122-002,,FIREWRAP® GRIP KIT 	White,5,21.75  ,108.75  ,"6,805.80  "
FireWrap® Grip Kit White,11/10/2022,Sales Receipt,M-112-5820430-9073859,,FireWrap® Grip Kit - White,1,28.95  ,28.95  ,"6,834.75  "
FireWrap® Grip Kit White,11/18/2022,Sales Receipt,M-114-0288644-8992234,,FireWrap® Grip Kit - White,1,28.95  ,28.95  ,"6,863.70  "
FireWrap® Grip Kit White,11/28/2022,Sales Receipt,9197,,"FIREWRAP® GRIP KIT
Color: White",5,27.95  ,139.75  ,"7,003.45  "
FireWrap® Grip Kit White,11/28/2022,Sales Receipt,9200,,"FIREWRAP® GRIP KIT
Color: White",6,27.95  ,167.70  ,"7,171.15  "
FireWrap® Grip Kit White,11/30/2022,Sales Receipt,M-111-1287542-5237858,,FireWrap® Grip Kit - White,1,28.95  ,28.95  ,"7,200.10  "
FireWrap® Grip Kit White,12/04/2022,Sales Receipt,9249,,"FIREWRAP® GRIP KIT
Color: White",1,27.95  ,27.95  ,"7,228.05  "
FireWrap® Grip Kit White,12/07/2022,Sales Receipt,9266,,"FIREWRAP® GRIP KIT
Color: White",1,27.95  ,27.95  ,"7,256.00  "
FireWrap® Grip Kit White,12/07/2022,Sales Receipt,9263,,"FIREWRAP® GRIP KIT
Color: White",1,27.95  ,27.95  ,"7,283.95  "
FireWrap® Grip Kit White,12/09/2022,Sales Receipt,M-114-4445822-7277829,,FireWrap® Grip Kit - White,1,28.95  ,28.95  ,"7,312.90  "
FireWrap® Grip Kit White,12/12/2022,Invoice,M-121222-002B,,FIREWRAP® GRIP KIT 	White,5,21.75  ,108.75  ,"7,421.65  "
FireWrap® Grip Kit White,12/14/2022,Sales Receipt,9324,,"FIREWRAP® GRIP KIT
Color: White",1,27.95  ,27.95  ,"7,449.60  "
FireWrap® Grip Kit White,12/16/2022,Sales Receipt,9344,,"FIREWRAP® GRIP KIT
Color: White",1,27.95  ,27.95  ,"7,477.55  "
FireWrap® Grip Kit White,12/25/2022,Sales Receipt,M-111-9897394-4141067,,FireWrap® Grip Kit - White,1,28.95  ,28.95  ,"7,506.50  "
FireWrap® Grip Kit White,12/26/2022,Sales Receipt,M-112-0976037-5403460,,FireWrap® Grip Kit - White,1,28.95  ,28.95  ,"7,535.45  "
FireWrap® Grip Kit White,12/27/2022,Invoice,M-121922-007,,FIREWRAP® GRIP KIT 	White,4,21.75  ,87.00  ,"7,622.45  "
FireWrap® Grip Kit White,12/27/2022,Invoice,M-121922-006,,FIREWRAP® GRIP KIT 	White,1,21.75  ,21.75  ,"7,644.20  "
FireWrap® Grip Kit White,12/31/2022,Sales Receipt,M-113-1797051-4143448,,FireWrap® Grip Kit - White,1,28.95  ,28.95  ,"7,673.15  "
Total for FireWrap® Grip Kit White,,,,,,323,,"$	7,673.15  ",
FireWrap® Grip Kit Yellow,,,,,,,,,
FireWrap® Grip Kit Yellow,03/26/2021,Invoice,M-032621-008,,FIREWRAP® GRIP KIT	Yellow,10,18.75  ,187.50  ,187.50  
FireWrap® Grip Kit Yellow,03/26/2021,Invoice,M-032621-009,,FIREWRAP® GRIP KIT	Yellow,1,18.75  ,18.75  ,206.25  
FireWrap® Grip Kit Yellow,07/08/2021,Invoice,M-070821-001,,FIREWRAP® GRIP KIT	Yellow,10,18.75  ,187.50  ,393.75  
FireWrap® Grip Kit Yellow,10/07/2021,Invoice,M-100721-004,,FIREWRAP® GRIP KIT	Yellow,1,18.75  ,18.75  ,412.50  
FireWrap® Grip Kit Yellow,10/07/2021,Invoice,M-100721-008,,FIREWRAP® GRIP KIT	Yellow,2,18.75  ,37.50  ,450.00  
FireWrap® Grip Kit Yellow,10/07/2021,Invoice,M-100721-003,,FIREWRAP® GRIP KIT	Yellow,8,18.75  ,150.00  ,600.00  
FireWrap® Grip Kit Yellow,10/27/2021,Invoice,M-102721-005,,FIREWRAP® GRIP KIT	Yellow,8,18.75  ,150.00  ,750.00  
FireWrap® Grip Kit Yellow,10/28/2021,Invoice,M-102821-005,,FIREWRAP® GRIP KIT	Yellow,1,24.95  ,24.95  ,774.95  
FireWrap® Grip Kit Yellow,12/02/2021,Invoice,M-120221-001,,FIREWRAP® GRIP KIT	Yellow,1,19.99  ,19.99  ,794.94  
FireWrap® Grip Kit Yellow,12/22/2021,Invoice,M-122221-001,,FIREWRAP® GRIP KIT	Yellow,4,18.75  ,75.00  ,869.94  
FireWrap® Grip Kit Yellow,01/12/2022,Invoice,M-011222-004,,FIREWRAP® GRIP KIT	Yellow,4,18.75  ,75.00  ,944.94  
FireWrap® Grip Kit Yellow,01/18/2022,Invoice,M-011822-002,,FIREWRAP® GRIP KIT	Yellow,1,24.95  ,24.95  ,969.89  
FireWrap® Grip Kit Yellow,02/01/2022,Invoice,M-020122-002,,FIREWRAP® GRIP KIT	Yellow,3,21.75  ,65.25  ,"1,035.14  "
FireWrap® Grip Kit Yellow,02/14/2022,Invoice,M-021422-002,,FIREWRAP® GRIP KIT	Yellow,2,21.75  ,43.50  ,"1,078.64  "
FireWrap® Grip Kit Yellow,02/22/2022,Invoice,M-022222-002,,FIREWRAP® GRIP KIT	Yellow,1,21.75  ,21.75  ,"1,100.39  "
FireWrap® Grip Kit Yellow,02/22/2022,Invoice,M-022122-005,,FIREWRAP® GRIP KIT	Yellow,1,21.75  ,21.75  ,"1,122.14  "
FireWrap® Grip Kit Yellow,03/11/2022,Invoice,M-031122-004,,FIREWRAP® GRIP KIT	Yellow,6,21.75  ,130.50  ,"1,252.64  "
FireWrap® Grip Kit Yellow,03/28/2022,Invoice,M-032822-005,,FIREWRAP® GRIP KIT	Yellow,5,27.95  ,139.75  ,"1,392.39  "
FireWrap® Grip Kit Yellow,03/30/2022,Invoice,M-033022-005,,FIREWRAP® GRIP KIT	Yellow,1,27.95  ,27.95  ,"1,420.34  "
FireWrap® Grip Kit Yellow,04/22/2022,Invoice,M-042222-001,,FIREWRAP® GRIP KIT	Yellow,3,27.95  ,83.85  ,"1,504.19  "
FireWrap® Grip Kit Yellow,04/28/2022,Invoice,M-040522-001,,FIREWRAP® GRIP KIT	Yellow,2,21.75  ,43.50  ,"1,547.69  "
FireWrap® Grip Kit Yellow,05/03/2022,Invoice,M-030122-003,,FIREWRAP® GRIP KIT	Yellow,7,16.50  ,115.50  ,"1,663.19  "
FireWrap® Grip Kit Yellow,05/04/2022,Invoice,M-050422-001,,FIREWRAP® GRIP KIT	Yellow,4,27.95  ,111.80  ,"1,774.99  "
FireWrap® Grip Kit Yellow,05/12/2022,Invoice,M-050922-006,,FIREWRAP® GRIP KIT	Yellow,13,27.95  ,363.35  ,"2,138.34  "
FireWrap® Grip Kit Yellow,05/31/2022,Invoice,M-053122-003A,,FIREWRAP® GRIP KIT	Yellow,8,21.75  ,174.00  ,"2,312.34  "
FireWrap® Grip Kit Yellow,06/23/2022,Invoice,M-041822-007-B,,FIREWRAP® GRIP KIT	Yellow,2,21.75  ,43.50  ,"2,355.84  "
FireWrap® Grip Kit Yellow,06/23/2022,Invoice,M-062322-002,,FIREWRAP® GRIP KIT	Yellow,2,21.75  ,43.50  ,"2,399.34  "
FireWrap® Grip Kit Yellow,06/23/2022,Invoice,M-062322-001,,FIREWRAP® GRIP KIT	Yellow,4,21.75  ,87.00  ,"2,486.34  "
FireWrap® Grip Kit Yellow,07/07/2022,Invoice,M-070722-001,,FIREWRAP® GRIP KIT	Yellow,1,27.95  ,27.95  ,"2,514.29  "
FireWrap® Grip Kit Yellow,07/12/2022,Invoice,M-071222-004,,FIREWRAP® GRIP KIT	Yellow,1,21.75  ,21.75  ,"2,536.04  "
FireWrap® Grip Kit Yellow,07/25/2022,Invoice,M-072122-007,,FIREWRAP® GRIP KIT	Yellow,7,27.95  ,195.65  ,"2,731.69  "
FireWrap® Grip Kit Yellow,07/26/2022,Invoice,M-072022-001,,FIREWRAP® GRIP KIT	Yellow,5,21.75  ,108.75  ,"2,840.44  "
FireWrap® Grip Kit Yellow,08/08/2022,Invoice,M-080822-005,,FIREWRAP® GRIP KIT	Yellow,2,21.75  ,43.50  ,"2,883.94  "
FireWrap® Grip Kit Yellow,08/09/2022,Invoice,M-080922-001,,FIREWRAP® GRIP KIT	Yellow,11,21.75  ,239.25  ,"3,123.19  "
FireWrap® Grip Kit Yellow,09/05/2022,Invoice,M-082422-002,,FIREWRAP® GRIP KIT	Yellow,6,21.75  ,130.50  ,"3,253.69  "
FireWrap® Grip Kit Yellow,09/07/2022,Invoice,M-090722-003,,FIREWRAP® GRIP KIT	Yellow,3,21.75  ,65.25  ,"3,318.94  "
FireWrap® Grip Kit Yellow,09/08/2022,Invoice,M-082722-001,,FIREWRAP® GRIP KIT	Yellow,1,21.75  ,21.75  ,"3,340.69  "
FireWrap® Grip Kit Yellow,09/08/2022,Invoice,M-082522-003,,FIREWRAP® GRIP KIT	Yellow,15,21.75  ,326.25  ,"3,666.94  "
FireWrap® Grip Kit Yellow,09/15/2022,Invoice,M-090722-002B,,FIREWRAP® GRIP KIT	Yellow,2,21.75  ,43.50  ,"3,710.44  "
FireWrap® Grip Kit Yellow,09/25/2022,Invoice,M-092522-001,,FIREWRAP® GRIP KIT	Yellow,15,21.75  ,326.25  ,"4,036.69  "
FireWrap® Grip Kit Yellow,10/31/2022,Invoice,M-103122-002,,FIREWRAP® GRIP KIT	Yellow,5,21.75  ,108.75  ,"4,145.44  "
FireWrap® Grip Kit Yellow,11/05/2022,Invoice,M-110522-002,,FIREWRAP® GRIP KIT	Yellow,2,21.75  ,43.50  ,"4,188.94  "
FireWrap® Grip Kit Yellow,11/09/2022,Invoice,M-110922-004,,FIREWRAP® GRIP KIT	Yellow,1,27.95  ,27.95  ,"4,216.89  "
FireWrap® Grip Kit Yellow,11/28/2022,Invoice,M-112222-004,,FIREWRAP® GRIP KIT	Yellow,7,21.75  ,152.25  ,"4,369.14  "
FireWrap® Grip Kit Yellow,12/06/2022,Invoice,M-120622-005,,FIREWRAP® GRIP KIT	Yellow,6,27.95  ,167.70  ,"4,536.84  "
FireWrap® Grip Kit Yellow,12/12/2022,Invoice,M-121222-002B,,FIREWRAP® GRIP KIT	Yellow,5,21.75  ,108.75  ,"4,645.59  "
FireWrap® Grip Kit Yellow,12/13/2022,Invoice,M-121322-001,,FIREWRAP® GRIP KIT	Yellow,1,21.75  ,21.75  ,"4,667.34  "
FireWrap® Grip Kit Yellow,12/27/2022,Invoice,M-122722-001,,FIREWRAP® GRIP KIT	Yellow,1,21.75  ,21.75  ,"4,689.09  "
Total for FireWrap® Grip Kit Yellow,,,,,,212,,"$	4,689.09  ",
TOTAL,,,,,,13977,,"$	374,228.83  ",
,,,,,,,,,
,,,,,,,,,
"Wednesday, Jan 11, 2023 10:03:05 AM GMT-8 - Accrual Basis",,,,,,,,,